geo_cod;nome;uf;id_uf;reg;mesoreg;microreg;lat;long;sede;total;pop-homem;pop-mulher;pop-urbano;pop-urbano-homem;pop-urbano-mulher;pop-rural;pop-rural-homem;pop-rural-mulher
1100015;Alta Floresta D'Oeste;RO;11;Norte;LESTE RONDONIENSE;CACOAL;-11.929;-61.996;True;23857;12302;11508;13373;6618;6739;10484;5684;4769
1100023;Ariquemes;RO;11;Norte;LESTE RONDONIENSE;ARIQUEMES;-9.913;-63.041;True;82388;41692;40331;63613;31581;31747;18775;10111;8584
1100031;Cabixi;RO;11;Norte;LESTE RONDONIENSE;COLORADO DO OESTE;-13.492;-60.545;True;6575;3372;3181;2542;1233;1287;4033;2139;1894
1100049;Cacoal;RO;11;Norte;LESTE RONDONIENSE;CACOAL;-11.438;-61.448;True;76155;38045;38088;58393;28546;29837;17762;9499;8251
1100056;Cerejeiras;RO;11;Norte;LESTE RONDONIENSE;COLORADO DO OESTE;-13.189;-60.812;True;16290;8212;8078;13634;6756;6878;2656;1456;1200
1100064;Colorado do Oeste;RO;11;Norte;LESTE RONDONIENSE;COLORADO DO OESTE;-13.117;-60.542;True;17644;8838;8781;12592;6137;6430;5052;2701;2351
1100072;Corumbiara;RO;11;Norte;LESTE RONDONIENSE;COLORADO DO OESTE;-12.962;-60.887;True;9476;5138;4318;2421;1241;1180;7055;3897;3138
1100080;Costa Marques;RO;11;Norte;MADEIRA-GUAPORE;GUAJARA-MIRIM;-12.445;-64.227;True;13664;7256;6375;7219;3743;3465;6445;3513;2910
1100098;Espigão D'Oeste;RO;11;Norte;LESTE RONDONIENSE;CACOAL;-11.525;-61.013;True;27867;14076;13564;19360;9576;9642;8507;4500;3922
1100106;Guajará-Mirim;RO;11;Norte;MADEIRA-GUAPORE;GUAJARA-MIRIM;-10.783;-65.339;True;39451;19295;18914;33373;15969;16273;6078;3326;2641
1100114;Jaru;RO;11;Norte;LESTE RONDONIENSE;JI-PARANA;-10.439;-62.466;True;52453;26315;25925;34890;17098;17665;17563;9217;8260
1100122;Ji-Paraná;RO;11;Norte;LESTE RONDONIENSE;JI-PARANA;-10.882;-61.944;True;107679;53262;54113;94704;46319;48106;12975;6943;6007
1100130;Machadinho D'Oeste;RO;11;Norte;LESTE RONDONIENSE;ARIQUEMES;-9.444;-61.981;True;31475;16715;14424;16370;8348;7811;15105;8367;6613
1100148;Nova Brasilândia D'Oeste;RO;11;Norte;LESTE RONDONIENSE;ALVORADA D'OESTE;-11.725;-62.331;True;17170;8944;8161;7998;3977;3992;9172;4967;4169
1100155;Ouro Preto do Oeste;RO;11;Norte;LESTE RONDONIENSE;JI-PARANA;-10.716;-62.248;True;36040;17655;18231;25958;12363;13480;10082;5292;4751
1100189;Pimenta Bueno;RO;11;Norte;LESTE RONDONIENSE;VILHENA;-11.673;-61.193;True;32893;16608;16280;28019;13972;14042;4874;2636;2238
1100205;Porto Velho;RO;11;Norte;MADEIRA-GUAPORE;PORTO VELHO;-8.762;-63.904;True;369345;182094;184172;304228;148388;154452;65117;33706;29720
1100254;Presidente Médici;RO;11;Norte;LESTE RONDONIENSE;JI-PARANA;-11.176;-61.901;True;22197;11252;10935;12977;6338;6639;9220;4914;4296
1100262;Rio Crespo;RO;11;Norte;LESTE RONDONIENSE;ARIQUEMES;-9.705;-62.9;True;3174;1710;1462;973;480;493;2201;1230;969
1100288;Rolim de Moura;RO;11;Norte;LESTE RONDONIENSE;CACOAL;-11.733;-61.778;True;48894;24481;24320;39086;19335;19661;9808;5146;4659
1100296;Santa Luzia D'Oeste;RO;11;Norte;LESTE RONDONIENSE;CACOAL;-11.902;-61.779;True;9264;4782;4465;4503;2238;2252;4761;2544;2213
1100304;Vilhena;RO;11;Norte;LESTE RONDONIENSE;VILHENA;-12.741;-60.146;True;66746;33126;33523;63346;31195;32060;3400;1931;1463
1100320;São Miguel do Guaporé;RO;11;Norte;LESTE RONDONIENSE;ALVORADA D'OESTE;-11.681;-62.684;True;22622;11893;10696;7392;3655;3715;15230;8238;6981
1100338;Nova Mamoré;RO;11;Norte;MADEIRA-GUAPORE;PORTO VELHO;-10.411;-65.331;True;21162;10418;9444;12159;5880;5750;9003;4538;3694
1100346;Alvorada D'Oeste;RO;11;Norte;LESTE RONDONIENSE;ALVORADA D'OESTE;-11.408;-62.389;True;16485;8443;8001;8316;4045;4230;8169;4398;3771
1100379;Alto Alegre dos Parecis;RO;11;Norte;LESTE RONDONIENSE;CACOAL;-12.128;-61.851;True;11615;6123;5458;3417;1705;1701;8198;4418;3757
1100403;Alto Paraíso;RO;11;Norte;LESTE RONDONIENSE;ARIQUEMES;-9.713;-63.321;True;16758;8871;7664;7649;3896;3715;9109;4975;3949
1100452;Buritis;RO;11;Norte;MADEIRA-GUAPORE;PORTO VELHO;-10.212;-63.829;True;33072;17180;15792;18328;9229;9021;14744;7951;6771
1100502;Novo Horizonte do Oeste;RO;11;Norte;LESTE RONDONIENSE;CACOAL;-11.71;-62;True;9648;5006;4585;1466;694;728;8182;4312;3857
1100601;Cacaulândia;RO;11;Norte;LESTE RONDONIENSE;ARIQUEMES;-10.34;-62.896;True;5553;2835;2564;1818;822;851;3735;2013;1713
1100700;Campo Novo de Rondônia;RO;11;Norte;MADEIRA-GUAPORE;PORTO VELHO;-10.571;-63.627;True;12455;6450;5549;3177;1604;1549;9278;4846;4000
1100809;Candeias do Jamari;RO;11;Norte;MADEIRA-GUAPORE;PORTO VELHO;-8.791;-63.701;True;16736;8530;7871;9922;4847;4874;6814;3683;2997
1100908;Castanheiras;RO;11;Norte;LESTE RONDONIENSE;CACOAL;-11.427;-61.95;True;3624;1851;1752;856;387;469;2768;1464;1283
1100924;Chupinguaia;RO;11;Norte;LESTE RONDONIENSE;VILHENA;-12.552;-60.9;True;7456;3970;3480;2535;1345;1187;4921;2625;2293
1100940;Cujubim;RO;11;Norte;MADEIRA-GUAPORE;PORTO VELHO;-9.363;-62.585;True;13857;7430;6291;9599;5069;4457;4258;2361;1834
1101005;Governador Jorge Teixeira;RO;11;Norte;LESTE RONDONIENSE;JI-PARANA;-10.61;-62.737;True;11432;6044;5361;2533;1220;1306;8899;4824;4055
1101104;Itapuã do Oeste;RO;11;Norte;MADEIRA-GUAPORE;PORTO VELHO;-9.205;-63.18;True;7905;4203;3675;4743;2438;2278;3162;1765;1397
1101203;Ministro Andreazza;RO;11;Norte;LESTE RONDONIENSE;CACOAL;-11.196;-61.517;True;10343;5345;4998;3270;1663;1607;7073;3682;3391
1101302;Mirante da Serra;RO;11;Norte;LESTE RONDONIENSE;JI-PARANA;-11.03;-62.675;True;12086;6140;5875;6322;3086;3184;5764;3054;2691
1101401;Monte Negro;RO;11;Norte;LESTE RONDONIENSE;ARIQUEMES;-10.246;-63.29;True;12357;6427;5743;6059;2982;2974;6298;3445;2769
1101435;Nova União;RO;11;Norte;LESTE RONDONIENSE;JI-PARANA;-10.904;-62.561;True;7750;4137;3570;1413;691;722;6337;3446;2848
1101450;Parecis;RO;11;Norte;LESTE RONDONIENSE;VILHENA;-12.175;-61.603;True;4583;2494;2089;1731;928;803;2852;1566;1286
1101468;Pimenteiras do Oeste;RO;11;Norte;LESTE RONDONIENSE;COLORADO DO OESTE;-13.483;-61.047;True;2358;1271;1087;1333;677;656;1025;594;431
1101476;Primavera de Rondônia;RO;11;Norte;LESTE RONDONIENSE;VILHENA;-11.828;-61.321;True;3704;1952;1752;1276;660;616;2428;1292;1136
1101484;São Felipe D'Oeste;RO;11;Norte;LESTE RONDONIENSE;VILHENA;-11.903;-61.502;True;6286;3291;2989;1444;739;705;4842;2552;2284
1101492;São Francisco do Guaporé;RO;11;Norte;MADEIRA-GUAPORE;GUAJARA-MIRIM;-12.062;-63.569;True;15710;8299;7373;8243;4180;4046;7467;4119;3327
1101500;Seringueiras;RO;11;Norte;LESTE RONDONIENSE;ALVORADA D'OESTE;-11.798;-63.031;True;11757;6162;5500;3928;1957;1911;7829;4205;3589
1101559;Teixeirópolis;RO;11;Norte;LESTE RONDONIENSE;JI-PARANA;-10.918;-62.249;True;4919;2551;2367;1249;600;649;3670;1951;1718
1101609;Theobroma;RO;11;Norte;LESTE RONDONIENSE;JI-PARANA;-10.244;-62.355;True;9952;5176;4574;1789;889;894;8163;4287;3680
1101708;Urupá;RO;11;Norte;LESTE RONDONIENSE;JI-PARANA;-11.125;-62.376;True;13381;7007;6366;4856;2420;2431;8525;4587;3935
1101757;Vale do Anari;RO;11;Norte;LESTE RONDONIENSE;ARIQUEMES;-9.863;-62.186;True;8751;4643;4097;2361;1156;1203;6390;3487;2894
1101807;Vale do Paraíso;RO;11;Norte;LESTE RONDONIENSE;JI-PARANA;-10.449;-62.134;True;8742;4499;4211;2326;1134;1175;6416;3365;3036
1200013;Acrelândia;AC;12;Norte;VALE DO ACRE;RIO BRANCO;-9.828;-66.883;True;11520;6088;5432;5470;2724;2746;6050;3364;2686
1200054;Assis Brasil;AC;12;Norte;VALE DO ACRE;BRASILEIA;-10.941;-69.567;True;5351;2743;2608;2956;1454;1502;2395;1289;1106
1200104;Brasiléia;AC;12;Norte;VALE DO ACRE;BRASILEIA;-11.01;-68.748;True;19065;9852;9159;12243;6102;6134;6822;3750;3025
1200138;Bujari;AC;12;Norte;VALE DO ACRE;RIO BRANCO;-9.831;-67.952;True;6543;3521;3001;3034;1517;1511;3509;2004;1490
1200179;Capixaba;AC;12;Norte;VALE DO ACRE;RIO BRANCO;-10.573;-67.676;True;8446;4478;3863;3154;1558;1579;5292;2920;2284
1200203;Cruzeiro do Sul;AC;12;Norte;VALE DO JURUA;CRUZEIRO DO SUL;-7.631;-72.67;True;73948;36630;36697;50950;24684;25992;22998;11946;10705
1200252;Epitaciolândia;AC;12;Norte;VALE DO ACRE;BRASILEIA;-11.029;-68.741;True;13434;6812;6598;9227;4465;4754;4207;2347;1844
1200302;Feijó;AC;12;Norte;VALE DO JURUA;TARAUACA;-8.164;-70.354;True;31288;16179;15100;15726;7750;7976;15562;8429;7124
1200328;Jordão;AC;12;Norte;VALE DO JURUA;TARAUACA;-9.434;-71.884;True;6059;3150;2907;1735;873;862;4324;2277;2045
1200336;Mâncio Lima;AC;12;Norte;VALE DO JURUA;CRUZEIRO DO SUL;-7.614;-72.896;True;13785;7042;6631;8164;4074;4090;5621;2968;2541
1200344;Manoel Urbano;AC;12;Norte;VALE DO ACRE;SENA MADUREIRA;-8.839;-69.26;True;7148;3799;3347;4153;2113;2038;2995;1686;1309
1200351;Marechal Thaumaturgo;AC;12;Norte;VALE DO JURUA;CRUZEIRO DO SUL;-8.941;-72.792;True;13061;6837;6065;3238;1695;1531;9823;5142;4534
1200385;Plácido de Castro;AC;12;Norte;VALE DO ACRE;RIO BRANCO;-10.276;-67.15;True;17258;9022;8158;8866;4497;4349;8392;4525;3809
1200393;Porto Walter;AC;12;Norte;VALE DO JURUA;CRUZEIRO DO SUL;-8.269;-72.744;True;8170;4266;3827;2709;1377;1332;5461;2889;2495
1200401;Rio Branco;AC;12;Norte;VALE DO ACRE;RIO BRANCO;-9.975;-67.81;True;290639;141618;148610;269505;129637;139535;21134;11981;9075
1200427;Rodrigues Alves;AC;12;Norte;VALE DO JURUA;CRUZEIRO DO SUL;-7.742;-72.647;True;12428;6411;5914;3674;1773;1853;8754;4638;4061
1200435;Santa Rosa do Purus;AC;12;Norte;VALE DO ACRE;SENA MADUREIRA;-9.433;-70.493;True;3948;2056;1857;1425;764;641;2523;1292;1216
1200450;Senador Guiomard;AC;12;Norte;VALE DO ACRE;RIO BRANCO;-10.151;-67.736;True;18863;9689;8987;11280;5558;5696;7583;4131;3291
1200500;Sena Madureira;AC;12;Norte;VALE DO ACRE;SENA MADUREIRA;-9.066;-68.657;True;34230;17761;16231;21356;10736;10598;12874;7025;5633
1200609;Tarauacá;AC;12;Norte;VALE DO JURUA;TARAUACA;-8.161;-70.766;True;32171;16480;15429;16608;8164;8290;15563;8316;7139
1200708;Xapuri;AC;12;Norte;VALE DO ACRE;BRASILEIA;-10.652;-68.504;True;14314;7355;6892;7366;3635;3731;6948;3720;3161
1200807;Porto Acre;AC;12;Norte;VALE DO ACRE;RIO BRANCO;-9.588;-67.533;True;13716;7212;6439;1841;937;904;11875;6275;5535
1300029;Alvarães;AM;13;Norte;CENTRO AMAZONENSE;TEFE;-3.221;-64.804;True;13010;6703;6161;6985;3586;3378;6025;3117;2783
1300060;Amaturá;AM;13;Norte;SUDOESTE AMAZONENSE;ALTO SOLIMOES;-3.364;-68.198;True;8384;4245;3912;4731;2413;2282;3653;1832;1630
1300086;Anamã;AM;13;Norte;CENTRO AMAZONENSE;COARI;-3.58;-61.404;True;8152;4356;3792;3304;1725;1579;4848;2631;2213
1300102;Anori;AM;13;Norte;CENTRO AMAZONENSE;COARI;-3.773;-61.644;True;13834;7227;6504;8651;4354;4221;5183;2873;2283
1300144;Apuí;AM;13;Norte;SUL AMAZONENSE;MADEIRA;-7.197;-59.891;True;17451;9473;7664;9264;4768;4261;8187;4705;3403
1300201;Atalaia do Norte;AM;13;Norte;SUDOESTE AMAZONENSE;ALTO SOLIMOES;-4.372;-70.192;True;13682;6972;6675;5796;2942;2850;7886;4030;3825
1300300;Autazes;AM;13;Norte;CENTRO AMAZONENSE;MANAUS;-3.58;-59.131;True;29907;15273;13417;12634;6263;6203;17273;9010;7214
1300409;Barcelos;AM;13;Norte;NORTE AMAZONENSE;RIO NEGRO;-0.975;-62.924;True;24567;12440;11824;6802;3352;3393;17765;9088;8431
1300508;Barreirinha;AM;13;Norte;CENTRO AMAZONENSE;PARINTINS;-2.793;-57.07;True;26645;13978;12661;11800;6046;5752;14845;7932;6909
1300607;Benjamin Constant;AM;13;Norte;SUDOESTE AMAZONENSE;ALTO SOLIMOES;-4.383;-70.031;True;29268;14874;14294;18598;9326;9246;10670;5548;5048
1300631;Beruri;AM;13;Norte;CENTRO AMAZONENSE;COARI;-3.898;-61.373;True;13809;7009;6355;7805;3870;3626;6004;3139;2729
1300680;Boa Vista do Ramos;AM;13;Norte;CENTRO AMAZONENSE;PARINTINS;-2.97;-57.59;True;13138;6934;6186;6665;3378;3287;6473;3556;2899
1300706;Boca do Acre;AM;13;Norte;SUL AMAZONENSE;BOCA DO ACRE;-8.752;-67.398;True;29818;15046;13779;18070;8969;8597;11748;6077;5182
1300805;Borba;AM;13;Norte;SUL AMAZONENSE;MADEIRA;-4.388;-59.594;True;31098;16297;14691;14082;7111;6937;17016;9186;7754
1300839;Caapiranga;AM;13;Norte;CENTRO AMAZONENSE;COARI;-3.328;-61.209;True;10547;5462;4780;4613;2325;2027;5934;3137;2753
1300904;Canutama;AM;13;Norte;SUL AMAZONENSE;PURUS;-6.534;-64.383;True;11463;6031;5322;5816;2943;2850;5647;3088;2472
1301001;Carauari;AM;13;Norte;SUDOESTE AMAZONENSE;JURUA;-4.883;-66.896;True;25110;12709;11961;18404;9224;8911;6706;3485;3050
1301100;Careiro;AM;13;Norte;CENTRO AMAZONENSE;MANAUS;-3.768;-60.369;True;31070;16548;13952;6891;3483;3354;24179;13065;10598
1301159;Careiro da Várzea;AM;13;Norte;CENTRO AMAZONENSE;MANAUS;-3.221;-59.826;True;23023;11605;10285;797;363;376;22226;11242;9909
1301209;Coari;AM;13;Norte;CENTRO AMAZONENSE;COARI;-4.085;-63.141;True;65222;32752;30397;43262;21243;20667;21960;11509;9730
1301308;Codajás;AM;13;Norte;CENTRO AMAZONENSE;COARI;-3.837;-62.057;True;16025;8086;7509;11556;5717;5518;4469;2369;1991
1301407;Eirunepé;AM;13;Norte;SUDOESTE AMAZONENSE;JURUA;-6.66;-69.874;True;29411;15056;14121;20742;10492;10191;8669;4564;3930
1301506;Envira;AM;13;Norte;SUDOESTE AMAZONENSE;JURUA;-7.433;-70.023;True;16438;8565;7860;9736;4947;4786;6702;3618;3074
1301605;Fonte Boa;AM;13;Norte;SUDOESTE AMAZONENSE;ALTO SOLIMOES;-2.514;-66.092;True;19726;10080;9321;12892;6591;6289;6834;3489;3032
1301654;Guajará;AM;13;Norte;SUDOESTE AMAZONENSE;JURUA;-7.546;-72.584;True;14102;7234;6521;6543;3246;3230;7559;3988;3291
1301704;Humaitá;AM;13;Norte;SUL AMAZONENSE;MADEIRA;-7.506;-63.021;True;38559;20101;18289;28079;14372;13634;10480;5729;4655
1301803;Ipixuna;AM;13;Norte;SUDOESTE AMAZONENSE;JURUA;-7.051;-71.695;True;17177;8927;8127;7313;3724;3579;9864;5203;4548
1301852;Iranduba;AM;13;Norte;CENTRO AMAZONENSE;MANAUS;-3.285;-60.186;True;32869;17017;15719;12026;5993;5980;20843;11024;9739
1301902;Itacoatiara;AM;13;Norte;CENTRO AMAZONENSE;ITACOATIARA;-3.143;-58.444;True;84676;43272;40701;55404;27515;27771;29272;15757;12930
1301951;Itamarati;AM;13;Norte;SUDOESTE AMAZONENSE;JURUA;-6.425;-68.253;True;8078;4249;3799;4317;2226;2076;3761;2023;1723
1302009;Itapiranga;AM;13;Norte;CENTRO AMAZONENSE;ITACOATIARA;-2.749;-58.022;True;9141;4719;4407;7061;3591;3460;2080;1128;947
1302108;Japurá;AM;13;Norte;NORTE AMAZONENSE;JAPURA;-1.826;-66.599;True;5281;2778;2427;2512;1309;1194;2769;1469;1233
1302207;Juruá;AM;13;Norte;SUDOESTE AMAZONENSE;JURUA;-3.481;-66.069;True;8658;4484;4073;4660;2398;2253;3998;2086;1820
1302306;Jutaí;AM;13;Norte;SUDOESTE AMAZONENSE;ALTO SOLIMOES;-2.747;-66.767;True;17129;8912;8150;9700;4955;4738;7429;3957;3412
1302405;Lábrea;AM;13;Norte;SUL AMAZONENSE;PURUS;-7.259;-64.798;True;36909;19327;17475;21943;11145;10770;14966;8182;6705
1302504;Manacapuru;AM;13;Norte;CENTRO AMAZONENSE;MANAUS;-3.3;-60.621;True;82309;41908;39376;54388;27073;27027;27921;14835;12349
1302553;Manaquiri;AM;13;Norte;CENTRO AMAZONENSE;MANAUS;-3.428;-60.459;True;19164;9975;8782;5205;2611;2455;13959;7364;6327
1302603;Manaus;AM;13;Norte;CENTRO AMAZONENSE;MANAUS;-3.102;-60.025;True;1646602;783817;824331;1636837;778553;820205;9765;5264;4126
1302702;Manicoré;AM;13;Norte;SUL AMAZONENSE;MADEIRA;-5.809;-61.3;True;44327;23549;20640;19625;9831;9763;24702;13718;10877
1302801;Maraã;AM;13;Norte;NORTE AMAZONENSE;JAPURA;-1.856;-65.581;True;17507;9049;8295;7097;3546;3518;10410;5503;4777
1302900;Maués;AM;13;Norte;CENTRO AMAZONENSE;PARINTINS;-3.384;-57.719;True;47020;24270;22298;24104;11903;12111;22916;12367;10187
1303007;Nhamundá;AM;13;Norte;CENTRO AMAZONENSE;PARINTINS;-2.186;-56.713;True;17553;8997;8477;7211;3628;3577;10342;5369;4900
1303106;Nova Olinda do Norte;AM;13;Norte;CENTRO AMAZONENSE;ITACOATIARA;-3.888;-59.094;True;29184;14826;13663;13227;6459;6354;15957;8367;7309
1303205;Novo Airão;AM;13;Norte;NORTE AMAZONENSE;RIO NEGRO;-2.621;-60.944;True;14630;7297;7239;10794;5317;5424;3836;1980;1815
1303304;Novo Aripuanã;AM;13;Norte;SUL AMAZONENSE;MADEIRA;-5.121;-60.38;True;18196;9983;8052;10804;5613;5145;7392;4370;2907
1303403;Parintins;AM;13;Norte;CENTRO AMAZONENSE;PARINTINS;-2.628;-56.736;True;102044;52294;49614;66236;32976;33151;35808;19318;16463
1303502;Pauini;AM;13;Norte;SUL AMAZONENSE;BOCA DO ACRE;-7.714;-66.976;True;18325;9358;8699;9118;4565;4353;9207;4793;4346
1303536;Presidente Figueiredo;AM;13;Norte;CENTRO AMAZONENSE;RIO PRETO DA EVA;-2.034;-60.025;True;24360;11903;10231;11580;5599;5504;12780;6304;4727
1303569;Rio Preto da Eva;AM;13;Norte;CENTRO AMAZONENSE;RIO PRETO DA EVA;-2.699;-59.7;True;24858;12960;11042;12722;6320;6179;12136;6640;4863
1303601;Santa Isabel do Rio Negro;AM;13;Norte;NORTE AMAZONENSE;RIO NEGRO;-0.414;-65.019;True;16921;8564;8090;6363;3173;3140;10558;5391;4950
1303700;Santo Antônio do Içá;AM;13;Norte;SUDOESTE AMAZONENSE;ALTO SOLIMOES;-3.102;-67.94;True;29249;14707;14357;11733;5922;5785;17516;8785;8572
1303809;São Gabriel da Cachoeira;AM;13;Norte;NORTE AMAZONENSE;RIO NEGRO;-0.13;-67.089;True;39129;18355;17179;17094;7283;7176;22035;11072;10003
1303908;São Paulo de Olivença;AM;13;Norte;SUDOESTE AMAZONENSE;ALTO SOLIMOES;-3.378;-68.873;True;30727;15847;14486;12698;6483;5905;18029;9364;8581
1303957;São Sebastião do Uatumã;AM;13;Norte;CENTRO AMAZONENSE;PARINTINS;-2.572;-57.871;True;8731;4581;4046;6363;3326;3037;2368;1255;1009
1304005;Silves;AM;13;Norte;CENTRO AMAZONENSE;ITACOATIARA;-2.839;-58.209;True;8211;4422;3780;3833;2002;1828;4378;2420;1952
1304062;Tabatinga;AM;13;Norte;SUDOESTE AMAZONENSE;ALTO SOLIMOES;-4.253;-69.938;True;45293;22911;22364;30998;15487;15493;14295;7424;6871
1304104;Tapauá;AM;13;Norte;SUL AMAZONENSE;PURUS;-5.628;-63.183;True;19453;9785;8944;10013;5121;4864;9440;4664;4080
1304203;Tefé;AM;13;Norte;CENTRO AMAZONENSE;TEFE;-3.354;-64.711;True;62920;31931;30140;47257;23707;23114;15663;8224;7026
1304237;Tonantins;AM;13;Norte;SUDOESTE AMAZONENSE;ALTO SOLIMOES;-2.873;-67.802;True;19090;9917;9113;6296;3228;3068;12794;6689;6045
1304260;Uarini;AM;13;Norte;CENTRO AMAZONENSE;TEFE;-2.99;-65.108;True;9859;4997;4486;5304;2747;2544;4555;2250;1942
1304302;Urucará;AM;13;Norte;CENTRO AMAZONENSE;PARINTINS;-2.536;-57.76;True;15716;7910;7070;10776;5304;4897;4940;2606;2173
1304401;Urucurituba;AM;13;Norte;CENTRO AMAZONENSE;ITACOATIARA;-3.131;-58.155;True;17184;9213;7945;8749;4557;4186;8435;4656;3759
1400027;Amajari;RR;14;Norte;NORTE DE RORAIMA;BOA VISTA;3.652;-61.371;True;7586;3634;3064;1159;510;482;6427;3124;2582
1400050;Alto Alegre;RR;14;Norte;NORTE DE RORAIMA;BOA VISTA;2.98;-61.292;True;14386;7592;6580;5198;2668;2497;9188;4924;4083
1400100;Boa Vista;RR;14;Norte;NORTE DE RORAIMA;BOA VISTA;2.82;-60.673;True;249853;119607;122502;246156;117650;121091;3697;1957;1411
1400159;Bonfim;RR;14;Norte;NORTE DE RORAIMA;NORDESTE DE RORAIMA;3.36;-59.833;True;10231;5388;4665;3663;1836;1817;6568;3552;2848
1400175;Cantá;RR;14;Norte;NORTE DE RORAIMA;NORDESTE DE RORAIMA;2.61;-60.597;True;11119;5878;5004;1845;908;931;9274;4970;4073
1400209;Caracaraí;RR;14;Norte;SUL DE RORAIMA;CARACARAI;1.816;-61.128;True;17981;9582;8361;9870;5094;4776;8111;4488;3585
1400233;Caroebe;RR;14;Norte;SUL DE RORAIMA;SUDESTE DE RORAIMA;0.884;-59.696;True;7086;3675;3246;2726;1296;1309;4360;2379;1937
1400282;Iracema;RR;14;Norte;SUL DE RORAIMA;CARACARAI;2.182;-61.041;True;5863;2842;2522;4138;1999;1910;1725;843;612
1400308;Mucajaí;RR;14;Norte;SUL DE RORAIMA;CARACARAI;2.43;-60.9;True;12546;6447;5776;7760;3837;3818;4786;2610;1958
1400407;Normandia;RR;14;Norte;NORTE DE RORAIMA;NORDESTE DE RORAIMA;3.881;-59.623;True;7118;3742;3353;2044;1063;974;5074;2679;2379
1400456;Pacaraima;RR;14;Norte;NORTE DE RORAIMA;BOA VISTA;4.431;-61.146;True;8640;4267;3852;4032;1844;1738;4608;2423;2114
1400472;Rorainópolis;RR;14;Norte;SUL DE RORAIMA;SUDESTE DE RORAIMA;0.946;-60.418;True;24466;12860;11331;10114;5108;4939;14352;7752;6392
1400506;São João da Baliza;RR;14;Norte;SUL DE RORAIMA;SUDESTE DE RORAIMA;0.951;-59.911;True;5727;2898;2618;3993;1911;1877;1734;987;741
1400605;São Luiz;RR;14;Norte;SUL DE RORAIMA;SUDESTE DE RORAIMA;1.005;-60.159;True;5720;3011;2626;3563;1822;1714;2157;1189;912
1400704;Uiramutã;RR;14;Norte;NORTE DE RORAIMA;NORDESTE DE RORAIMA;4.596;-60.168;True;7403;3852;3546;728;405;323;6675;3447;3223
1500107;Abaetetuba;PA;15;Norte;NORDESTE PARAENSE;CAMETA;-1.718;-48.883;True;132222;66743;64335;77792;38253;38921;54430;28490;25414
1500131;Abel Figueiredo;PA;15;Norte;SUDESTE PARAENSE;PARAGOMINAS;-4.954;-48.393;True;6592;3452;3140;5778;2993;2785;814;459;355
1500206;Acará;PA;15;Norte;NORDESTE PARAENSE;TOME-ACU;-1.961;-48.197;True;47923;25224;22320;10854;5326;5495;37069;19898;16825
1500305;Afuá;PA;15;Norte;MARAJO;FUROS DE BREVES;-0.157;-50.387;True;31183;15922;14230;8956;4261;4329;22227;11661;9901
1500347;Água Azul do Norte;PA;15;Norte;SUDESTE PARAENSE;PARAUAPEBAS;-6.791;-50.467;True;28658;15780;12730;4598;2443;2155;24060;13337;10575
1500404;Alenquer;PA;15;Norte;BAIXO AMAZONAS;SANTAREM;-1.942;-54.738;True;52661;26769;25264;30046;14572;15158;22615;12197;10106
1500503;Almeirim;PA;15;Norte;BAIXO AMAZONAS;ALMEIRIM;-1.523;-52.582;True;30903;16057;14668;18458;9224;9121;12445;6833;5547
1500602;Altamira;PA;15;Norte;SUDOESTE PARAENSE;ALTAMIRA;-3.203;-52.206;True;92105;46788;44918;68665;33655;34910;23440;13133;10008
1500701;Anajás;PA;15;Norte;MARAJO;FUROS DE BREVES;-0.987;-49.94;True;24942;13107;11626;9988;5093;4874;14954;8014;6752
1500800;Ananindeua;PA;15;Norte;METROPOLITANA DE BELEM;BELEM;-1.366;-48.372;True;484278;;;;;;;;
1500859;Anapu;PA;15;Norte;SUDOESTE PARAENSE;ALTAMIRA;-3.472;-51.198;True;17787;9296;7759;7548;3653;3531;10239;5643;4228
1500909;Augusto Corrêa;PA;15;Norte;NORDESTE PARAENSE;BRAGANTINA;-1.022;-46.645;False;37086;19069;17610;16673;8282;8064;20413;10787;9546
1500958;Aurora do Pará;PA;15;Norte;NORDESTE PARAENSE;GUAMA;-2.134;-47.563;True;21239;11032;10092;6479;3150;3329;14760;7882;6763
1501006;Aveiro;PA;15;Norte;SUDOESTE PARAENSE;ITAITUBA;-3.606;-55.332;True;18830;9911;8613;3510;1854;1656;15320;8057;6957
1501105;Bagre;PA;15;Norte;MARAJO;PORTEL;-1.9;-50.164;True;18580;9629;8926;7769;3980;3789;10811;5649;5137
1501204;Baião;PA;15;Norte;NORDESTE PARAENSE;CAMETA;-2.791;-49.672;True;26190;13585;12426;14264;7237;6989;11926;6348;5437
1501253;Bannach;PA;15;Norte;SUDESTE PARAENSE;SAO FELIX DO XINGU;-7.348;-50.396;True;3812;2094;1689;1352;702;632;2460;1392;1057
1501303;Barcarena;PA;15;Norte;METROPOLITANA DE BELEM;BELEM;-1.506;-48.626;True;84560;41407;39426;31362;15121;15120;53198;26286;24306
1501402;Belém;PA;15;Norte;METROPOLITANA DE BELEM;BELEM;-1.456;-48.504;True;1408847;;;;;;;;
1501451;Belterra;PA;15;Norte;BAIXO AMAZONAS;SANTAREM;-2.636;-54.937;True;12707;6009;5468;5434;2371;2356;7273;3638;3112
1501501;Benevides;PA;15;Norte;METROPOLITANA DE BELEM;BELEM;-1.361;-48.245;True;43282;21118;21254;25078;12043;12411;18204;9075;8843
1501576;Bom Jesus do Tocantins;PA;15;Norte;SUDESTE PARAENSE;PARAGOMINAS;-5.051;-48.609;True;13145;6944;6201;7402;3703;3699;5743;3241;2502
1501600;Bonito;PA;15;Norte;NORDESTE PARAENSE;BRAGANTINA;-1.363;-47.307;True;11279;5568;5110;3538;1588;1594;7741;3980;3516
1501709;Bragança;PA;15;Norte;NORDESTE PARAENSE;BRAGANTINA;-1.063;-46.773;False;101728;51175;49712;64761;31670;32653;36967;19505;17059
1501725;Brasil Novo;PA;15;Norte;SUDOESTE PARAENSE;ALTAMIRA;-3.262;-52.668;True;18749;9295;8172;7721;3439;3528;11028;5856;4644
1501758;Brejo Grande do Araguaia;PA;15;Norte;SUDESTE PARAENSE;MARABA;-5.699;-48.413;True;7444;3852;3568;4298;2135;2163;3146;1717;1405
1501782;Breu Branco;PA;15;Norte;SUDESTE PARAENSE;TUCURUI;-4.009;-49.461;True;47069;24718;22307;23684;12004;11672;23385;12714;10635
1501808;Breves;PA;15;Norte;MARAJO;FUROS DE BREVES;-1.682;-50.48;True;94458;48068;44520;49960;24902;24487;44498;23166;20033
1501907;Bujaru;PA;15;Norte;METROPOLITANA DE BELEM;CASTANHAL;-1.515;-48.045;True;22535;11602;10860;8236;3995;4218;14299;7607;6642
1501956;Cachoeira do Piriá;PA;15;Norte;NORDESTE PARAENSE;GUAMA;-1.671;-46.529;True;17649;9206;8396;3864;1992;1870;13785;7214;6526
1502004;Cachoeira do Arari;PA;15;Norte;MARAJO;ARARI;-1.011;-48.963;True;18995;9714;9068;7579;3776;3772;11416;5938;5296
1502103;Cametá;PA;15;Norte;NORDESTE PARAENSE;CAMETA;-2.244;-49.496;True;110323;56667;53565;47984;23741;24238;62339;32926;29327
1502152;Canaã dos Carajás;PA;15;Norte;SUDESTE PARAENSE;PARAUAPEBAS;-6.497;-49.878;True;23757;12421;11238;18153;9298;8807;5604;3123;2431
1502202;Capanema;PA;15;Norte;NORDESTE PARAENSE;BRAGANTINA;-1.196;-47.181;True;61350;30141;31136;49117;23749;25337;12233;6392;5799
1502301;Capitão Poço;PA;15;Norte;NORDESTE PARAENSE;GUAMA;-1.745;-47.065;True;50839;25776;24481;24927;12261;12400;25912;13515;12081
1502400;Castanhal;PA;15;Norte;METROPOLITANA DE BELEM;CASTANHAL;-1.297;-47.922;True;152126;73242;76948;137226;65517;69935;14900;7725;7013
1502509;Chaves;PA;15;Norte;MARAJO;ARARI;-0.16;-49.988;True;19368;9739;8669;1986;1028;958;17382;8711;7711
1502608;Colares;PA;15;Norte;NORDESTE PARAENSE;SALGADO;-0.937;-48.282;True;10981;5673;5279;3432;1739;1686;7549;3934;3593
1502707;Conceição do Araguaia;PA;15;Norte;SUDESTE PARAENSE;CONCEICAO DO ARAGUAIA;-8.258;-49.265;True;45267;23070;21808;31104;15268;15650;14163;7802;6158
1502756;Concórdia do Pará;PA;15;Norte;NORDESTE PARAENSE;TOME-ACU;-1.991;-47.949;True;21422;11141;10257;12155;6082;6052;9267;5059;4205
1502764;Cumaru do Norte;PA;15;Norte;SUDESTE PARAENSE;SAO FELIX DO XINGU;-7.825;-50.773;True;10452;5777;4405;2500;1333;1141;7952;4444;3264
1502772;Curionópolis;PA;15;Norte;SUDESTE PARAENSE;PARAUAPEBAS;-6.091;-49.541;True;17769;9376;8352;12101;6095;5975;5668;3281;2377
1502806;Curralinho;PA;15;Norte;MARAJO;FUROS DE BREVES;-1.814;-49.795;True;25388;13348;11965;8976;4531;4445;16412;8817;7520
1502855;Curuá;PA;15;Norte;BAIXO AMAZONAS;SANTAREM;-1.888;-55.117;True;11928;6154;5404;5087;2547;2390;6841;3607;3014
1502905;Curuçá;PA;15;Norte;NORDESTE PARAENSE;SALGADO;-0.734;-47.855;False;33768;17216;16131;13027;6538;6350;20741;10678;9781
1502939;Dom Eliseu;PA;15;Norte;SUDESTE PARAENSE;PARAGOMINAS;-4.285;-47.505;True;38150;19258;18892;26231;13032;13199;11919;6226;5693
1502954;Eldorado dos Carajás;PA;15;Norte;SUDESTE PARAENSE;PARAUAPEBAS;-6.104;-49.355;True;28554;14974;13135;15271;7692;7375;13283;7282;5760
1503002;Faro;PA;15;Norte;BAIXO AMAZONAS;OBIDOS;-2.171;-56.745;True;17253;8653;8386;12995;6553;6437;4258;2100;1949
1503044;Floresta do Araguaia;PA;15;Norte;SUDESTE PARAENSE;CONCEICAO DO ARAGUAIA;-7.554;-49.713;True;14964;8023;6931;6097;3150;2942;8867;4873;3989
1503077;Garrafão do Norte;PA;15;Norte;NORDESTE PARAENSE;GUAMA;-1.934;-47.053;True;24619;12890;11674;8927;4448;4474;15692;8442;7200
1503093;Goianésia do Pará;PA;15;Norte;SUDESTE PARAENSE;PARAGOMINAS;-3.843;-49.097;True;27166;14116;12804;18590;9307;9199;8576;4809;3605
1503101;Gurupá;PA;15;Norte;MARAJO;PORTEL;-1.405;-51.64;True;24384;12783;11258;7307;3582;3596;17077;9201;7662
1503200;Igarapé-Açu;PA;15;Norte;NORDESTE PARAENSE;BRAGANTINA;-1.127;-47.618;True;33778;17171;16582;19868;9770;10098;13910;7401;6484
1503309;Igarapé-Miri;PA;15;Norte;NORDESTE PARAENSE;CAMETA;-1.975;-48.96;True;54673;27788;26519;25842;12620;13035;28831;15168;13484
1503408;Inhangapi;PA;15;Norte;METROPOLITANA DE BELEM;CASTANHAL;-1.43;-47.917;True;9592;5036;4556;2613;1309;1304;6979;3727;3252
1503457;Ipixuna do Pará;PA;15;Norte;NORDESTE PARAENSE;GUAMA;-2.558;-47.494;True;39563;19942;17666;9934;4653;4351;29629;15289;13315
1503507;Irituia;PA;15;Norte;NORDESTE PARAENSE;GUAMA;-1.769;-47.439;True;29746;15374;14181;6496;3131;3365;23250;12243;10816
1503606;Itaituba;PA;15;Norte;SUDOESTE PARAENSE;ITAITUBA;-4.276;-55.984;True;118194;61643;54970;82495;41522;40203;35699;20121;14767
1503705;Itupiranga;PA;15;Norte;SUDESTE PARAENSE;TUCURUI;-5.135;-49.327;True;42002;21793;19519;18496;9275;9075;23506;12518;10444
1503754;Jacareacanga;PA;15;Norte;SUDOESTE PARAENSE;ITAITUBA;-6.224;-57.754;True;37073;21623;15378;5691;3002;2681;31382;18621;12697
1503804;Jacundá;PA;15;Norte;SUDESTE PARAENSE;TUCURUI;-4.451;-49.116;True;51511;25474;26011;47447;23200;24231;4064;2274;1780
1503903;Juruti;PA;15;Norte;BAIXO AMAZONAS;OBIDOS;-2.152;-56.092;True;33775;17416;15761;12488;6234;6165;21287;11182;9596
1504000;Limoeiro do Ajuru;PA;15;Norte;NORDESTE PARAENSE;CAMETA;-1.895;-49.381;True;23284;12154;11130;5953;3005;2948;17331;9149;8182
1504059;Mãe do Rio;PA;15;Norte;NORDESTE PARAENSE;GUAMA;-2.06;-47.553;True;27614;13684;13699;22287;10993;11188;5327;2691;2511
1504109;Magalhães Barata;PA;15;Norte;NORDESTE PARAENSE;SALGADO;-0.795;-47.598;True;7650;3965;3586;3592;1804;1719;4058;2161;1867
1504208;Marabá;PA;15;Norte;SUDESTE PARAENSE;MARABA;-5.369;-49.118;True;196468;;;;;;;;
1504307;Maracanã;PA;15;Norte;NORDESTE PARAENSE;SALGADO;-0.765;-47.45;True;28296;14724;13429;11199;5557;5584;17097;9167;7845
1504406;Marapanim;PA;15;Norte;NORDESTE PARAENSE;SALGADO;-0.714;-47.694;True;26651;14062;12475;9256;4735;4491;17395;9327;7984
1504422;Marituba;PA;15;Norte;METROPOLITANA DE BELEM;BELEM;-1.355;-48.342;True;93416;46158;47106;81420;40133;41171;11996;6025;5935
1504455;Medicilândia;PA;15;Norte;SUDOESTE PARAENSE;ALTAMIRA;-3.446;-52.889;True;22624;12370;10138;7995;4029;3963;14629;8341;6175
1504505;Melgaço;PA;15;Norte;MARAJO;PORTEL;-1.804;-50.712;True;17845;9079;8072;4035;2036;1963;13810;7043;6109
1504604;Mocajuba;PA;15;Norte;NORDESTE PARAENSE;CAMETA;-2.584;-49.507;True;23258;11830;11248;16577;8189;8254;6681;3641;2994
1504703;Moju;PA;15;Norte;NORDESTE PARAENSE;TOME-ACU;-1.884;-48.769;True;63821;32668;29533;22137;10879;10867;41684;21789;18666
1504802;Monte Alegre;PA;15;Norte;BAIXO AMAZONAS;SANTAREM;-2.008;-54.069;True;61350;31178;28784;23700;11423;11811;37650;19755;16973
1504901;Muaná;PA;15;Norte;MARAJO;ARARI;-1.528;-49.217;True;28796;14657;13456;10991;5481;5402;17805;9176;8054
1504950;Nova Esperança do Piriá;PA;15;Norte;NORDESTE PARAENSE;GUAMA;-2.269;-46.966;True;22447;11871;10343;7899;3986;3784;14548;7885;6559
1504976;Nova Ipixuna;PA;15;Norte;SUDESTE PARAENSE;TUCURUI;-4.921;-49.077;True;14086;7287;6637;7961;4003;3950;6125;3284;2687
1505007;Nova Timboteua;PA;15;Norte;NORDESTE PARAENSE;BRAGANTINA;-1.206;-47.386;True;12103;6307;5788;4669;2294;2375;7434;4013;3413
1505031;Novo Progresso;PA;15;Norte;SUDOESTE PARAENSE;ITAITUBA;-7.147;-55.382;True;21598;11325;10024;17587;9166;8341;4011;2159;1683
1505064;Novo Repartimento;PA;15;Norte;SUDESTE PARAENSE;TUCURUI;-4.331;-49.796;True;51645;26741;23994;22957;11375;11393;28688;15366;12601
1505106;Óbidos;PA;15;Norte;BAIXO AMAZONAS;OBIDOS;-1.918;-55.518;True;46793;24010;22396;23874;11778;12006;22919;12232;10390
1505205;Oeiras do Pará;PA;15;Norte;NORDESTE PARAENSE;CAMETA;-2.003;-49.854;True;25420;13335;12081;10238;5167;5071;15182;8168;7010
1505304;Oriximiná;PA;15;Norte;BAIXO AMAZONAS;OBIDOS;-1.766;-55.866;True;55175;27675;26755;34189;16798;17175;20986;10877;9580
1505403;Ourém;PA;15;Norte;NORDESTE PARAENSE;GUAMA;-1.548;-47.119;True;15152;7714;7268;7573;3736;3788;7579;3978;3480
1505437;Ourilândia do Norte;PA;15;Norte;SUDESTE PARAENSE;SAO FELIX DO XINGU;-6.755;-51.084;True;20415;11115;9278;13830;7225;6585;6585;3890;2693
1505486;Pacajá;PA;15;Norte;SUDOESTE PARAENSE;ALTAMIRA;-3.838;-50.638;True;38365;20700;17612;13951;7067;6870;24414;13633;10742
1505494;Palestina do Pará;PA;15;Norte;SUDESTE PARAENSE;MARABA;-5.742;-48.317;True;7156;3742;3411;4199;2137;2062;2957;1605;1349
1505502;Paragominas;PA;15;Norte;SUDESTE PARAENSE;PARAGOMINAS;-2.995;-47.353;True;90819;45776;44618;69677;34565;34752;21142;11211;9866
1505536;Parauapebas;PA;15;Norte;SUDESTE PARAENSE;PARAUAPEBAS;-6.068;-49.902;True;133298;67524;64633;118847;59981;57914;14451;7543;6719
1505551;Pau D'Arco;PA;15;Norte;SUDESTE PARAENSE;REDENCAO;-7.833;-50.044;True;6466;3404;2877;3347;1693;1532;3119;1711;1345
1505601;Peixe-Boi;PA;15;Norte;NORDESTE PARAENSE;BRAGANTINA;-1.192;-47.314;True;7679;3958;3715;4376;2201;2169;3303;1757;1546
1505635;Piçarra;PA;15;Norte;SUDESTE PARAENSE;REDENCAO;-6.438;-48.872;True;12707;6163;5372;3387;1491;1511;9320;4672;3861
1505650;Placas;PA;15;Norte;BAIXO AMAZONAS;SANTAREM;-3.868;-54.22;True;17898;9562;8223;4077;2109;1968;13821;7453;6255
1505700;Ponta de Pedras;PA;15;Norte;MARAJO;ARARI;-1.39;-48.871;True;24276;12323;11470;11189;5351;5419;13087;6972;6051
1505809;Portel;PA;15;Norte;MARAJO;PORTEL;-1.936;-50.821;True;45586;23550;21777;22132;11089;11003;23454;12461;10774
1505908;Porto de Moz;PA;15;Norte;BAIXO AMAZONAS;ALMEIRIM;-1.748;-52.238;True;26489;13780;12325;13385;6796;6382;13104;6984;5943
1506005;Prainha;PA;15;Norte;BAIXO AMAZONAS;SANTAREM;-1.8;-53.48;True;26436;13510;12127;7705;3899;3753;18731;9611;8374
1506104;Primavera;PA;15;Norte;NORDESTE PARAENSE;BRAGANTINA;-0.943;-47.116;True;10463;5433;4980;6727;3463;3264;3736;1970;1716
1506112;Quatipuru;PA;15;Norte;NORDESTE PARAENSE;BRAGANTINA;-0.901;-47.006;False;12620;6422;5999;5871;2937;2874;6749;3485;3125
1506138;Redenção;PA;15;Norte;SUDESTE PARAENSE;REDENCAO;-8.029;-50.031;True;64583;31933;31755;61020;29981;30171;3563;1952;1584
1506161;Rio Maria;PA;15;Norte;SUDESTE PARAENSE;REDENCAO;-7.311;-50.048;True;16993;8654;8281;12971;6422;6499;4022;2232;1782
1506187;Rondon do Pará;PA;15;Norte;SUDESTE PARAENSE;PARAGOMINAS;-4.776;-48.067;True;45016;23102;21914;32430;16108;16322;12586;6994;5592
1506195;Rurópolis;PA;15;Norte;SUDOESTE PARAENSE;ITAITUBA;-4.096;-54.91;True;32950;17246;15649;12216;6075;6141;20734;11171;9508
1506203;Salinópolis;PA;15;Norte;NORDESTE PARAENSE;SALGADO;-0.629;-47.356;True;37066;18704;17964;33185;16736;16327;3881;1968;1637
1506302;Salvaterra;PA;15;Norte;MARAJO;ARARI;-0.753;-48.517;True;17077;8680;8392;11498;5783;5715;5579;2897;2677
1506351;Santa Bárbara do Pará;PA;15;Norte;METROPOLITANA DE BELEM;BELEM;-1.224;-48.294;True;13714;6912;6758;4219;2030;2154;9495;4882;4604
1506401;Santa Cruz do Arari;PA;15;Norte;MARAJO;ARARI;-0.664;-49.163;True;5921;2993;2798;3006;1491;1499;2915;1502;1299
1506500;Santa Isabel do Pará;PA;15;Norte;METROPOLITANA DE BELEM;CASTANHAL;-1.299;-48.161;True;51763;26786;24859;38458;18921;19513;13305;7865;5346
1506559;Santa Luzia do Pará;PA;15;Norte;NORDESTE PARAENSE;GUAMA;-1.517;-46.942;True;18123;9223;8662;9019;4460;4383;9104;4763;4279
1506583;Santa Maria das Barreiras;PA;15;Norte;SUDESTE PARAENSE;CONCEICAO DO ARAGUAIA;-8.855;-49.722;True;16012;8894;6931;4768;2477;2263;11244;6417;4668
1506609;Santa Maria do Pará;PA;15;Norte;NORDESTE PARAENSE;BRAGANTINA;-1.352;-47.576;True;22147;10884;10731;12049;5644;5995;10098;5240;4736
1506708;Santana do Araguaia;PA;15;Norte;SUDESTE PARAENSE;CONCEICAO DO ARAGUAIA;-9.505;-50.625;True;49053;25457;23503;28632;14354;14267;20421;11103;9236
1506807;Santarém;PA;15;Norte;BAIXO AMAZONAS;SANTAREM;-2.443;-54.708;True;274285;;;;;;;;
1506906;Santarém Novo;PA;15;Norte;NORDESTE PARAENSE;BRAGANTINA;-0.929;-47.397;True;6007;3186;2777;1694;887;803;4313;2299;1974
1507003;Santo Antônio do Tauá;PA;15;Norte;METROPOLITANA DE BELEM;CASTANHAL;-1.152;-48.129;True;24814;12302;12143;13546;6579;6811;11268;5723;5332
1507102;São Caetano de Odivelas;PA;15;Norte;NORDESTE PARAENSE;SALGADO;-0.75;-48.02;True;16179;8404;7681;6685;3416;3269;9494;4988;4412
1507151;São Domingos do Araguaia;PA;15;Norte;SUDESTE PARAENSE;MARABA;-5.538;-48.733;True;21094;10659;10166;13751;6783;6898;7343;3876;3268
1507201;São Domingos do Capim;PA;15;Norte;NORDESTE PARAENSE;GUAMA;-1.675;-47.775;True;27094;14069;12644;6226;3142;3084;20868;10927;9560
1507300;São Félix do Xingu;PA;15;Norte;SUDESTE PARAENSE;SAO FELIX DO XINGU;-6.645;-51.995;True;59238;31993;26828;24837;12688;12043;34401;19305;14785
1507409;São Francisco do Pará;PA;15;Norte;NORDESTE PARAENSE;BRAGANTINA;-1.169;-47.795;True;11913;6205;5698;4612;2306;2306;7301;3899;3392
1507458;São Geraldo do Araguaia;PA;15;Norte;SUDESTE PARAENSE;REDENCAO;-6.401;-48.555;True;24872;12522;12099;12938;6287;6639;11934;6235;5460
1507466;São João da Ponta;PA;15;Norte;NORDESTE PARAENSE;SALGADO;-0.85;-47.92;True;4715;2487;2228;1072;538;534;3643;1949;1694
1507474;São João de Pirabas;PA;15;Norte;NORDESTE PARAENSE;SALGADO;-0.769;-47.174;True;18919;9698;8915;10425;5305;5061;8494;4393;3854
1507508;São João do Araguaia;PA;15;Norte;SUDESTE PARAENSE;MARABA;-5.358;-48.791;True;11673;6103;5310;2541;1302;1239;9132;4801;4071
1507607;São Miguel do Guamá;PA;15;Norte;NORDESTE PARAENSE;GUAMA;-1.627;-47.483;True;42987;21689;21040;27185;13457;13641;15802;8232;7399
1507706;São Sebastião da Boa Vista;PA;15;Norte;MARAJO;FUROS DE BREVES;-1.718;-49.541;True;20500;10650;9799;8725;4435;4286;11775;6215;5513
1507755;Sapucaia;PA;15;Norte;SUDESTE PARAENSE;REDENCAO;-6.947;-49.682;True;5117;2750;2367;3229;1634;1595;1888;1116;772
1507805;Senador José Porfírio;PA;15;Norte;SUDOESTE PARAENSE;ALTAMIRA;-2.591;-51.954;True;14302;7398;6437;6278;3172;3031;8024;4226;3406
1507904;Soure;PA;15;Norte;MARAJO;ARARI;-0.717;-48.523;True;21395;10653;10574;19342;9582;9671;2053;1071;903
1507953;Tailândia;PA;15;Norte;NORDESTE PARAENSE;TOME-ACU;-2.947;-48.953;True;64281;32534;30022;45700;22596;21831;18581;9938;8191
1507961;Terra Alta;PA;15;Norte;NORDESTE PARAENSE;SALGADO;-1.038;-47.908;True;9861;4926;4547;4114;1992;1906;5747;2934;2641
1507979;Terra Santa;PA;15;Norte;BAIXO AMAZONAS;OBIDOS;-2.104;-56.487;True;15316;7840;7075;10569;5277;5070;4747;2563;2005
1508001;Tomé-Açu;PA;15;Norte;NORDESTE PARAENSE;TOME-ACU;-2.419;-48.152;True;47081;24045;22621;28451;14105;14108;18630;9940;8513
1508035;Tracuateua;PA;15;Norte;NORDESTE PARAENSE;BRAGANTINA;-1.072;-46.897;True;26129;13550;12253;6854;3475;3379;19275;10075;8874
1508050;Trairão;PA;15;Norte;SUDOESTE PARAENSE;ITAITUBA;-4.574;-55.944;True;16097;8751;7328;5906;3031;2875;10191;5720;4453
1508084;Tucumã;PA;15;Norte;SUDESTE PARAENSE;SAO FELIX DO XINGU;-6.748;-51.161;True;26513;13204;12411;20568;10080;9858;5945;3124;2553
1508100;Tucuruí;PA;15;Norte;SUDESTE PARAENSE;TUCURUI;-3.768;-49.673;True;89264;44426;44143;85426;42233;42498;3838;2193;1645
1508126;Ulianópolis;PA;15;Norte;SUDESTE PARAENSE;PARAGOMINAS;-3.756;-47.501;True;31881;16799;15082;24760;12850;11910;7121;3949;3172
1508159;Uruará;PA;15;Norte;SUDOESTE PARAENSE;ALTAMIRA;-3.718;-53.737;True;35076;18178;16724;19097;9431;9591;15979;8747;7133
1508209;Vigia;PA;15;Norte;NORDESTE PARAENSE;SALGADO;-0.858;-48.142;True;43847;22311;21342;30087;15066;14869;13760;7245;6473
1508308;Viseu;PA;15;Norte;NORDESTE PARAENSE;GUAMA;-1.197;-46.14;False;53217;27642;24962;17865;8925;8675;35352;18717;16287
1508357;Vitória do Xingu;PA;15;Norte;SUDOESTE PARAENSE;ALTAMIRA;-2.88;-52.01;True;9693;5163;4399;4251;2212;2026;5442;2951;2373
1508407;Xinguara;PA;15;Norte;SUDESTE PARAENSE;REDENCAO;-7.095;-49.946;True;38457;19469;18866;29821;14842;14873;8636;4627;3993
1600055;Serra do Navio;AP;16;Norte;SUL DO AMAPA;MACAPA;0.896;-52.002;True;3772;2072;1700;1133;627;506;2639;1445;1194
1600105;Amapá;AP;16;Norte;NORTE DO AMAPA;AMAPA;2.053;-50.793;True;7492;3886;3605;6350;3237;3113;1142;649;492
1600154;Pedra Branca do Amaparí;AP;16;Norte;SUL DO AMAPA;MACAPA;0.778;-51.944;True;7332;3880;3448;4083;2148;1935;3249;1732;1513
1600204;Calçoene;AP;16;Norte;NORTE DO AMAPA;OIAPOQUE;2.498;-50.949;True;8656;4491;3981;7032;3623;3365;1624;868;616
1600212;Cutias;AP;16;Norte;SUL DO AMAPA;MACAPA;0.986;-50.802;True;4320;2220;2072;2170;1085;1083;2150;1135;989
1600238;Ferreira Gomes;AP;16;Norte;SUL DO AMAPA;MACAPA;0.858;-51.18;True;5040;2649;2391;3481;1786;1695;1559;863;696
1600253;Itaubal;AP;16;Norte;SUL DO AMAPA;MACAPA;0.596;-50.671;True;3439;1810;1563;1411;715;693;2028;1095;870
1600279;Laranjal do Jari;AP;16;Norte;SUL DO AMAPA;MAZAGAO;-0.842;-52.516;True;37491;19158;18089;35587;18114;17245;1904;1044;844
1600303;Macapá;AP;16;Norte;SUL DO AMAPA;MACAPA;0.039;-51.066;True;344153;167926;173213;328865;159929;166114;15288;7997;7099
1600402;Mazagão;AP;16;Norte;SUL DO AMAPA;MAZAGAO;-0.115;-51.289;True;13862;7159;6486;7345;3720;3564;6517;3439;2922
1600501;Oiapoque;AP;16;Norte;NORTE DO AMAPA;OIAPOQUE;3.843;-51.835;True;19181;9760;8959;12603;6315;5940;6578;3445;3019
1600535;Porto Grande;AP;16;Norte;SUL DO AMAPA;MACAPA;0.713;-51.413;True;13962;7326;6636;9212;4679;4533;4750;2647;2103
1600550;Pracuúba;AP;16;Norte;NORTE DO AMAPA;AMAPA;1.743;-50.791;True;3353;1780;1573;1587;847;740;1766;933;833
1600600;Santana;AP;16;Norte;SUL DO AMAPA;MACAPA;-0.058;-51.182;True;92098;46058;45909;90707;45269;45307;1391;789;602
1600709;Tartarugalzinho;AP;16;Norte;NORTE DO AMAPA;AMAPA;1.506;-50.912;True;12395;6318;5478;6108;3168;2933;6287;3150;2545
1600808;Vitória do Jari;AP;16;Norte;SUL DO AMAPA;MAZAGAO;-0.938;-52.424;True;10765;5531;5234;9471;4822;4649;1294;709;585
1700251;Abreulândia;TO;17;Norte;OCIDENTAL DO TOCANTINS;MIRACEMA DO TOCANTINS;-9.621;-49.151;True;2245;1224;1020;1507;787;720;738;437;300
1700301;Aguiarnópolis;TO;17;Norte;OCIDENTAL DO TOCANTINS;BICO DO PAPAGAIO;-6.563;-47.466;True;3995;2034;1951;2933;1451;1482;1062;583;469
1700350;Aliança do Tocantins;TO;17;Norte;OCIDENTAL DO TOCANTINS;GURUPI;-11.306;-48.936;True;5701;2950;2743;4754;2388;2364;947;562;379
1700400;Almas;TO;17;Norte;ORIENTAL DO TOCANTINS;DIANOPOLIS;-11.574;-47.17;True;7488;3871;3608;5661;2813;2848;1827;1058;760
1700707;Alvorada;TO;17;Norte;OCIDENTAL DO TOCANTINS;GURUPI;-12.48;-49.125;True;7976;4048;3879;7365;3705;3615;611;343;264
1701002;Ananás;TO;17;Norte;OCIDENTAL DO TOCANTINS;BICO DO PAPAGAIO;-6.366;-48.073;True;9358;4699;4619;7496;3715;3766;1862;984;853
1701051;Angico;TO;17;Norte;OCIDENTAL DO TOCANTINS;BICO DO PAPAGAIO;-6.39;-47.865;True;3169;1629;1416;1783;915;868;1386;714;548
1701101;Aparecida do Rio Negro;TO;17;Norte;ORIENTAL DO TOCANTINS;PORTO NACIONAL;-9.952;-47.972;True;4018;2071;1947;3114;1565;1549;904;506;398
1701309;Aragominas;TO;17;Norte;OCIDENTAL DO TOCANTINS;ARAGUAINA;-7.162;-48.528;True;5469;2899;2553;1829;923;906;3640;1976;1647
1701903;Araguacema;TO;17;Norte;OCIDENTAL DO TOCANTINS;MIRACEMA DO TOCANTINS;-8.804;-49.556;True;5423;2740;2483;3042;1476;1463;2381;1264;1020
1702000;Araguaçu;TO;17;Norte;OCIDENTAL DO TOCANTINS;RIO FORMOSO;-12.931;-49.826;True;8989;4645;4344;6004;2971;3033;2985;1674;1311
1702109;Araguaína;TO;17;Norte;OCIDENTAL DO TOCANTINS;ARAGUAINA;-7.191;-48.207;True;115759;55495;59084;109571;52174;56290;6188;3321;2794
1702158;Araguanã;TO;17;Norte;OCIDENTAL DO TOCANTINS;ARAGUAINA;-6.581;-48.644;True;5000;2583;2393;3462;1743;1703;1538;840;690
1702208;Araguatins;TO;17;Norte;OCIDENTAL DO TOCANTINS;BICO DO PAPAGAIO;-5.651;-48.124;True;25973;13067;12612;17290;8387;8739;8683;4680;3873
1702307;Arapoema;TO;17;Norte;OCIDENTAL DO TOCANTINS;ARAGUAINA;-7.658;-49.064;True;6839;3503;3336;5488;2742;2746;1351;761;590
1702406;Arraias;TO;17;Norte;ORIENTAL DO TOCANTINS;DIANOPOLIS;-12.931;-46.938;True;10626;5487;5111;6954;3389;3565;3672;2098;1546
1702554;Augustinópolis;TO;17;Norte;OCIDENTAL DO TOCANTINS;BICO DO PAPAGAIO;-5.466;-47.888;True;14800;7433;7276;12148;5994;6106;2652;1439;1170
1702703;Aurora do Tocantins;TO;17;Norte;ORIENTAL DO TOCANTINS;DIANOPOLIS;-12.713;-46.408;True;3385;1736;1637;2441;1204;1229;944;532;408
1702901;Axixá do Tocantins;TO;17;Norte;OCIDENTAL DO TOCANTINS;BICO DO PAPAGAIO;-5.617;-47.769;True;8917;4417;4434;7291;3588;3654;1626;829;780
1703008;Babaçulândia;TO;17;Norte;OCIDENTAL DO TOCANTINS;ARAGUAINA;-7.205;-47.757;True;10372;5435;4918;5345;2680;2665;5027;2755;2253
1703057;Bandeirantes do Tocantins;TO;17;Norte;OCIDENTAL DO TOCANTINS;ARAGUAINA;-7.756;-48.584;True;2711;1423;1288;1418;735;683;1293;688;605
1703073;Barra do Ouro;TO;17;Norte;ORIENTAL DO TOCANTINS;JALAPAO;-7.689;-47.683;True;3581;1929;1652;1851;953;898;1730;976;754
1703107;Barrolândia;TO;17;Norte;OCIDENTAL DO TOCANTINS;MIRACEMA DO TOCANTINS;-9.836;-48.725;True;5155;2703;2452;4388;2255;2133;767;448;319
1703206;Bernardo Sayão;TO;17;Norte;OCIDENTAL DO TOCANTINS;MIRACEMA DO TOCANTINS;-7.874;-48.888;True;4518;2358;2160;2236;1106;1130;2282;1252;1030
1703305;Bom Jesus do Tocantins;TO;17;Norte;ORIENTAL DO TOCANTINS;PORTO NACIONAL;-8.965;-48.166;True;2710;1408;1302;2104;1061;1043;606;347;259
1703602;Brasilândia do Tocantins;TO;17;Norte;OCIDENTAL DO TOCANTINS;MIRACEMA DO TOCANTINS;-8.388;-48.481;True;2119;1090;1029;1420;717;703;699;373;326
1703701;Brejinho de Nazaré;TO;17;Norte;OCIDENTAL DO TOCANTINS;GURUPI;-11;-48.566;True;5295;2739;2556;4233;2129;2104;1062;610;452
1703800;Buriti do Tocantins;TO;17;Norte;OCIDENTAL DO TOCANTINS;BICO DO PAPAGAIO;-5.316;-48.229;True;8164;4106;4053;6600;3312;3288;1564;794;765
1703826;Cachoeirinha;TO;17;Norte;OCIDENTAL DO TOCANTINS;BICO DO PAPAGAIO;-6.122;-47.922;True;2171;1083;995;1678;812;773;493;271;222
1703842;Campos Lindos;TO;17;Norte;ORIENTAL DO TOCANTINS;JALAPAO;-7.994;-46.868;True;7615;3878;3552;4690;2323;2241;2925;1555;1311
1703867;Cariri do Tocantins;TO;17;Norte;OCIDENTAL DO TOCANTINS;GURUPI;-11.891;-49.161;True;3562;1949;1576;1980;978;965;1582;971;611
1703883;Carmolândia;TO;17;Norte;OCIDENTAL DO TOCANTINS;ARAGUAINA;-7.033;-48.396;True;2313;1198;1108;1855;949;899;458;249;209
1703891;Carrasco Bonito;TO;17;Norte;OCIDENTAL DO TOCANTINS;BICO DO PAPAGAIO;-5.322;-48.035;True;3314;1707;1604;1786;923;863;1528;784;741
1703909;Caseara;TO;17;Norte;OCIDENTAL DO TOCANTINS;MIRACEMA DO TOCANTINS;-9.278;-49.956;True;4667;2433;2234;2770;1355;1415;1897;1078;819
1704105;Centenário;TO;17;Norte;ORIENTAL DO TOCANTINS;JALAPAO;-8.951;-47.336;True;2386;1269;1117;1373;718;655;1013;551;462
1704600;Chapada de Areia;TO;17;Norte;OCIDENTAL DO TOCANTINS;RIO FORMOSO;-10.144;-49.14;True;1239;664;575;722;369;353;517;295;222
1705102;Chapada da Natividade;TO;17;Norte;ORIENTAL DO TOCANTINS;DIANOPOLIS;-11.617;-47.751;True;3680;2014;1666;1819;958;861;1861;1056;805
1705508;Colinas do Tocantins;TO;17;Norte;OCIDENTAL DO TOCANTINS;ARAGUAINA;-8.059;-48.475;True;29298;14550;14692;28249;13955;14238;1049;595;454
1705557;Combinado;TO;17;Norte;ORIENTAL DO TOCANTINS;DIANOPOLIS;-12.792;-46.539;True;4878;2533;2344;4021;2060;1960;857;473;384
1705607;Conceição do Tocantins;TO;17;Norte;ORIENTAL DO TOCANTINS;DIANOPOLIS;-12.219;-47.298;True;4402;2233;1998;2654;1294;1286;1748;939;712
1706001;Couto de Magalhães;TO;17;Norte;OCIDENTAL DO TOCANTINS;MIRACEMA DO TOCANTINS;-8.284;-49.247;True;4887;2622;2263;1683;839;844;3204;1783;1419
1706100;Cristalândia;TO;17;Norte;OCIDENTAL DO TOCANTINS;RIO FORMOSO;-10.6;-49.193;True;6520;3343;3177;5755;2895;2860;765;448;317
1706258;Crixás do Tocantins;TO;17;Norte;OCIDENTAL DO TOCANTINS;GURUPI;-11.1;-48.919;True;1264;637;590;854;428;422;410;209;168
1706506;Darcinópolis;TO;17;Norte;OCIDENTAL DO TOCANTINS;BICO DO PAPAGAIO;-6.713;-47.76;True;5130;2729;2401;3193;1638;1555;1937;1091;846
1707009;Dianópolis;TO;17;Norte;ORIENTAL DO TOCANTINS;DIANOPOLIS;-11.628;-46.821;True;18584;10038;8444;14665;7322;7262;3919;2716;1182
1707108;Divinópolis do Tocantins;TO;17;Norte;OCIDENTAL DO TOCANTINS;MIRACEMA DO TOCANTINS;-9.8;-49.214;True;6359;3331;3021;4498;2280;2211;1861;1051;810
1707207;Dois Irmãos do Tocantins;TO;17;Norte;OCIDENTAL DO TOCANTINS;MIRACEMA DO TOCANTINS;-9.258;-49.064;True;7060;3870;3103;2978;1518;1434;4082;2352;1669
1707306;Dueré;TO;17;Norte;OCIDENTAL DO TOCANTINS;RIO FORMOSO;-11.344;-49.271;True;4489;2377;2084;3020;1523;1497;1469;854;587
1707405;Esperantina;TO;17;Norte;OCIDENTAL DO TOCANTINS;BICO DO PAPAGAIO;-5.343;-48.511;True;8134;4187;3925;4240;2162;2075;3894;2025;1850
1707553;Fátima;TO;17;Norte;OCIDENTAL DO TOCANTINS;RIO FORMOSO;-10.761;-48.907;True;3984;2035;1949;3305;1635;1670;679;400;279
1707652;Figueirópolis;TO;17;Norte;OCIDENTAL DO TOCANTINS;GURUPI;-12.131;-49.174;True;4820;2451;2366;3878;1924;1951;942;527;415
1707702;Filadélfia;TO;17;Norte;OCIDENTAL DO TOCANTINS;ARAGUAINA;-7.336;-47.49;True;7787;4093;3688;4892;2461;2425;2895;1632;1263
1708205;Formoso do Araguaia;TO;17;Norte;OCIDENTAL DO TOCANTINS;RIO FORMOSO;-11.797;-49.529;True;18225;9408;8746;13049;6576;6463;5176;2832;2283
1708254;Fortaleza do Tabocão;TO;17;Norte;OCIDENTAL DO TOCANTINS;MIRACEMA DO TOCANTINS;-9.057;-48.519;True;2101;1081;1020;1712;860;852;389;221;168
1708304;Goianorte;TO;17;Norte;OCIDENTAL DO TOCANTINS;MIRACEMA DO TOCANTINS;-8.776;-48.932;True;5221;2769;2412;2776;1398;1346;2445;1371;1066
1709005;Goiatins;TO;17;Norte;ORIENTAL DO TOCANTINS;JALAPAO;-7.71;-47.314;True;11639;6093;5521;5014;2546;2468;6625;3547;3053
1709302;Guaraí;TO;17;Norte;OCIDENTAL DO TOCANTINS;MIRACEMA DO TOCANTINS;-8.834;-48.51;True;21669;10882;10787;19612;9702;9910;2057;1180;877
1709500;Gurupi;TO;17;Norte;OCIDENTAL DO TOCANTINS;GURUPI;-11.729;-49.069;True;71413;35142;36046;69748;34232;35317;1665;910;729
1709807;Ipueiras;TO;17;Norte;ORIENTAL DO TOCANTINS;PORTO NACIONAL;-11.239;-48.463;True;1698;910;788;961;473;488;737;437;300
1710508;Itacajá;TO;17;Norte;ORIENTAL DO TOCANTINS;JALAPAO;-8.392;-47.768;True;6386;3305;2991;3620;1833;1759;2766;1472;1232
1710706;Itaguatins;TO;17;Norte;OCIDENTAL DO TOCANTINS;BICO DO PAPAGAIO;-5.768;-47.481;True;6074;3178;2867;3360;1650;1681;2714;1528;1186
1710904;Itapiratins;TO;17;Norte;ORIENTAL DO TOCANTINS;JALAPAO;-8.384;-48.111;True;3421;1858;1563;1768;906;862;1653;952;701
1711100;Itaporã do Tocantins;TO;17;Norte;OCIDENTAL DO TOCANTINS;MIRACEMA DO TOCANTINS;-8.571;-48.689;True;2989;1644;1329;1696;879;809;1293;765;520
1711506;Jaú do Tocantins;TO;17;Norte;OCIDENTAL DO TOCANTINS;GURUPI;-12.654;-48.594;True;3789;1995;1794;1331;648;683;2458;1347;1111
1711803;Juarina;TO;17;Norte;OCIDENTAL DO TOCANTINS;MIRACEMA DO TOCANTINS;-8.119;-49.065;True;2141;1140;1000;947;478;469;1194;662;531
1711902;Lagoa da Confusão;TO;17;Norte;OCIDENTAL DO TOCANTINS;RIO FORMOSO;-10.794;-49.624;True;8220;4359;3830;4946;2583;2344;3274;1776;1486
1711951;Lagoa do Tocantins;TO;17;Norte;ORIENTAL DO TOCANTINS;JALAPAO;-10.378;-47.551;True;3179;1655;1519;2210;1128;1082;969;527;437
1712009;Lajeado;TO;17;Norte;ORIENTAL DO TOCANTINS;PORTO NACIONAL;-9.751;-48.358;True;2159;1123;1028;1124;566;550;1035;557;478
1712157;Lavandeira;TO;17;Norte;ORIENTAL DO TOCANTINS;DIANOPOLIS;-12.789;-46.506;True;1590;842;744;928;466;460;662;376;284
1712405;Lizarda;TO;17;Norte;ORIENTAL DO TOCANTINS;JALAPAO;-9.594;-46.673;True;3634;1932;1694;1893;944;949;1741;988;745
1712454;Luzinópolis;TO;17;Norte;OCIDENTAL DO TOCANTINS;BICO DO PAPAGAIO;-6.182;-47.856;True;2784;1289;1209;2056;902;883;728;387;326
1712504;Marianópolis do Tocantins;TO;17;Norte;OCIDENTAL DO TOCANTINS;MIRACEMA DO TOCANTINS;-9.796;-49.654;True;4473;2361;2108;2236;1100;1136;2237;1261;972
1712702;Mateiros;TO;17;Norte;ORIENTAL DO TOCANTINS;JALAPAO;-10.548;-46.421;True;1737;883;851;1147;555;592;590;328;259
1712801;Maurilândia do Tocantins;TO;17;Norte;OCIDENTAL DO TOCANTINS;BICO DO PAPAGAIO;-5.953;-47.506;True;3185;1715;1426;1898;992;900;1287;723;526
1713205;Miracema do Tocantins;TO;17;Norte;OCIDENTAL DO TOCANTINS;MIRACEMA DO TOCANTINS;-9.567;-48.392;True;19683;9745;9807;16700;8096;8575;2983;1649;1232
1713304;Miranorte;TO;17;Norte;OCIDENTAL DO TOCANTINS;MIRACEMA DO TOCANTINS;-9.529;-48.59;True;11858;6006;5804;10545;5249;5248;1313;757;556
1713601;Monte do Carmo;TO;17;Norte;ORIENTAL DO TOCANTINS;PORTO NACIONAL;-10.763;-48.109;True;6387;3426;2888;2872;1448;1419;3515;1978;1469
1713700;Monte Santo do Tocantins;TO;17;Norte;OCIDENTAL DO TOCANTINS;MIRACEMA DO TOCANTINS;-10.004;-48.995;True;1858;1004;841;489;251;233;1369;753;608
1713809;Palmeiras do Tocantins;TO;17;Norte;OCIDENTAL DO TOCANTINS;BICO DO PAPAGAIO;-6.613;-47.546;True;4542;2263;2143;2307;1114;1145;2235;1149;998
1713957;Muricilândia;TO;17;Norte;OCIDENTAL DO TOCANTINS;ARAGUAINA;-7.147;-48.611;True;2850;1464;1386;1682;820;862;1168;644;524
1714203;Natividade;TO;17;Norte;ORIENTAL DO TOCANTINS;DIANOPOLIS;-11.71;-47.723;True;9090;4629;4349;6860;3336;3412;2230;1293;937
1714302;Nazaré;TO;17;Norte;OCIDENTAL DO TOCANTINS;BICO DO PAPAGAIO;-6.372;-47.664;True;4528;2313;2127;1905;956;949;2623;1357;1178
1714880;Nova Olinda;TO;17;Norte;OCIDENTAL DO TOCANTINS;ARAGUAINA;-7.632;-48.423;True;10518;5420;5076;7302;3651;3651;3216;1769;1425
1715002;Nova Rosalândia;TO;17;Norte;OCIDENTAL DO TOCANTINS;RIO FORMOSO;-10.567;-48.914;True;3772;1945;1823;2474;1244;1226;1298;701;597
1715101;Novo Acordo;TO;17;Norte;ORIENTAL DO TOCANTINS;JALAPAO;-9.963;-47.677;True;3754;1938;1808;2883;1435;1444;871;503;364
1715150;Novo Alegre;TO;17;Norte;ORIENTAL DO TOCANTINS;DIANOPOLIS;-12.931;-46.574;True;1801;910;859;1730;869;831;71;41;28
1715259;Novo Jardim;TO;17;Norte;ORIENTAL DO TOCANTINS;DIANOPOLIS;-11.824;-46.628;True;2419;1258;1161;1713;877;836;706;381;325
1715507;Oliveira de Fátima;TO;17;Norte;OCIDENTAL DO TOCANTINS;RIO FORMOSO;-10.708;-48.907;True;1081;578;503;845;435;410;236;143;93
1715705;Palmeirante;TO;17;Norte;OCIDENTAL DO TOCANTINS;ARAGUAINA;-7.86;-47.926;True;4689;2494;2129;1810;891;919;2879;1603;1210
1715754;Palmeirópolis;TO;17;Norte;OCIDENTAL DO TOCANTINS;GURUPI;-13.044;-48.402;True;8120;4156;3904;6896;3483;3362;1224;673;542
1716109;Paraíso do Tocantins;TO;17;Norte;OCIDENTAL DO TOCANTINS;RIO FORMOSO;-10.176;-48.867;True;40290;20042;20179;38343;18936;19338;1947;1106;841
1716208;Paranã;TO;17;Norte;ORIENTAL DO TOCANTINS;DIANOPOLIS;-12.615;-47.883;True;10491;5562;4892;4255;2100;2155;6236;3462;2737
1716307;Pau D'Arco;TO;17;Norte;OCIDENTAL DO TOCANTINS;ARAGUAINA;-7.54;-49.372;True;4767;2528;2229;2965;1506;1459;1802;1022;770
1716505;Pedro Afonso;TO;17;Norte;ORIENTAL DO TOCANTINS;PORTO NACIONAL;-8.968;-48.175;True;10294;5295;4959;8880;4491;4371;1414;804;588
1716604;Peixe;TO;17;Norte;OCIDENTAL DO TOCANTINS;GURUPI;-12.025;-48.539;True;8750;4529;4135;4294;2143;2097;4456;2386;2038
1716653;Pequizeiro;TO;17;Norte;OCIDENTAL DO TOCANTINS;MIRACEMA DO TOCANTINS;-8.595;-48.934;True;4799;2561;2231;2441;1247;1194;2358;1314;1037
1716703;Colméia;TO;17;Norte;OCIDENTAL DO TOCANTINS;MIRACEMA DO TOCANTINS;-8.729;-48.765;True;8759;4418;4303;6504;3178;3288;2255;1240;1015
1717008;Pindorama do Tocantins;TO;17;Norte;ORIENTAL DO TOCANTINS;DIANOPOLIS;-11.139;-47.579;True;4397;2369;2028;2900;1490;1410;1497;879;618
1717206;Piraquê;TO;17;Norte;OCIDENTAL DO TOCANTINS;ARAGUAINA;-6.774;-48.297;True;3014;1639;1344;1097;525;572;1917;1114;772
1717503;Pium;TO;17;Norte;OCIDENTAL DO TOCANTINS;RIO FORMOSO;-10.443;-49.182;True;6403;3370;3020;3484;1738;1746;2919;1632;1274
1717800;Ponte Alta do Bom Jesus;TO;17;Norte;ORIENTAL DO TOCANTINS;DIANOPOLIS;-12.091;-46.479;True;4529;2399;2130;2426;1219;1207;2103;1180;923
1717909;Ponte Alta do Tocantins;TO;17;Norte;ORIENTAL DO TOCANTINS;JALAPAO;-10.744;-47.536;True;6569;3549;3020;3981;2026;1955;2588;1523;1065
1718006;Porto Alegre do Tocantins;TO;17;Norte;ORIENTAL DO TOCANTINS;DIANOPOLIS;-11.609;-47.049;True;2830;1500;1330;2124;1090;1034;706;410;296
1718204;Porto Nacional;TO;17;Norte;ORIENTAL DO TOCANTINS;PORTO NACIONAL;-10.708;-48.417;True;45289;22490;22689;39013;19026;19917;6276;3464;2772
1718303;Praia Norte;TO;17;Norte;OCIDENTAL DO TOCANTINS;BICO DO PAPAGAIO;-5.393;-47.811;True;7060;3623;3409;3800;1924;1876;3260;1699;1533
1718402;Presidente Kennedy;TO;17;Norte;OCIDENTAL DO TOCANTINS;MIRACEMA DO TOCANTINS;-8.539;-48.506;True;3680;1875;1804;3154;1582;1571;526;293;233
1718451;Pugmil;TO;17;Norte;OCIDENTAL DO TOCANTINS;RIO FORMOSO;-10.424;-48.894;True;2165;1131;1034;1783;924;859;382;207;175
1718501;Recursolândia;TO;17;Norte;ORIENTAL DO TOCANTINS;JALAPAO;-8.737;-47.247;True;3665;1926;1648;1822;919;869;1843;1007;779
1718550;Riachinho;TO;17;Norte;OCIDENTAL DO TOCANTINS;BICO DO PAPAGAIO;-6.438;-48.137;True;3691;1892;1778;1683;829;854;2008;1063;924
1718659;Rio da Conceição;TO;17;Norte;ORIENTAL DO TOCANTINS;DIANOPOLIS;-11.4;-46.883;True;1454;751;703;1324;680;644;130;71;59
1718709;Rio dos Bois;TO;17;Norte;OCIDENTAL DO TOCANTINS;MIRACEMA DO TOCANTINS;-9.293;-48.466;True;2092;1031;927;1123;493;496;969;538;431
1718758;Rio Sono;TO;17;Norte;ORIENTAL DO TOCANTINS;JALAPAO;-9.344;-47.902;True;6167;3363;2716;2316;1183;1100;3851;2180;1616
1718808;Sampaio;TO;17;Norte;OCIDENTAL DO TOCANTINS;BICO DO PAPAGAIO;-5.348;-47.873;True;3672;1831;1789;3282;1642;1640;390;189;149
1718840;Sandolândia;TO;17;Norte;OCIDENTAL DO TOCANTINS;RIO FORMOSO;-12.537;-49.925;True;3443;1800;1599;1711;835;838;1732;965;761
1718865;Santa Fé do Araguaia;TO;17;Norte;OCIDENTAL DO TOCANTINS;ARAGUAINA;-7.157;-48.721;True;5610;2933;2669;3696;1868;1828;1914;1065;841
1718881;Santa Maria do Tocantins;TO;17;Norte;ORIENTAL DO TOCANTINS;PORTO NACIONAL;-8.797;-47.795;True;2673;1423;1250;1809;907;902;864;516;348
1718899;Santa Rita do Tocantins;TO;17;Norte;OCIDENTAL DO TOCANTINS;GURUPI;-10.861;-48.914;True;2260;1252;1008;865;432;433;1395;820;575
1718907;Santa Rosa do Tocantins;TO;17;Norte;ORIENTAL DO TOCANTINS;DIANOPOLIS;-11.449;-48.121;True;4417;2328;2073;2872;1449;1413;1545;879;660
1719004;Santa Tereza do Tocantins;TO;17;Norte;ORIENTAL DO TOCANTINS;JALAPAO;-10.282;-47.808;True;2297;1207;1088;1485;770;713;812;437;375
1720002;Santa Terezinha do Tocantins;TO;17;Norte;OCIDENTAL DO TOCANTINS;BICO DO PAPAGAIO;-6.434;-47.673;True;2291;1174;1117;1480;753;727;811;421;390
1720101;São Bento do Tocantins;TO;17;Norte;OCIDENTAL DO TOCANTINS;BICO DO PAPAGAIO;-5.915;-48.06;True;4447;2227;2035;2665;1295;1251;1782;932;784
1720150;São Félix do Tocantins;TO;17;Norte;ORIENTAL DO TOCANTINS;JALAPAO;-10.168;-46.659;True;1409;719;658;793;393;384;616;326;274
1720200;São Miguel do Tocantins;TO;17;Norte;OCIDENTAL DO TOCANTINS;BICO DO PAPAGAIO;-5.555;-47.575;True;10221;5220;5001;2362;1148;1214;7859;4072;3787
1720259;São Salvador do Tocantins;TO;17;Norte;OCIDENTAL DO TOCANTINS;GURUPI;-12.744;-48.236;True;3012;1542;1453;1453;720;733;1559;822;720
1720309;São Sebastião do Tocantins;TO;17;Norte;OCIDENTAL DO TOCANTINS;BICO DO PAPAGAIO;-5.257;-48.2;True;4244;2213;2031;3397;1739;1658;847;474;373
1720499;São Valério da Natividade;TO;17;Norte;ORIENTAL DO TOCANTINS;DIANOPOLIS;-11.975;-48.234;True;4885;2560;2307;2889;1435;1454;1996;1125;853
1720655;Silvanópolis;TO;17;Norte;ORIENTAL DO TOCANTINS;PORTO NACIONAL;-11.147;-48.169;True;5098;2716;2382;3998;2062;1936;1100;654;446
1720804;Sítio Novo do Tocantins;TO;17;Norte;OCIDENTAL DO TOCANTINS;BICO DO PAPAGAIO;-5.601;-47.638;True;9302;4722;4548;4978;2469;2502;4324;2253;2046
1720853;Sucupira;TO;17;Norte;OCIDENTAL DO TOCANTINS;GURUPI;-11.993;-48.971;True;1667;875;792;970;476;494;697;399;298
1720903;Taguatinga;TO;17;Norte;ORIENTAL DO TOCANTINS;DIANOPOLIS;-12.404;-46.436;True;14110;7352;6692;9705;4876;4829;4405;2476;1863
1720937;Taipas do Tocantins;TO;17;Norte;ORIENTAL DO TOCANTINS;DIANOPOLIS;-12.188;-46.989;True;1916;993;923;1515;770;745;401;223;178
1720978;Talismã;TO;17;Norte;OCIDENTAL DO TOCANTINS;GURUPI;-12.795;-49.093;True;2555;1342;1163;1257;647;610;1298;695;553
1721000;Palmas;TO;17;Norte;ORIENTAL DO TOCANTINS;PORTO NACIONAL;-10.167;-48.333;True;178386;84096;85914;175166;82248;84584;3220;1848;1330
1721109;Tocantínia;TO;17;Norte;ORIENTAL DO TOCANTINS;PORTO NACIONAL;-9.564;-48.377;True;6663;3410;3233;3057;1522;1526;3606;1888;1707
1721208;Tocantinópolis;TO;17;Norte;OCIDENTAL DO TOCANTINS;BICO DO PAPAGAIO;-6.329;-47.416;True;21334;10481;10684;17414;8420;8846;3920;2061;1838
1721257;Tupirama;TO;17;Norte;OCIDENTAL DO TOCANTINS;MIRACEMA DO TOCANTINS;-8.973;-48.188;True;1405;781;624;793;424;369;612;357;255
1721307;Tupiratins;TO;17;Norte;OCIDENTAL DO TOCANTINS;MIRACEMA DO TOCANTINS;-8.394;-48.116;True;2007;1103;899;867;440;422;1140;663;477
1722081;Wanderlândia;TO;17;Norte;OCIDENTAL DO TOCANTINS;ARAGUAINA;-6.849;-47.963;True;9317;4786;4495;5178;2567;2611;4139;2219;1884
1722107;Xambioá;TO;17;Norte;OCIDENTAL DO TOCANTINS;ARAGUAINA;-6.411;-48.536;True;10856;5446;5195;8837;4326;4399;2019;1120;796
2100055;Açailândia;MA;21;Nordeste;OESTE MARANHENSE;IMPERATRIZ;-4.947;-47.505;True;97034;46854;46765;73386;34855;35920;23648;11999;10845
2100105;Afonso Cunha;MA;21;Nordeste;LESTE MARANHENSE;COELHO NETO;-4.133;-43.324;True;5651;2841;2810;3063;1506;1557;2588;1335;1253
2100154;Água Doce do Maranhão;MA;21;Nordeste;LESTE MARANHENSE;BAIXO PARNAIBA MARANHENSE;-2.841;-42.112;True;11829;6074;5593;2989;1421;1466;8840;4653;4127
2100204;Alcântara;MA;21;Nordeste;NORTE MARANHENSE;LITORAL OCIDENTAL MARANHENSE;-2.409;-44.415;False;21349;11216;10076;5974;2998;2950;15375;8218;7126
2100303;Aldeias Altas;MA;21;Nordeste;LESTE MARANHENSE;COELHO NETO;-4.628;-43.471;True;21645;11147;10429;10796;5376;5400;10849;5771;5029
2100402;Altamira do Maranhão;MA;21;Nordeste;OESTE MARANHENSE;PINDARE;-4.165;-45.47;True;7365;3707;3658;2722;1313;1409;4643;2394;2249
2100436;Alto Alegre do Maranhão;MA;21;Nordeste;LESTE MARANHENSE;CODO;-4.213;-44.446;True;22002;10979;10957;14941;7302;7599;7061;3677;3358
2100477;Alto Alegre do Pindaré;MA;21;Nordeste;OESTE MARANHENSE;PINDARE;-3.69;-45.903;True;31992;16482;15412;9418;4666;4734;22574;11816;10678
2100501;Alto Parnaíba;MA;21;Nordeste;SUL MARANHENSE;GERAIS DE BALSAS;-9.111;-45.93;True;10304;5192;5028;6260;3029;3227;4044;2163;1801
2100550;Amapá do Maranhão;MA;21;Nordeste;OESTE MARANHENSE;GURUPI;-1.675;-46.002;True;6168;3188;2970;4530;2306;2214;1638;882;756
2100600;Amarante do Maranhão;MA;21;Nordeste;OESTE MARANHENSE;IMPERATRIZ;-5.567;-46.742;True;35727;18565;16991;14247;7148;7099;21480;11417;9892
2100709;Anajatuba;MA;21;Nordeste;NORTE MARANHENSE;BAIXADA MARANHENSE;-3.264;-44.62;True;23941;11842;11009;6455;3024;3239;17486;8818;7770
2100808;Anapurus;MA;21;Nordeste;LESTE MARANHENSE;CHAPADINHA;-3.672;-43.116;True;12580;6348;6209;6108;2972;3118;6472;3376;3091
2100832;Apicum-Açu;MA;21;Nordeste;NORTE MARANHENSE;LITORAL OCIDENTAL MARANHENSE;-1.461;-45.103;False;13216;6947;6176;7664;3990;3602;5552;2957;2574
2100873;Araguanã;MA;21;Nordeste;OESTE MARANHENSE;PINDARE;-2.953;-45.665;True;9918;5123;4746;4586;2291;2292;5332;2832;2454
2100907;Araioses;MA;21;Nordeste;LESTE MARANHENSE;BAIXO PARNAIBA MARANHENSE;-2.89;-41.903;True;37655;19519;17993;10028;5064;4934;27627;14455;13059
2100956;Arame;MA;21;Nordeste;CENTRO MARANHENSE;ALTO MEARIM E GRAJAU;-4.733;-45.908;True;27229;14115;13061;11029;5400;5600;16200;8715;7461
2101004;Arari;MA;21;Nordeste;NORTE MARANHENSE;BAIXADA MARANHENSE;-3.454;-44.78;True;27753;13902;13720;16415;7858;8426;11338;6044;5294
2101103;Axixá;MA;21;Nordeste;NORTE MARANHENSE;ROSARIO;-2.837;-44.053;True;14249;7231;6904;1841;953;888;12408;6278;6016
2101202;Bacabal;MA;21;Nordeste;CENTRO MARANHENSE;MEDIO MEARIM;-4.225;-44.78;True;95124;45083;49058;73704;34097;38775;21420;10986;10283
2101251;Bacabeira;MA;21;Nordeste;NORTE MARANHENSE;ROSARIO;-2.971;-44.316;True;14611;7352;7235;3156;1560;1596;11455;5792;5639
2101301;Bacuri;MA;21;Nordeste;NORTE MARANHENSE;LITORAL OCIDENTAL MARANHENSE;-1.703;-45.134;True;16026;8154;7587;7805;3828;3947;8221;4326;3640
2101350;Bacurituba;MA;21;Nordeste;NORTE MARANHENSE;LITORAL OCIDENTAL MARANHENSE;-2.706;-44.738;True;5425;2823;2578;1315;681;634;4110;2142;1944
2101400;Balsas;MA;21;Nordeste;SUL MARANHENSE;GERAIS DE BALSAS;-7.533;-46.036;True;78845;39155;39440;66263;32498;33727;12582;6657;5713
2101509;Barão de Grajaú;MA;21;Nordeste;LESTE MARANHENSE;CHAPADAS DO ALTO ITAPECURU;-6.756;-43.024;True;16565;8264;8223;8695;4145;4541;7870;4119;3682
2101608;Barra do Corda;MA;21;Nordeste;CENTRO MARANHENSE;ALTO MEARIM E GRAJAU;-5.506;-45.243;True;78718;39722;38705;46861;22677;24078;31857;17045;14627
2101707;Barreirinhas;MA;21;Nordeste;NORTE MARANHENSE;LENCOIS MARANHENSES;-2.747;-42.826;True;47850;24407;23134;18024;8804;9181;29826;15603;13953
2101731;Belágua;MA;21;Nordeste;LESTE MARANHENSE;CHAPADINHA;-3.155;-43.51;True;5717;2938;2723;2516;1255;1261;3201;1683;1462
2101772;Bela Vista do Maranhão;MA;21;Nordeste;NORTE MARANHENSE;BAIXADA MARANHENSE;-3.731;-45.315;True;8603;4283;4248;4145;2008;2119;4458;2275;2129
2101806;Benedito Leite;MA;21;Nordeste;SUL MARANHENSE;CHAPADAS DAS MANGABEIRAS;-7.223;-44.558;True;5387;2764;2618;2525;1241;1284;2862;1523;1334
2101905;Bequimão;MA;21;Nordeste;NORTE MARANHENSE;LITORAL OCIDENTAL MARANHENSE;-2.449;-44.783;True;20735;10330;9662;5543;2572;2709;15192;7758;6953
2101939;Bernardo do Mearim;MA;21;Nordeste;CENTRO MARANHENSE;MEDIO MEARIM;-4.584;-44.764;True;5972;2971;2977;2028;988;1040;3944;1983;1937
2101970;Boa Vista do Gurupi;MA;21;Nordeste;OESTE MARANHENSE;GURUPI;-1.788;-46.303;True;7385;3731;3643;5288;2634;2654;2097;1097;989
2102002;Bom Jardim;MA;21;Nordeste;OESTE MARANHENSE;PINDARE;-3.565;-45.994;True;37659;19116;18237;14706;7053;7605;22953;12063;10632
2102036;Bom Jesus das Selvas;MA;21;Nordeste;OESTE MARANHENSE;PINDARE;-4.42;-46.765;True;23827;11791;10448;11250;5507;5404;12577;6284;5044
2102077;Bom Lugar;MA;21;Nordeste;CENTRO MARANHENSE;MEDIO MEARIM;-4.22;-45.039;True;12825;6540;6244;2776;1386;1390;10049;5154;4854
2102101;Brejo;MA;21;Nordeste;LESTE MARANHENSE;CHAPADINHA;-3.684;-42.75;True;31049;15603;15181;11499;5435;5912;19550;10168;9269
2102150;Brejo de Areia;MA;21;Nordeste;OESTE MARANHENSE;PINDARE;-4.334;-45.581;True;5803;2965;2838;2707;1348;1359;3096;1617;1479
2102200;Buriti;MA;21;Nordeste;LESTE MARANHENSE;CHAPADINHA;-3.942;-42.925;True;25274;12793;12270;8093;3857;4118;17181;8936;8152
2102309;Buriti Bravo;MA;21;Nordeste;LESTE MARANHENSE;CAXIAS;-5.837;-43.834;True;22279;11091;11047;16048;7785;8188;6231;3306;2859
2102325;Buriticupu;MA;21;Nordeste;OESTE MARANHENSE;PINDARE;-4.346;-46.401;True;61480;31693;29588;31210;15656;15479;30270;16037;14109
2102358;Buritirana;MA;21;Nordeste;OESTE MARANHENSE;IMPERATRIZ;-5.593;-47.018;True;12596;6448;6105;4211;2081;2113;8385;4367;3992
2102374;Cachoeira Grande;MA;21;Nordeste;NORTE MARANHENSE;ROSARIO;-2.927;-44.058;True;8831;4619;4199;3472;1766;1706;5359;2853;2493
2102408;Cajapió;MA;21;Nordeste;NORTE MARANHENSE;LITORAL OCIDENTAL MARANHENSE;-2.881;-44.675;True;9982;5075;4889;3263;1606;1657;6719;3469;3232
2102507;Cajari;MA;21;Nordeste;NORTE MARANHENSE;BAIXADA MARANHENSE;-3.321;-45.011;True;12842;6669;6170;4080;2006;2074;8762;4663;4096
2102556;Campestre do Maranhão;MA;21;Nordeste;SUL MARANHENSE;PORTO FRANCO;-6.172;-47.364;True;12246;6255;5981;9534;4805;4729;2712;1450;1252
2102606;Cândido Mendes;MA;21;Nordeste;OESTE MARANHENSE;GURUPI;-1.447;-45.717;False;18820;9758;8634;11098;5721;5338;7722;4037;3296
2102705;Cantanhede;MA;21;Nordeste;NORTE MARANHENSE;ITAPECURU MIRIM;-3.633;-44.377;True;18827;9490;9288;11833;5822;6003;6994;3668;3285
2102754;Capinzal do Norte;MA;21;Nordeste;LESTE MARANHENSE;CODO;-4.728;-44.327;True;10385;5253;5082;4439;2195;2244;5946;3058;2838
2102804;Carolina;MA;21;Nordeste;SUL MARANHENSE;PORTO FRANCO;-7.333;-47.469;True;24442;12404;11899;15132;7261;7763;9310;5143;4136
2102903;Carutapera;MA;21;Nordeste;OESTE MARANHENSE;GURUPI;-1.195;-46.02;False;20285;10376;9872;13861;6942;6911;6424;3434;2961
2103000;Caxias;MA;21;Nordeste;LESTE MARANHENSE;CAXIAS;-4.859;-43.356;True;143197;69155;73780;108542;50858;57529;34655;18297;16251
2103109;Cedral;MA;21;Nordeste;NORTE MARANHENSE;LITORAL OCIDENTAL MARANHENSE;-2;-44.536;False;9841;5145;4693;2184;1085;1099;7657;4060;3594
2103125;Central do Maranhão;MA;21;Nordeste;NORTE MARANHENSE;LITORAL OCIDENTAL MARANHENSE;-2.199;-44.826;True;8776;4524;4206;4232;2142;2080;4544;2382;2126
2103158;Centro do Guilherme;MA;21;Nordeste;OESTE MARANHENSE;GURUPI;-2.369;-46.002;True;7094;3669;3188;4549;2324;2099;2545;1345;1089
2103174;Centro Novo do Maranhão;MA;21;Nordeste;OESTE MARANHENSE;GURUPI;-2.107;-46.128;True;15127;8086;6980;4530;2330;2197;10597;5756;4783
2103208;Chapadinha;MA;21;Nordeste;LESTE MARANHENSE;CHAPADINHA;-3.742;-43.36;True;67649;33200;33448;44819;21358;22951;22830;11842;10497
2103257;Cidelândia;MA;21;Nordeste;OESTE MARANHENSE;IMPERATRIZ;-5.174;-47.782;True;12407;6288;5903;5068;2485;2458;7339;3803;3445
2103307;Codó;MA;21;Nordeste;LESTE MARANHENSE;CODO;-4.455;-43.886;True;110574;53828;56429;76209;35994;40104;34365;17834;16325
2103406;Coelho Neto;MA;21;Nordeste;LESTE MARANHENSE;COELHO NETO;-4.257;-43.013;True;44031;21878;22149;36917;18114;18803;7114;3764;3346
2103505;Colinas;MA;21;Nordeste;LESTE MARANHENSE;CHAPADAS DO ALTO ITAPECURU;-6.026;-44.249;True;35692;17441;17877;22742;10775;11846;12950;6666;6031
2103554;Conceição do Lago-Açu;MA;21;Nordeste;NORTE MARANHENSE;BAIXADA MARANHENSE;-3.834;-44.893;True;14063;7309;6690;6516;3322;3194;7547;3987;3496
2103604;Coroatá;MA;21;Nordeste;LESTE MARANHENSE;CODO;-4.13;-44.124;True;60589;30021;30441;40850;19585;21261;19739;10436;9180
2103703;Cururupu;MA;21;Nordeste;NORTE MARANHENSE;LITORAL OCIDENTAL MARANHENSE;-1.828;-44.868;False;34018;17280;16724;22359;10990;11361;11659;6290;5363
2103752;Davinópolis;MA;21;Nordeste;OESTE MARANHENSE;IMPERATRIZ;-5.558;-47.426;True;11786;5815;5851;9733;4758;4877;2053;1057;974
2103802;Dom Pedro;MA;21;Nordeste;CENTRO MARANHENSE;PRESIDENTE DUTRA;-5.033;-44.436;True;21479;10492;10977;14409;6925;7476;7070;3567;3501
2103901;Duque Bacelar;MA;21;Nordeste;LESTE MARANHENSE;COELHO NETO;-4.156;-42.944;True;10384;5265;5101;4952;2430;2520;5432;2835;2581
2104008;Esperantinópolis;MA;21;Nordeste;CENTRO MARANHENSE;MEDIO MEARIM;-4.883;-44.688;True;18569;9216;9352;9443;4514;4928;9126;4702;4424
2104057;Estreito;MA;21;Nordeste;SUL MARANHENSE;PORTO FRANCO;-6.561;-47.451;True;26490;12992;12781;18728;8924;9303;7762;4068;3478
2104073;Feira Nova do Maranhão;MA;21;Nordeste;SUL MARANHENSE;GERAIS DE BALSAS;-6.96;-46.686;True;7648;4093;3555;2093;1042;1051;5555;3051;2504
2104081;Fernando Falcão;MA;21;Nordeste;CENTRO MARANHENSE;ALTO MEARIM E GRAJAU;-6.152;-44.893;True;8105;4214;3861;1243;650;593;6862;3564;3268
2104099;Formosa da Serra Negra;MA;21;Nordeste;CENTRO MARANHENSE;ALTO MEARIM E GRAJAU;-6.435;-46.191;True;16882;8849;7995;5039;2444;2595;11843;6405;5400
2104107;Fortaleza dos Nogueiras;MA;21;Nordeste;SUL MARANHENSE;CHAPADAS DAS MANGABEIRAS;-6.964;-46.177;True;11578;5989;5488;6819;3406;3356;4759;2583;2132
2104206;Fortuna;MA;21;Nordeste;CENTRO MARANHENSE;PRESIDENTE DUTRA;-5.733;-44.158;True;14486;7252;7082;8977;4435;4500;5509;2817;2582
2104305;Godofredo Viana;MA;21;Nordeste;OESTE MARANHENSE;GURUPI;-1.403;-45.78;False;10452;5335;5097;7654;3829;3805;2798;1506;1292
2104404;Gonçalves Dias;MA;21;Nordeste;CENTRO MARANHENSE;PRESIDENTE DUTRA;-5.151;-44.299;True;16444;8159;8279;7413;3530;3877;9031;4629;4402
2104503;Governador Archer;MA;21;Nordeste;CENTRO MARANHENSE;PRESIDENTE DUTRA;-5.022;-44.271;True;9920;4912;4930;6579;3202;3334;3341;1710;1596
2104552;Governador Edison Lobão;MA;21;Nordeste;OESTE MARANHENSE;IMPERATRIZ;-5.749;-47.361;True;14086;7306;6752;5676;2856;2811;8410;4450;3941
2104602;Governador Eugênio Barros;MA;21;Nordeste;CENTRO MARANHENSE;PRESIDENTE DUTRA;-5.323;-44.247;True;15857;8019;7835;4374;2065;2306;11483;5954;5529
2104628;Governador Luiz Rocha;MA;21;Nordeste;CENTRO MARANHENSE;PRESIDENTE DUTRA;-5.469;-44.074;True;6884;3503;3378;4764;2395;2366;2120;1108;1012
2104651;Governador Newton Bello;MA;21;Nordeste;OESTE MARANHENSE;PINDARE;-3.426;-45.676;True;11346;5634;5438;3779;1820;1901;7567;3814;3537
2104677;Governador Nunes Freire;MA;21;Nordeste;OESTE MARANHENSE;GURUPI;-2.126;-45.885;True;24012;12240;11759;14682;7296;7386;9330;4944;4373
2104701;Graça Aranha;MA;21;Nordeste;CENTRO MARANHENSE;PRESIDENTE DUTRA;-5.41;-44.334;True;6254;3037;3158;2995;1446;1549;3259;1591;1609
2104800;Grajaú;MA;21;Nordeste;CENTRO MARANHENSE;ALTO MEARIM E GRAJAU;-5.819;-46.139;True;54135;27519;26442;32018;15691;16183;22117;11828;10259
2104909;Guimarães;MA;21;Nordeste;NORTE MARANHENSE;LITORAL OCIDENTAL MARANHENSE;-2.133;-44.601;False;12387;6357;5914;5123;2515;2561;7264;3842;3353
2105005;Humberto de Campos;MA;21;Nordeste;NORTE MARANHENSE;LENCOIS MARANHENSES;-2.598;-43.461;True;24275;12653;11597;7744;3904;3833;16531;8749;7764
2105104;Icatu;MA;21;Nordeste;NORTE MARANHENSE;ROSARIO;-2.776;-44.066;True;24432;12719;11604;5715;2850;2853;18717;9869;8751
2105153;Igarapé do Meio;MA;21;Nordeste;NORTE MARANHENSE;BAIXADA MARANHENSE;-3.661;-45.227;True;11697;5710;5635;5227;2437;2535;6470;3273;3100
2105203;Igarapé Grande;MA;21;Nordeste;CENTRO MARANHENSE;MEDIO MEARIM;-4.585;-44.853;True;10676;5320;5294;6006;2894;3095;4670;2426;2199
2105302;Imperatriz;MA;21;Nordeste;OESTE MARANHENSE;IMPERATRIZ;-5.526;-47.476;True;229671;109644;118732;217192;103265;112763;12479;6379;5969
2105351;Itaipava do Grajaú;MA;21;Nordeste;CENTRO MARANHENSE;ALTO MEARIM E GRAJAU;-5.145;-45.791;True;13197;6869;6328;3561;1794;1767;9636;5075;4561
2105401;Itapecuru Mirim;MA;21;Nordeste;NORTE MARANHENSE;ITAPECURU MIRIM;-3.393;-44.359;True;54573;27108;27047;29425;14085;15271;25148;13023;11776
2105427;Itinga do Maranhão;MA;21;Nordeste;OESTE MARANHENSE;IMPERATRIZ;-4.45;-47.526;True;25100;12650;12352;18110;8872;9194;6990;3778;3158
2105450;Jatobá;MA;21;Nordeste;LESTE MARANHENSE;CHAPADAS DO ALTO ITAPECURU;-5.817;-44.223;True;8255;4175;4080;2412;1205;1207;5843;2970;2873
2105476;Jenipapo dos Vieiras;MA;21;Nordeste;CENTRO MARANHENSE;ALTO MEARIM E GRAJAU;-5.371;-45.636;True;14815;7715;7097;2404;1217;1187;12411;6498;5910
2105500;João Lisboa;MA;21;Nordeste;OESTE MARANHENSE;IMPERATRIZ;-5.448;-47.401;True;19928;9768;9977;14847;7190;7584;5081;2578;2393
2105609;Joselândia;MA;21;Nordeste;CENTRO MARANHENSE;ALTO MEARIM E GRAJAU;-4.967;-44.7;True;15583;7754;7622;4907;2324;2412;10676;5430;5210
2105658;Junco do Maranhão;MA;21;Nordeste;OESTE MARANHENSE;GURUPI;-1.844;-46.092;True;4014;2020;1984;2702;1338;1364;1312;682;620
2105708;Lago da Pedra;MA;21;Nordeste;OESTE MARANHENSE;PINDARE;-4.57;-45.132;True;42666;21150;21144;26267;12517;13659;16399;8633;7485
2105807;Lago do Junco;MA;21;Nordeste;CENTRO MARANHENSE;MEDIO MEARIM;-4.609;-45.049;True;9616;4844;4735;3217;1542;1655;6399;3302;3080
2105906;Lago Verde;MA;21;Nordeste;CENTRO MARANHENSE;MEDIO MEARIM;-3.957;-44.822;True;14580;7383;7179;5330;2612;2714;9250;4771;4465
2105922;Lagoa do Mato;MA;21;Nordeste;LESTE MARANHENSE;CHAPADAS DO ALTO ITAPECURU;-6.047;-43.526;True;10225;5239;4986;4110;2013;2097;6115;3226;2889
2105948;Lago dos Rodrigues;MA;21;Nordeste;CENTRO MARANHENSE;MEDIO MEARIM;-4.609;-44.98;True;7780;3880;3881;4488;2167;2321;3292;1713;1560
2105963;Lagoa Grande do Maranhão;MA;21;Nordeste;OESTE MARANHENSE;PINDARE;-4.813;-45.33;True;9015;4701;4174;4553;2277;2188;4462;2424;1986
2105989;Lajeado Novo;MA;21;Nordeste;OESTE MARANHENSE;IMPERATRIZ;-6.189;-47.035;True;6620;3453;3166;2813;1398;1415;3807;2055;1751
2106003;Lima Campos;MA;21;Nordeste;CENTRO MARANHENSE;MEDIO MEARIM;-4.52;-44.467;True;11365;5606;5735;6629;3159;3466;4736;2447;2269
2106102;Loreto;MA;21;Nordeste;SUL MARANHENSE;CHAPADAS DAS MANGABEIRAS;-7.084;-45.141;True;10340;5352;4987;5300;2631;2669;5040;2721;2318
2106201;Luís Domingues;MA;21;Nordeste;OESTE MARANHENSE;GURUPI;-1.268;-45.873;False;6672;3229;2955;5663;2690;2552;1009;539;403
2106300;Magalhães de Almeida;MA;21;Nordeste;LESTE MARANHENSE;BAIXO PARNAIBA MARANHENSE;-3.396;-42.204;True;14217;7227;6988;7292;3652;3640;6925;3575;3348
2106326;Maracaçumé;MA;21;Nordeste;OESTE MARANHENSE;GURUPI;-2.043;-45.959;True;17537;8869;8618;14476;7254;7197;3061;1615;1421
2106359;Marajá do Sena;MA;21;Nordeste;OESTE MARANHENSE;PINDARE;-4.599;-45.577;True;6790;3349;2849;976;496;472;5814;2853;2377
2106375;Maranhãozinho;MA;21;Nordeste;OESTE MARANHENSE;GURUPI;-2.241;-45.851;True;11887;5923;5964;7699;3776;3923;4188;2147;2041
2106409;Mata Roma;MA;21;Nordeste;LESTE MARANHENSE;CHAPADINHA;-3.625;-43.111;True;13812;6928;6666;6306;3015;3093;7506;3913;3573
2106508;Matinha;MA;21;Nordeste;NORTE MARANHENSE;BAIXADA MARANHENSE;-3.101;-45.034;True;20422;10357;10049;7831;3855;3976;12591;6502;6073
2106607;MatõEs;MA;21;Nordeste;LESTE MARANHENSE;CAXIAS;-5.519;-43.199;True;28278;14324;13879;11764;5789;5947;16514;8535;7932
2106631;MatõEs do Norte;MA;21;Nordeste;NORTE MARANHENSE;ITAPECURU MIRIM;-3.632;-44.556;True;10576;5505;5071;3334;1668;1666;7242;3837;3405
2106672;Milagres do Maranhão;MA;21;Nordeste;LESTE MARANHENSE;CHAPADINHA;-3.581;-42.609;True;7617;3968;3591;1671;860;811;5946;3108;2780
2106706;Mirador;MA;21;Nordeste;LESTE MARANHENSE;CHAPADAS DO ALTO ITAPECURU;-6.371;-44.363;True;19445;9907;9393;7953;3802;4129;11492;6105;5264
2106755;Miranda do Norte;MA;21;Nordeste;NORTE MARANHENSE;ITAPECURU MIRIM;-3.569;-44.584;True;17742;8694;8896;14951;7230;7569;2791;1464;1327
2106805;Mirinzal;MA;21;Nordeste;NORTE MARANHENSE;LITORAL OCIDENTAL MARANHENSE;-2.065;-44.784;True;13786;7087;6690;8695;4363;4332;5091;2724;2358
2106904;Monção;MA;21;Nordeste;NORTE MARANHENSE;BAIXADA MARANHENSE;-3.492;-45.251;True;27558;13942;13317;10345;5080;5228;17213;8862;8089
2107001;Montes Altos;MA;21;Nordeste;OESTE MARANHENSE;IMPERATRIZ;-5.831;-47.067;True;8828;4600;4228;4834;2409;2425;3994;2191;1803
2107100;Morros;MA;21;Nordeste;NORTE MARANHENSE;ROSARIO;-2.864;-44.039;True;17077;8864;8189;5303;2616;2683;11774;6248;5506
2107209;Nina Rodrigues;MA;21;Nordeste;NORTE MARANHENSE;ITAPECURU MIRIM;-3.466;-43.905;True;10003;4995;4810;3743;1766;1826;6260;3229;2984
2107258;Nova Colinas;MA;21;Nordeste;SUL MARANHENSE;CHAPADAS DAS MANGABEIRAS;-7.116;-46.257;True;4829;2576;2213;1963;1019;940;2866;1557;1273
2107308;Nova Iorque;MA;21;Nordeste;LESTE MARANHENSE;CHAPADAS DO ALTO ITAPECURU;-6.734;-44.044;True;4892;2476;2387;2913;1425;1484;1979;1051;903
2107357;Nova Olinda do Maranhão;MA;21;Nordeste;OESTE MARANHENSE;PINDARE;-2.847;-45.695;True;17121;8714;8398;10955;5466;5482;6166;3248;2916
2107407;Olho D'Água das Cunhãs;MA;21;Nordeste;CENTRO MARANHENSE;MEDIO MEARIM;-4.139;-45.12;True;17361;8405;8636;8798;4041;4607;8563;4364;4029
2107456;Olinda Nova do Maranhão;MA;21;Nordeste;NORTE MARANHENSE;BAIXADA MARANHENSE;-2.998;-44.997;True;12068;6266;5802;5055;2545;2510;7013;3721;3292
2107506;Paço do Lumiar;MA;21;Nordeste;NORTE MARANHENSE;AGLOMERACAO URBANA DE SAO LUIS;-2.532;-44.108;True;98175;47331;50835;1837;894;943;96338;46437;49892
2107605;Palmeirândia;MA;21;Nordeste;NORTE MARANHENSE;BAIXADA MARANHENSE;-2.645;-44.895;True;18105;9186;8916;3432;1655;1777;14673;7531;7139
2107704;Paraibano;MA;21;Nordeste;LESTE MARANHENSE;CHAPADAS DO ALTO ITAPECURU;-6.433;-43.984;True;19453;9625;9827;14973;7298;7674;4480;2327;2153
2107803;Parnarama;MA;21;Nordeste;LESTE MARANHENSE;CAXIAS;-5.682;-43.093;True;34912;17596;16903;12248;5849;6290;22664;11747;10613
2107902;Passagem Franca;MA;21;Nordeste;LESTE MARANHENSE;CHAPADAS DO ALTO ITAPECURU;-6.18;-43.784;True;17085;8533;8549;9612;4653;4959;7473;3880;3590
2108009;Pastos Bons;MA;21;Nordeste;LESTE MARANHENSE;CHAPADAS DO ALTO ITAPECURU;-6.602;-44.077;True;17507;8942;8488;11176;5577;5583;6331;3365;2905
2108058;Paulino Neves;MA;21;Nordeste;NORTE MARANHENSE;LENCOIS MARANHENSES;-2.719;-42.533;True;12799;6643;6061;3260;1669;1591;9539;4974;4470
2108108;Paulo Ramos;MA;21;Nordeste;OESTE MARANHENSE;PINDARE;-4.445;-45.239;True;16129;7870;7631;8680;4183;4130;7449;3687;3501
2108207;Pedreiras;MA;21;Nordeste;CENTRO MARANHENSE;MEDIO MEARIM;-4.574;-44.597;True;37984;18093;19634;32011;14950;16855;5973;3143;2779
2108256;Pedro do Rosário;MA;21;Nordeste;NORTE MARANHENSE;BAIXADA MARANHENSE;-2.973;-45.349;True;21714;11290;10311;4821;2378;2443;16893;8912;7868
2108306;Penalva;MA;21;Nordeste;NORTE MARANHENSE;BAIXADA MARANHENSE;-3.294;-45.174;True;33473;17034;16428;13997;6852;7143;19476;10182;9285
2108405;Peri Mirim;MA;21;Nordeste;NORTE MARANHENSE;BAIXADA MARANHENSE;-2.578;-44.854;True;12219;6271;5942;3346;1636;1710;8873;4635;4232
2108454;Peritoró;MA;21;Nordeste;LESTE MARANHENSE;CODO;-4.383;-44.333;True;19017;9463;9542;7442;3628;3814;11575;5835;5728
2108504;Pindaré-Mirim;MA;21;Nordeste;OESTE MARANHENSE;PINDARE;-3.608;-45.343;True;30927;15106;15678;22063;10515;11408;8864;4591;4270
2108603;Pinheiro;MA;21;Nordeste;NORTE MARANHENSE;BAIXADA MARANHENSE;-2.521;-45.083;True;74123;35721;37455;41467;19184;21869;32656;16537;15586
2108702;Pio Xii;MA;21;Nordeste;CENTRO MARANHENSE;MEDIO MEARIM;-3.894;-45.17;True;21821;10867;10737;12372;6018;6294;9449;4849;4443
2108801;Pirapemas;MA;21;Nordeste;NORTE MARANHENSE;ITAPECURU MIRIM;-3.727;-44.223;True;15043;7579;7464;9128;4403;4725;5915;3176;2739
2108900;Poção de Pedras;MA;21;Nordeste;CENTRO MARANHENSE;MEDIO MEARIM;-4.746;-44.943;True;15853;7836;8011;7984;3795;4189;7869;4041;3822
2109007;Porto Franco;MA;21;Nordeste;SUL MARANHENSE;PORTO FRANCO;-6.338;-47.399;True;18692;9428;9139;14193;6958;7117;4499;2470;2022
2109056;Porto Rico do Maranhão;MA;21;Nordeste;NORTE MARANHENSE;LITORAL OCIDENTAL MARANHENSE;-1.893;-44.605;False;6900;3656;3146;2715;1420;1279;4185;2236;1867
2109106;Presidente Dutra;MA;21;Nordeste;CENTRO MARANHENSE;PRESIDENTE DUTRA;-5.29;-44.49;True;40004;19515;20330;28290;13484;14680;11714;6031;5650
2109205;Presidente Juscelino;MA;21;Nordeste;NORTE MARANHENSE;ROSARIO;-2.928;-44.065;True;11705;6061;5632;4067;2002;2065;7638;4059;3567
2109239;Presidente Médici;MA;21;Nordeste;OESTE MARANHENSE;PINDARE;-2.387;-45.82;True;6058;3115;2931;3953;1978;1963;2105;1137;968
2109270;Presidente Sarney;MA;21;Nordeste;NORTE MARANHENSE;BAIXADA MARANHENSE;-2.591;-45.364;True;15606;7991;7495;3906;1898;2003;11700;6093;5492
2109304;Presidente Vargas;MA;21;Nordeste;NORTE MARANHENSE;ITAPECURU MIRIM;-3.407;-44.024;True;9798;4985;4805;4195;2099;2096;5603;2886;2709
2109403;Primeira Cruz;MA;21;Nordeste;NORTE MARANHENSE;LENCOIS MARANHENSES;-2.51;-43.438;True;11999;6335;5652;4032;2047;1973;7967;4288;3679
2109452;Raposa;MA;21;Nordeste;NORTE MARANHENSE;AGLOMERACAO URBANA DE SAO LUIS;-2.423;-44.103;False;24201;12043;12040;15916;7905;7908;8285;4138;4132
2109502;Riachão;MA;21;Nordeste;SUL MARANHENSE;GERAIS DE BALSAS;-7.362;-46.617;True;21016;10784;10030;9957;4872;4991;11059;5912;5039
2109551;Ribamar Fiquene;MA;21;Nordeste;OESTE MARANHENSE;IMPERATRIZ;-5.93;-47.384;True;7170;3731;3439;3475;1724;1751;3695;2007;1688
2109601;Rosário;MA;21;Nordeste;NORTE MARANHENSE;ROSARIO;-2.934;-44.235;True;37920;18798;18995;21936;10703;11142;15984;8095;7853
2109700;Sambaíba;MA;21;Nordeste;SUL MARANHENSE;CHAPADAS DAS MANGABEIRAS;-7.14;-45.346;True;5792;2961;2725;3019;1499;1495;2773;1462;1230
2109759;Santa Filomena do Maranhão;MA;21;Nordeste;CENTRO MARANHENSE;ALTO MEARIM E GRAJAU;-5.501;-44.561;True;5526;2860;2648;1905;981;924;3621;1879;1724
2109809;Santa Helena;MA;21;Nordeste;NORTE MARANHENSE;BAIXADA MARANHENSE;-2.231;-45.3;True;34022;16969;16988;14899;7086;7789;19123;9883;9199
2109908;Santa Inês;MA;21;Nordeste;OESTE MARANHENSE;PINDARE;-3.667;-45.38;True;82026;39235;42536;71280;33732;37330;10746;5503;5206
2110005;Santa Luzia;MA;21;Nordeste;OESTE MARANHENSE;PINDARE;-4.069;-45.69;True;69306;35191;33805;22236;10610;11615;47070;24581;22190
2110039;Santa Luzia do Paruá;MA;21;Nordeste;OESTE MARANHENSE;PINDARE;-2.629;-45.773;True;19633;9813;9745;11408;5564;5842;8225;4249;3903
2110104;Santa Quitéria do Maranhão;MA;21;Nordeste;LESTE MARANHENSE;BAIXO PARNAIBA MARANHENSE;-3.516;-42.547;True;28341;14442;13818;13177;6505;6662;15164;7937;7156
2110203;Santa Rita;MA;21;Nordeste;NORTE MARANHENSE;ROSARIO;-3.144;-44.326;True;30882;15467;15071;15243;7466;7726;15639;8001;7345
2110237;Santana do Maranhão;MA;21;Nordeste;LESTE MARANHENSE;BAIXO PARNAIBA MARANHENSE;-3.116;-42.412;True;10537;5585;4879;1768;910;858;8769;4675;4021
2110278;Santo Amaro do Maranhão;MA;21;Nordeste;NORTE MARANHENSE;LENCOIS MARANHENSES;-2.5;-43.254;True;11155;5882;5228;3241;1639;1602;7914;4243;3626
2110302;Santo Antônio dos Lopes;MA;21;Nordeste;CENTRO MARANHENSE;MEDIO MEARIM;-4.869;-44.36;True;14225;7175;6995;5645;2705;2912;8580;4470;4083
2110401;São Benedito do Rio Preto;MA;21;Nordeste;LESTE MARANHENSE;CHAPADINHA;-3.334;-43.528;True;17191;8759;8409;10400;5175;5216;6791;3584;3193
2110500;São Bento;MA;21;Nordeste;NORTE MARANHENSE;BAIXADA MARANHENSE;-2.696;-44.821;True;37449;18404;18996;21693;10239;11417;15756;8165;7579
2110609;São Bernardo;MA;21;Nordeste;LESTE MARANHENSE;BAIXO PARNAIBA MARANHENSE;-3.361;-42.418;True;25480;12925;12522;11157;5494;5660;14323;7431;6862
2110658;São Domingos do Azeitão;MA;21;Nordeste;SUL MARANHENSE;CHAPADAS DAS MANGABEIRAS;-6.81;-44.645;True;6953;3522;3424;4560;2282;2278;2393;1240;1146
2110708;São Domingos do Maranhão;MA;21;Nordeste;CENTRO MARANHENSE;PRESIDENTE DUTRA;-5.576;-44.385;True;32557;16321;16214;16379;7913;8466;16178;8408;7748
2110807;São Félix de Balsas;MA;21;Nordeste;SUL MARANHENSE;CHAPADAS DAS MANGABEIRAS;-7.083;-44.813;True;4398;2314;2082;1366;674;692;3032;1640;1390
2110856;São Francisco do Brejão;MA;21;Nordeste;OESTE MARANHENSE;IMPERATRIZ;-5.123;-47.386;True;8431;4365;3993;4108;2055;2053;4323;2310;1940
2110906;São Francisco do Maranhão;MA;21;Nordeste;LESTE MARANHENSE;CHAPADAS DO ALTO ITAPECURU;-6.251;-42.857;True;14194;7139;6989;3726;1768;1955;10468;5371;5034
2111003;São João Batista;MA;21;Nordeste;NORTE MARANHENSE;BAIXADA MARANHENSE;-2.955;-44.807;True;18108;8963;8755;3945;1862;2036;14163;7101;6719
2111029;São João do Carú;MA;21;Nordeste;OESTE MARANHENSE;PINDARE;-3.554;-46.256;True;12281;6336;5914;4639;2347;2269;7642;3989;3645
2111052;São João do Paraíso;MA;21;Nordeste;SUL MARANHENSE;PORTO FRANCO;-6.461;-47.058;True;11267;5932;5254;5065;2497;2514;6202;3435;2740
2111078;São João do Soter;MA;21;Nordeste;LESTE MARANHENSE;CAXIAS;-5.114;-43.81;True;16592;8453;8074;6093;3008;3029;10499;5445;5045
2111102;São João dos Patos;MA;21;Nordeste;LESTE MARANHENSE;CHAPADAS DO ALTO ITAPECURU;-6.495;-43.702;True;23576;11304;11858;19226;9110;9996;4350;2194;1862
2111201;São José de Ribamar;MA;21;Nordeste;NORTE MARANHENSE;AGLOMERACAO URBANA DE SAO LUIS;-2.562;-44.054;True;131379;63678;67238;52699;25166;27476;78680;38512;39762
2111250;São José dos Basílios;MA;21;Nordeste;CENTRO MARANHENSE;PRESIDENTE DUTRA;-5.051;-44.584;True;7282;3728;3551;3040;1532;1508;4242;2196;2043
2111300;São Luís;MA;21;Nordeste;NORTE MARANHENSE;AGLOMERACAO URBANA DE SAO LUIS;-2.53;-44.303;True;957515;444274;503833;917155;423251;485116;40360;21023;18717
2111409;São Luís Gonzaga do Maranhão;MA;21;Nordeste;CENTRO MARANHENSE;MEDIO MEARIM;-4.38;-44.67;True;19655;9859;9665;7067;3337;3730;12588;6522;5935
2111508;São Mateus do Maranhão;MA;21;Nordeste;CENTRO MARANHENSE;MEDIO MEARIM;-4.04;-44.47;True;38045;18798;18972;27723;13399;14096;10322;5399;4876
2111532;São Pedro da Água Branca;MA;21;Nordeste;OESTE MARANHENSE;IMPERATRIZ;-5.085;-48.429;True;11113;5668;5424;9853;4963;4876;1260;705;548
2111573;São Pedro dos Crentes;MA;21;Nordeste;SUL MARANHENSE;PORTO FRANCO;-6.826;-46.532;True;4020;2157;1833;2113;1079;1022;1907;1078;811
2111607;São Raimundo das Mangabeiras;MA;21;Nordeste;SUL MARANHENSE;CHAPADAS DAS MANGABEIRAS;-7.022;-45.481;True;15962;8134;7755;11399;5686;5653;4563;2448;2102
2111631;São Raimundo do Doca Bezerra;MA;21;Nordeste;CENTRO MARANHENSE;MEDIO MEARIM;-5.105;-45.077;True;4502;2353;2137;1628;819;809;2874;1534;1328
2111672;São Roberto;MA;21;Nordeste;CENTRO MARANHENSE;MEDIO MEARIM;-5.021;-44.991;True;4989;2574;2412;2432;1220;1209;2557;1354;1203
2111706;São Vicente Ferrer;MA;21;Nordeste;NORTE MARANHENSE;BAIXADA MARANHENSE;-2.894;-44.88;True;19692;9986;9659;5082;2476;2604;14610;7510;7055
2111722;Satubinha;MA;21;Nordeste;CENTRO MARANHENSE;MEDIO MEARIM;-4.039;-45.238;True;8399;4272;4095;2656;1329;1327;5743;2943;2768
2111748;Senador Alexandre Costa;MA;21;Nordeste;CENTRO MARANHENSE;PRESIDENTE DUTRA;-5.256;-44.056;True;9071;4540;4525;5653;2748;2904;3418;1792;1621
2111763;Senador La Rocque;MA;21;Nordeste;OESTE MARANHENSE;IMPERATRIZ;-5.443;-47.291;True;20793;10338;10152;8712;4141;4390;12081;6197;5762
2111789;Serrano do Maranhão;MA;21;Nordeste;NORTE MARANHENSE;LITORAL OCIDENTAL MARANHENSE;-1.856;-45.123;True;10576;5655;4851;3578;1840;1735;6998;3815;3116
2111805;Sítio Novo;MA;21;Nordeste;CENTRO MARANHENSE;ALTO MEARIM E GRAJAU;-5.878;-46.699;True;15549;8261;7266;4355;2132;2215;11194;6129;5051
2111904;Sucupira do Norte;MA;21;Nordeste;LESTE MARANHENSE;CHAPADAS DO ALTO ITAPECURU;-6.477;-44.192;True;10235;5227;4961;4678;2301;2365;5557;2926;2596
2111953;Sucupira do Riachão;MA;21;Nordeste;LESTE MARANHENSE;CHAPADAS DO ALTO ITAPECURU;-6.411;-43.546;True;4675;2427;2248;2866;1473;1393;1809;954;855
2112001;Tasso Fragoso;MA;21;Nordeste;SUL MARANHENSE;GERAIS DE BALSAS;-8.475;-45.743;True;6652;3292;3166;3886;1839;1915;2766;1453;1251
2112100;Timbiras;MA;21;Nordeste;LESTE MARANHENSE;CODO;-4.255;-43.941;True;26132;13026;12934;15831;7641;8139;10301;5385;4795
2112209;Timon;MA;21;Nordeste;LESTE MARANHENSE;CAXIAS;-5.094;-42.837;True;144333;69762;73423;127396;60960;65534;16937;8802;7889
2112233;Trizidela do Vale;MA;21;Nordeste;CENTRO MARANHENSE;MEDIO MEARIM;-4.538;-44.628;True;18300;8654;9295;15521;7271;8053;2779;1383;1242
2112274;Tufilândia;MA;21;Nordeste;OESTE MARANHENSE;PINDARE;-3.729;-45.554;True;5517;2810;2641;2398;1188;1174;3119;1622;1467
2112308;Tuntum;MA;21;Nordeste;CENTRO MARANHENSE;ALTO MEARIM E GRAJAU;-5.258;-44.649;True;37894;19146;18519;17603;8565;8955;20291;10581;9564
2112407;Turiaçu;MA;21;Nordeste;OESTE MARANHENSE;GURUPI;-1.663;-45.372;False;32491;16849;15524;10226;5040;5153;22265;11809;10371
2112456;Turilândia;MA;21;Nordeste;OESTE MARANHENSE;GURUPI;-2.201;-45.343;True;20119;10150;9694;9536;4643;4751;10583;5507;4943
2112506;Tutóia;MA;21;Nordeste;NORTE MARANHENSE;LENCOIS MARANHENSES;-2.762;-42.274;True;46280;23370;22440;13564;6705;6797;32716;16665;15643
2112605;Urbano Santos;MA;21;Nordeste;LESTE MARANHENSE;CHAPADINHA;-3.208;-43.404;True;21747;11040;10629;14427;7162;7187;7320;3878;3442
2112704;Vargem Grande;MA;21;Nordeste;NORTE MARANHENSE;ITAPECURU MIRIM;-3.543;-43.916;True;43228;21496;21669;23169;11083;12061;20059;10413;9608
2112803;Viana;MA;21;Nordeste;NORTE MARANHENSE;BAIXADA MARANHENSE;-3.22;-45.004;True;47466;23772;23487;26038;12609;13312;21428;11163;10175
2112852;Vila Nova dos Martírios;MA;21;Nordeste;OESTE MARANHENSE;IMPERATRIZ;-5.188;-48.136;True;8671;4343;3946;5176;2650;2468;3495;1693;1478
2112902;Vitória do Mearim;MA;21;Nordeste;NORTE MARANHENSE;BAIXADA MARANHENSE;-3.462;-44.871;True;30935;15452;15420;14117;6823;7294;16818;8629;8126
2113009;Vitorino Freire;MA;21;Nordeste;OESTE MARANHENSE;PINDARE;-4.282;-45.251;True;30235;14974;15259;14975;7145;7830;15260;7829;7429
2114007;Zé Doca;MA;21;Nordeste;OESTE MARANHENSE;PINDARE;-3.243;-45.824;True;45008;22288;22016;27562;13288;14161;17446;9000;7855
2200053;Acauã;PI;22;Nordeste;SUDESTE PIAUIENSE;ALTO MEDIO CANINDE;-8.215;-41.082;True;6300;2841;2684;1166;417;489;5134;2424;2195
2200103;Agricolândia;PI;22;Nordeste;CENTRO-NORTE PIAUIENSE;MEDIO PARNAIBA PIAUIENSE;-5.799;-42.669;True;4980;2418;2561;3924;1889;2035;1056;529;526
2200202;Água Branca;PI;22;Nordeste;CENTRO-NORTE PIAUIENSE;MEDIO PARNAIBA PIAUIENSE;-5.89;-42.638;True;15887;7600;8283;14281;6779;7498;1606;821;785
2200251;Alagoinha do Piauí;PI;22;Nordeste;SUDESTE PIAUIENSE;PIO IX;-7.008;-40.939;True;7447;3751;3696;2445;1142;1303;5002;2609;2393
2200277;Alegrete do Piauí;PI;22;Nordeste;SUDESTE PIAUIENSE;PIO IX;-7.243;-40.858;True;4482;2256;2226;2510;1232;1278;1972;1024;948
2200301;Alto Longá;PI;22;Nordeste;CENTRO-NORTE PIAUIENSE;CAMPO MAIOR;-5.251;-42.21;True;13612;6994;6617;6176;3033;3143;7436;3961;3474
2200400;Altos;PI;22;Nordeste;CENTRO-NORTE PIAUIENSE;TERESINA;-5.039;-42.461;True;38328;18865;19407;26858;12865;13949;11470;6000;5458
2200459;Alvorada do Gurguéia;PI;22;Nordeste;SUDOESTE PIAUIENSE;ALTO MEDIO GURGUEIA;-8.424;-43.777;True;4976;2630;2334;1831;953;878;3145;1677;1456
2200509;Amarante;PI;22;Nordeste;CENTRO-NORTE PIAUIENSE;MEDIO PARNAIBA PIAUIENSE;-6.241;-42.855;True;17316;8505;8711;8936;4150;4699;8380;4355;4012
2200608;Angical do Piauí;PI;22;Nordeste;CENTRO-NORTE PIAUIENSE;MEDIO PARNAIBA PIAUIENSE;-6.086;-42.739;True;6609;3191;3395;5022;2414;2600;1587;777;795
2200707;Anísio de Abreu;PI;22;Nordeste;SUDOESTE PIAUIENSE;SAO RAIMUNDO NONATO;-9.189;-43.046;True;8197;4174;3992;3829;1958;1861;4368;2216;2131
2200806;Antônio Almeida;PI;22;Nordeste;SUDOESTE PIAUIENSE;BERTOLINIA;-7.219;-44.198;True;3140;1525;1496;2281;1090;1123;859;435;373
2200905;Aroazes;PI;22;Nordeste;CENTRO-NORTE PIAUIENSE;VALENCA DO PIAUI;-6.119;-41.793;True;5857;2961;2886;3260;1612;1646;2597;1349;1240
2200954;Aroeiras do Itaim;PI;22;Nordeste;SUDESTE PIAUIENSE;PICOS;-7.276;-41.564;True;2654;1366;1267;254;126;125;2400;1240;1142
2201002;Arraial;PI;22;Nordeste;CENTRO-NORTE PIAUIENSE;MEDIO PARNAIBA PIAUIENSE;-6.655;-42.532;True;5002;2481;2494;2678;1245;1421;2324;1236;1073
2201051;Assunção do Piauí;PI;22;Nordeste;CENTRO-NORTE PIAUIENSE;CAMPO MAIOR;-5.198;-41.044;True;8011;4099;3904;3569;1782;1787;4442;2317;2117
2201101;Avelino Lopes;PI;22;Nordeste;SUDOESTE PIAUIENSE;CHAPADAS DO EXTREMO SUL PIAUIENSE;-10.137;-43.949;True;11507;5520;5424;6341;2922;3162;5166;2598;2262
2201150;Baixa Grande do Ribeiro;PI;22;Nordeste;SUDOESTE PIAUIENSE;ALTO PARNAIBA PIAUIENSE;-7.85;-45.214;True;10232;5285;4947;5566;2833;2733;4666;2452;2214
2201176;Barra D'Alcântara;PI;22;Nordeste;CENTRO-NORTE PIAUIENSE;VALENCA DO PIAUI;-6.517;-42.114;True;3774;1798;1931;1954;937;1017;1820;861;914
2201200;Barras;PI;22;Nordeste;NORTE PIAUIENSE;BAIXO PARNAIBA PIAUIENSE;-4.247;-42.296;True;43328;21786;21448;20999;10072;10908;22329;11714;10540
2201309;Barreiras do Piauí;PI;22;Nordeste;SUDOESTE PIAUIENSE;ALTO MEDIO GURGUEIA;-9.925;-45.475;True;3355;1774;1572;1875;951;924;1480;823;648
2201408;Barro Duro;PI;22;Nordeste;CENTRO-NORTE PIAUIENSE;MEDIO PARNAIBA PIAUIENSE;-5.818;-42.513;True;6661;3287;3266;4865;2354;2403;1796;933;863
2201507;Batalha;PI;22;Nordeste;NORTE PIAUIENSE;BAIXO PARNAIBA PIAUIENSE;-4.024;-42.078;True;25724;12944;12590;8480;4126;4351;17244;8818;8239
2201556;Bela Vista do Piauí;PI;22;Nordeste;SUDESTE PIAUIENSE;ALTO MEDIO CANINDE;-7.989;-41.868;True;3344;1713;1631;1143;585;558;2201;1128;1073
2201572;Belém do Piauí;PI;22;Nordeste;SUDESTE PIAUIENSE;ALTO MEDIO CANINDE;-7.376;-40.972;True;2788;1429;1355;1286;634;652;1502;795;703
2201606;Beneditinos;PI;22;Nordeste;CENTRO-NORTE PIAUIENSE;TERESINA;-5.455;-42.36;True;9560;4795;4755;5552;2655;2897;4008;2140;1858
2201705;Bertolínia;PI;22;Nordeste;SUDOESTE PIAUIENSE;BERTOLINIA;-7.641;-43.951;True;5302;2654;2589;3837;1879;1917;1465;775;672
2201739;Betânia do Piauí;PI;22;Nordeste;SUDESTE PIAUIENSE;ALTO MEDIO CANINDE;-8.148;-40.796;True;9312;4700;4565;1462;705;757;7850;3995;3808
2201770;Boa Hora;PI;22;Nordeste;NORTE PIAUIENSE;BAIXO PARNAIBA PIAUIENSE;-4.411;-42.086;True;6086;3137;2901;1368;676;676;4718;2461;2225
2201804;Bocaina;PI;22;Nordeste;SUDESTE PIAUIENSE;PICOS;-6.943;-41.323;True;4039;1975;2064;1693;814;879;2346;1161;1185
2201903;Bom Jesus;PI;22;Nordeste;SUDOESTE PIAUIENSE;ALTO MEDIO GURGUEIA;-9.074;-44.359;True;19532;9683;9639;14381;6935;7265;5151;2748;2374
2201919;Bom Princípio do Piauí;PI;22;Nordeste;NORTE PIAUIENSE;LITORAL PIAUIENSE;-3.191;-41.645;True;5276;2748;2528;1583;781;802;3693;1967;1726
2201929;Bonfim do Piauí;PI;22;Nordeste;SUDOESTE PIAUIENSE;SAO RAIMUNDO NONATO;-9.166;-42.874;True;5185;2633;2550;1398;706;692;3787;1927;1858
2201945;Boqueirão do Piauí;PI;22;Nordeste;CENTRO-NORTE PIAUIENSE;CAMPO MAIOR;-4.487;-42.074;True;6325;2990;2978;2506;1162;1205;3819;1828;1773
2201960;Brasileira;PI;22;Nordeste;NORTE PIAUIENSE;BAIXO PARNAIBA PIAUIENSE;-4.131;-41.782;True;7699;3900;3775;3276;1598;1672;4423;2302;2103
2201988;Brejo do Piauí;PI;22;Nordeste;SUDOESTE PIAUIENSE;SAO RAIMUNDO NONATO;-8.214;-42.826;True;3181;1596;1581;1296;624;672;1885;972;909
2202000;Buriti dos Lopes;PI;22;Nordeste;NORTE PIAUIENSE;LITORAL PIAUIENSE;-3.175;-41.867;True;19150;9668;9391;9639;4735;4866;9511;4933;4525
2202026;Buriti dos Montes;PI;22;Nordeste;CENTRO-NORTE PIAUIENSE;CAMPO MAIOR;-5.312;-41.098;True;7820;3945;3667;2124;1064;1060;5696;2881;2607
2202059;Cabeceiras do Piauí;PI;22;Nordeste;NORTE PIAUIENSE;BAIXO PARNAIBA PIAUIENSE;-4.476;-42.309;True;9438;4871;4532;1636;802;834;7802;4069;3698
2202075;Cajazeiras do Piauí;PI;22;Nordeste;SUDESTE PIAUIENSE;PICOS;-6.766;-42.392;True;3193;1642;1510;1006;497;499;2187;1145;1011
2202083;Cajueiro da Praia;PI;22;Nordeste;NORTE PIAUIENSE;LITORAL PIAUIENSE;-2.928;-41.336;True;6981;3645;3330;2575;1364;1211;4406;2281;2119
2202091;Caldeirão Grande do Piauí;PI;22;Nordeste;SUDESTE PIAUIENSE;ALTO MEDIO CANINDE;-7.332;-40.637;True;5622;2798;2790;1563;731;832;4059;2067;1958
2202109;Campinas do Piauí;PI;22;Nordeste;SUDESTE PIAUIENSE;ALTO MEDIO CANINDE;-7.66;-41.882;True;5598;2814;2750;1887;879;993;3711;1935;1757
2202117;Campo Alegre do Fidalgo;PI;22;Nordeste;SUDESTE PIAUIENSE;ALTO MEDIO CANINDE;-8.376;-41.836;True;4451;2284;2163;927;448;479;3524;1836;1684
2202133;Campo Grande do Piauí;PI;22;Nordeste;SUDESTE PIAUIENSE;ALTO MEDIO CANINDE;-7.132;-41.036;True;5645;2723;2647;1519;731;755;4126;1992;1892
2202174;Campo Largo do Piauí;PI;22;Nordeste;NORTE PIAUIENSE;BAIXO PARNAIBA PIAUIENSE;-3.812;-42.629;True;6726;3476;3242;1413;711;701;5313;2765;2541
2202208;Campo Maior;PI;22;Nordeste;CENTRO-NORTE PIAUIENSE;CAMPO MAIOR;-4.828;-42.169;True;44548;21585;22753;32283;15207;16907;12265;6378;5846
2202251;Canavieira;PI;22;Nordeste;SUDOESTE PIAUIENSE;FLORIANO;-7.688;-43.721;True;3984;2018;1904;1847;913;934;2137;1105;970
2202307;Canto do Buriti;PI;22;Nordeste;SUDOESTE PIAUIENSE;SAO RAIMUNDO NONATO;-8.11;-42.944;True;20673;10295;10297;10476;4955;5508;10197;5340;4789
2202406;Capitão de Campos;PI;22;Nordeste;CENTRO-NORTE PIAUIENSE;CAMPO MAIOR;-4.457;-41.944;True;10830;5426;5398;6225;3051;3174;4605;2375;2224
2202455;Capitão Gervásio Oliveira;PI;22;Nordeste;SUDESTE PIAUIENSE;ALTO MEDIO CANINDE;-8.49;-41.82;True;3865;2000;1865;849;417;432;3016;1583;1433
2202505;Caracol;PI;22;Nordeste;SUDOESTE PIAUIENSE;SAO RAIMUNDO NONATO;-9.279;-43.33;True;10343;5262;5000;3823;1883;1923;6520;3379;3077
2202539;Caraúbas do Piauí;PI;22;Nordeste;NORTE PIAUIENSE;LITORAL PIAUIENSE;-3.476;-41.843;True;5371;2804;2562;881;458;423;4490;2346;2139
2202554;Caridade do Piauí;PI;22;Nordeste;SUDESTE PIAUIENSE;ALTO MEDIO CANINDE;-7.733;-40.99;True;4583;2405;2175;1511;785;726;3072;1620;1449
2202604;Castelo do Piauí;PI;22;Nordeste;CENTRO-NORTE PIAUIENSE;CAMPO MAIOR;-5.322;-41.553;True;18550;9102;9348;11295;5317;5966;7255;3785;3382
2202653;Caxingó;PI;22;Nordeste;NORTE PIAUIENSE;LITORAL PIAUIENSE;-3.418;-41.896;True;5023;2690;2333;951;490;461;4072;2200;1872
2202703;Cocal;PI;22;Nordeste;NORTE PIAUIENSE;LITORAL PIAUIENSE;-3.471;-41.555;True;26201;13355;12833;11077;5468;5609;15124;7887;7224
2202711;Cocal de Telha;PI;22;Nordeste;CENTRO-NORTE PIAUIENSE;CAMPO MAIOR;-4.559;-41.972;True;4522;2196;2263;2633;1261;1372;1889;935;891
2202729;Cocal dos Alves;PI;22;Nordeste;NORTE PIAUIENSE;LITORAL PIAUIENSE;-3.729;-41.449;True;5341;2668;2668;1613;796;817;3728;1872;1851
2202737;Coivaras;PI;22;Nordeste;CENTRO-NORTE PIAUIENSE;TERESINA;-5.094;-42.207;True;3797;1987;1807;1089;540;549;2708;1447;1258
2202752;Colônia do Gurguéia;PI;22;Nordeste;SUDOESTE PIAUIENSE;BERTOLINIA;-8.182;-43.792;True;5700;2871;2823;4535;2266;2263;1165;605;560
2202778;Colônia do Piauí;PI;22;Nordeste;SUDESTE PIAUIENSE;PICOS;-7.231;-42.178;True;7662;3852;3810;2679;1334;1345;4983;2518;2465
2202802;Conceição do Canindé;PI;22;Nordeste;SUDESTE PIAUIENSE;ALTO MEDIO CANINDE;-7.878;-41.597;True;4923;2282;2282;2450;1099;1201;2473;1183;1081
2202851;Coronel José Dias;PI;22;Nordeste;SUDOESTE PIAUIENSE;SAO RAIMUNDO NONATO;-8.816;-42.513;True;4356;2271;1994;1375;723;652;2981;1548;1342
2202901;Corrente;PI;22;Nordeste;SUDOESTE PIAUIENSE;CHAPADAS DO EXTREMO SUL PIAUIENSE;-10.443;-45.162;True;24518;12410;12001;14090;6826;7250;10428;5584;4751
2203008;Cristalândia do Piauí;PI;22;Nordeste;SUDOESTE PIAUIENSE;CHAPADAS DO EXTREMO SUL PIAUIENSE;-10.653;-45.185;True;7800;4005;3671;3093;1490;1561;4707;2515;2110
2203107;Cristino Castro;PI;22;Nordeste;SUDOESTE PIAUIENSE;ALTO MEDIO GURGUEIA;-8.818;-44.224;True;9518;4794;4724;6845;3314;3531;2673;1480;1193
2203206;Curimatá;PI;22;Nordeste;SUDOESTE PIAUIENSE;CHAPADAS DO EXTREMO SUL PIAUIENSE;-10.036;-44.306;True;10360;5301;5059;5979;2935;3044;4381;2366;2015
2203230;Currais;PI;22;Nordeste;SUDOESTE PIAUIENSE;ALTO MEDIO GURGUEIA;-9.007;-44.411;True;4538;2365;2091;887;470;411;3651;1895;1680
2203255;Curralinhos;PI;22;Nordeste;CENTRO-NORTE PIAUIENSE;TERESINA;-5.583;-42.778;True;4072;2118;1954;1182;583;599;2890;1535;1355
2203271;Curral Novo do Piauí;PI;22;Nordeste;SUDESTE PIAUIENSE;ALTO MEDIO CANINDE;-7.832;-40.901;True;4898;2558;2338;1266;623;641;3632;1935;1697
2203305;Demerval Lobão;PI;22;Nordeste;CENTRO-NORTE PIAUIENSE;TERESINA;-5.358;-42.676;True;12806;6323;6483;10373;5030;5343;2433;1293;1140
2203354;Dirceu Arcoverde;PI;22;Nordeste;SUDOESTE PIAUIENSE;SAO RAIMUNDO NONATO;-9.338;-42.428;True;6721;3471;3250;2210;1090;1120;4511;2381;2130
2203404;Dom Expedito Lopes;PI;22;Nordeste;SUDESTE PIAUIENSE;PICOS;-6.959;-41.641;True;6532;3031;3236;3401;1613;1764;3131;1418;1472
2203420;Domingos Mourão;PI;22;Nordeste;CENTRO-NORTE PIAUIENSE;CAMPO MAIOR;-4.254;-41.27;True;4312;2202;2110;1020;490;530;3292;1712;1580
2203453;Dom Inocêncio;PI;22;Nordeste;SUDOESTE PIAUIENSE;SAO RAIMUNDO NONATO;-9.002;-41.974;True;10329;5422;4907;2034;1026;1008;8295;4396;3899
2203503;Elesbão Veloso;PI;22;Nordeste;CENTRO-NORTE PIAUIENSE;VALENCA DO PIAUI;-6.202;-42.14;True;14174;6950;7186;9637;4562;5068;4537;2388;2118
2203602;Eliseu Martins;PI;22;Nordeste;SUDOESTE PIAUIENSE;BERTOLINIA;-8.097;-43.664;True;4722;2446;2256;3815;1915;1890;907;531;366
2203701;Esperantina;PI;22;Nordeste;NORTE PIAUIENSE;BAIXO PARNAIBA PIAUIENSE;-3.902;-42.234;True;36190;18008;18126;21906;10504;11363;14284;7504;6763
2203750;Fartura do Piauí;PI;22;Nordeste;SUDOESTE PIAUIENSE;SAO RAIMUNDO NONATO;-9.484;-42.791;True;5190;2568;2499;1296;635;653;3894;1933;1846
2203800;Flores do Piauí;PI;22;Nordeste;SUDOESTE PIAUIENSE;FLORIANO;-7.791;-42.927;True;4468;2275;2193;1874;901;973;2594;1374;1220
2203859;Floresta do Piauí;PI;22;Nordeste;SUDESTE PIAUIENSE;ALTO MEDIO CANINDE;-7.469;-41.794;True;2551;1294;1252;852;438;414;1699;856;838
2203909;Floriano;PI;22;Nordeste;SUDOESTE PIAUIENSE;FLORIANO;-6.767;-43.023;True;56090;26305;29294;47962;22059;25649;8128;4246;3645
2204006;Francinópolis;PI;22;Nordeste;CENTRO-NORTE PIAUIENSE;VALENCA DO PIAUI;-6.396;-42.262;True;5292;2459;2671;3115;1436;1672;2177;1023;999
2204105;Francisco Ayres;PI;22;Nordeste;CENTRO-NORTE PIAUIENSE;MEDIO PARNAIBA PIAUIENSE;-6.623;-42.693;True;5017;2342;2332;2423;1058;1116;2594;1284;1216
2204154;Francisco Macedo;PI;22;Nordeste;SUDESTE PIAUIENSE;ALTO MEDIO CANINDE;-7.331;-40.788;True;2255;1129;1126;861;425;436;1394;704;690
2204204;Francisco Santos;PI;22;Nordeste;SUDESTE PIAUIENSE;PIO IX;-6.993;-41.138;True;8293;4143;4021;3560;1751;1799;4733;2392;2222
2204303;Fronteiras;PI;22;Nordeste;SUDESTE PIAUIENSE;ALTO MEDIO CANINDE;-7.088;-40.616;True;11054;5062;5204;6730;3113;3362;4324;1949;1842
2204352;Geminiano;PI;22;Nordeste;SUDESTE PIAUIENSE;PICOS;-7.158;-41.361;True;5255;2678;2570;1061;527;534;4194;2151;2036
2204402;Gilbués;PI;22;Nordeste;SUDOESTE PIAUIENSE;ALTO MEDIO GURGUEIA;-9.832;-45.344;True;10351;5238;5102;5038;2384;2647;5313;2854;2455
2204501;Guadalupe;PI;22;Nordeste;SUDOESTE PIAUIENSE;FLORIANO;-6.787;-43.569;True;9587;4736;4851;8967;4372;4595;620;364;256
2204550;Guaribas;PI;22;Nordeste;SUDOESTE PIAUIENSE;SAO RAIMUNDO NONATO;-9.398;-43.687;True;4343;2211;2132;1278;633;645;3065;1578;1487
2204600;Hugo Napoleão;PI;22;Nordeste;CENTRO-NORTE PIAUIENSE;MEDIO PARNAIBA PIAUIENSE;-5.989;-42.556;True;3674;1808;1866;2889;1387;1502;785;421;364
2204659;Ilha Grande;PI;22;Nordeste;NORTE PIAUIENSE;LITORAL PIAUIENSE;-2.858;-41.821;True;8420;4353;4067;7067;3629;3438;1353;724;629
2204709;Inhuma;PI;22;Nordeste;CENTRO-NORTE PIAUIENSE;VALENCA DO PIAUI;-6.668;-41.708;True;14973;7270;7466;6940;3262;3633;8033;4008;3833
2204808;Ipiranga do Piauí;PI;22;Nordeste;SUDESTE PIAUIENSE;PICOS;-6.828;-41.741;True;9354;4563;4691;5422;2586;2822;3932;1977;1869
2204907;Isaías Coelho;PI;22;Nordeste;SUDESTE PIAUIENSE;ALTO MEDIO CANINDE;-7.738;-41.676;True;7790;3888;3902;1790;830;960;6000;3058;2942
2205003;Itainópolis;PI;22;Nordeste;SUDESTE PIAUIENSE;ALTO MEDIO CANINDE;-7.447;-41.478;True;11084;5549;5535;2615;1258;1357;8469;4291;4178
2205102;Itaueira;PI;22;Nordeste;SUDOESTE PIAUIENSE;FLORIANO;-7.603;-43.026;True;10558;5340;5191;5316;2530;2783;5242;2810;2408
2205151;Jacobina do Piauí;PI;22;Nordeste;SUDESTE PIAUIENSE;ALTO MEDIO CANINDE;-7.935;-41.21;True;5597;2839;2750;886;415;471;4711;2424;2279
2205201;Jaicós;PI;22;Nordeste;SUDESTE PIAUIENSE;ALTO MEDIO CANINDE;-7.359;-41.138;True;16826;8138;8617;7811;3596;4188;9015;4542;4429
2205250;Jardim do Mulato;PI;22;Nordeste;CENTRO-NORTE PIAUIENSE;MEDIO PARNAIBA PIAUIENSE;-6.099;-42.63;True;4171;2109;2058;1143;538;605;3028;1571;1453
2205276;Jatobá do Piauí;PI;22;Nordeste;CENTRO-NORTE PIAUIENSE;CAMPO MAIOR;-4.771;-41.818;True;4523;2379;2068;926;445;427;3597;1934;1641
2205300;Jerumenha;PI;22;Nordeste;SUDOESTE PIAUIENSE;FLORIANO;-7.088;-43.51;True;4371;2218;2127;2452;1208;1244;1919;1010;883
2205359;João Costa;PI;22;Nordeste;SUDESTE PIAUIENSE;ALTO MEDIO CANINDE;-8.511;-42.414;True;3199;1585;1397;741;316;306;2458;1269;1091
2205409;Joaquim Pires;PI;22;Nordeste;NORTE PIAUIENSE;BAIXO PARNAIBA PIAUIENSE;-3.508;-42.198;True;13779;7117;6550;4098;1962;2122;9681;5155;4428
2205458;Joca Marques;PI;22;Nordeste;NORTE PIAUIENSE;BAIXO PARNAIBA PIAUIENSE;-3.478;-42.428;True;5345;2714;2476;1570;787;684;3775;1927;1792
2205508;José de Freitas;PI;22;Nordeste;CENTRO-NORTE PIAUIENSE;TERESINA;-4.756;-42.576;True;35164;17632;17412;20010;9749;10226;15154;7883;7186
2205516;Juazeiro do Piauí;PI;22;Nordeste;CENTRO-NORTE PIAUIENSE;CAMPO MAIOR;-5.172;-41.703;True;4769;2419;2340;1348;669;679;3421;1750;1661
2205524;Júlio Borges;PI;22;Nordeste;SUDOESTE PIAUIENSE;CHAPADAS DO EXTREMO SUL PIAUIENSE;-10.323;-44.238;True;5250;2716;2462;1240;601;639;4010;2115;1823
2205532;Jurema;PI;22;Nordeste;SUDOESTE PIAUIENSE;SAO RAIMUNDO NONATO;-9.231;-43.128;True;4388;2291;2052;620;326;294;3768;1965;1758
2205540;Lagoinha do Piauí;PI;22;Nordeste;CENTRO-NORTE PIAUIENSE;MEDIO PARNAIBA PIAUIENSE;-5.831;-42.623;True;2563;1187;1219;1589;709;747;974;478;472
2205557;Lagoa Alegre;PI;22;Nordeste;CENTRO-NORTE PIAUIENSE;TERESINA;-4.516;-42.625;True;7862;4053;3727;2805;1443;1362;5057;2610;2365
2205565;Lagoa do Barro do Piauí;PI;22;Nordeste;SUDESTE PIAUIENSE;ALTO MEDIO CANINDE;-8.478;-41.527;True;4543;2314;2229;971;472;499;3572;1842;1730
2205573;Lagoa de São Francisco;PI;22;Nordeste;CENTRO-NORTE PIAUIENSE;CAMPO MAIOR;-4.392;-41.601;True;6520;3335;3185;2045;1021;1024;4475;2314;2161
2205581;Lagoa do Piauí;PI;22;Nordeste;CENTRO-NORTE PIAUIENSE;TERESINA;-5.415;-42.643;True;3684;1903;1777;1453;704;749;2231;1199;1028
2205599;Lagoa do Sítio;PI;22;Nordeste;CENTRO-NORTE PIAUIENSE;VALENCA DO PIAUI;-6.513;-41.584;True;5042;2582;2453;1683;839;844;3359;1743;1609
2205607;Landri Sales;PI;22;Nordeste;SUDOESTE PIAUIENSE;BERTOLINIA;-7.266;-43.93;True;5586;2830;2737;3879;1882;1997;1707;948;740
2205706;Luís Correia;PI;22;Nordeste;NORTE PIAUIENSE;LITORAL PIAUIENSE;-2.879;-41.667;True;26147;13418;12586;11169;5560;5496;14978;7858;7090
2205805;Luzilândia;PI;22;Nordeste;NORTE PIAUIENSE;BAIXO PARNAIBA PIAUIENSE;-3.458;-42.37;True;24323;12243;12033;13293;6415;6855;11030;5828;5178
2205854;Madeiro;PI;22;Nordeste;NORTE PIAUIENSE;BAIXO PARNAIBA PIAUIENSE;-3.483;-42.504;True;7680;3971;3699;3139;1587;1552;4541;2384;2147
2205904;Manoel Emídio;PI;22;Nordeste;SUDOESTE PIAUIENSE;BERTOLINIA;-8.013;-43.872;True;5357;2793;2547;2674;1334;1333;2683;1459;1214
2205953;Marcolândia;PI;22;Nordeste;SUDESTE PIAUIENSE;ALTO MEDIO CANINDE;-7.443;-40.661;True;7154;3547;3607;5590;2725;2865;1564;822;742
2206001;Marcos Parente;PI;22;Nordeste;SUDOESTE PIAUIENSE;BERTOLINIA;-7.121;-43.894;True;4198;2065;2125;3524;1690;1828;674;375;297
2206050;Massapê do Piauí;PI;22;Nordeste;SUDESTE PIAUIENSE;ALTO MEDIO CANINDE;-7.463;-41.126;True;6428;3145;3036;878;422;456;5550;2723;2580
2206100;Matias Olímpio;PI;22;Nordeste;NORTE PIAUIENSE;BAIXO PARNAIBA PIAUIENSE;-3.716;-42.556;True;10465;5252;5142;4214;2051;2113;6251;3201;3029
2206209;Miguel Alves;PI;22;Nordeste;NORTE PIAUIENSE;BAIXO PARNAIBA PIAUIENSE;-4.166;-42.895;True;32178;16341;15508;10417;5039;5363;21761;11302;10145
2206308;Miguel Leão;PI;22;Nordeste;CENTRO-NORTE PIAUIENSE;TERESINA;-5.681;-42.739;True;1194;614;580;835;423;412;359;191;168
2206357;Milton Brandão;PI;22;Nordeste;CENTRO-NORTE PIAUIENSE;CAMPO MAIOR;-4.684;-41.422;True;7018;3585;3433;1674;833;841;5344;2752;2592
2206407;Monsenhor Gil;PI;22;Nordeste;CENTRO-NORTE PIAUIENSE;TERESINA;-5.564;-42.608;True;10321;5205;5116;5226;2535;2691;5095;2670;2425
2206506;Monsenhor Hipólito;PI;22;Nordeste;SUDESTE PIAUIENSE;PIO IX;-6.996;-41.03;True;7163;3612;3542;3092;1474;1618;4071;2138;1924
2206605;Monte Alegre do Piauí;PI;22;Nordeste;SUDOESTE PIAUIENSE;ALTO MEDIO GURGUEIA;-9.754;-45.304;True;10335;5259;5065;2764;1305;1456;7571;3954;3609
2206654;Morro Cabeça No Tempo;PI;22;Nordeste;SUDOESTE PIAUIENSE;CHAPADAS DO EXTREMO SUL PIAUIENSE;-9.725;-43.901;True;4241;2152;2057;1271;623;648;2970;1529;1409
2206670;Morro do Chapéu do Piauí;PI;22;Nordeste;NORTE PIAUIENSE;BAIXO PARNAIBA PIAUIENSE;-3.743;-42.312;True;6377;3311;3066;2147;1045;1102;4230;2266;1964
2206696;Murici dos Portelas;PI;22;Nordeste;NORTE PIAUIENSE;LITORAL PIAUIENSE;-3.319;-42.094;True;7655;4043;3606;1568;783;785;6087;3260;2821
2206704;Nazaré do Piauí;PI;22;Nordeste;SUDOESTE PIAUIENSE;FLORIANO;-6.973;-42.672;True;6947;3497;3411;2676;1288;1376;4271;2209;2035
2206753;Nossa Senhora de Nazaré;PI;22;Nordeste;CENTRO-NORTE PIAUIENSE;CAMPO MAIOR;-4.631;-42.173;True;4048;2037;2001;1250;626;624;2798;1411;1377
2206803;Nossa Senhora dos Remédios;PI;22;Nordeste;NORTE PIAUIENSE;BAIXO PARNAIBA PIAUIENSE;-3.979;-42.621;True;8044;4022;3975;2978;1383;1578;5066;2639;2397
2206902;Novo Oriente do Piauí;PI;22;Nordeste;CENTRO-NORTE PIAUIENSE;VALENCA DO PIAUI;-6.449;-41.939;True;6191;3038;3153;2865;1365;1500;3326;1673;1653
2206951;Novo Santo Antônio;PI;22;Nordeste;CENTRO-NORTE PIAUIENSE;CAMPO MAIOR;-5.288;-41.933;True;3383;1753;1626;732;353;377;2651;1400;1249
2207009;Oeiras;PI;22;Nordeste;SUDESTE PIAUIENSE;PICOS;-7.025;-42.131;True;35075;16888;18163;20740;9542;11198;14335;7346;6965
2207108;Olho D'Água do Piauí;PI;22;Nordeste;CENTRO-NORTE PIAUIENSE;MEDIO PARNAIBA PIAUIENSE;-5.841;-42.575;True;2637;1363;1272;1016;504;512;1621;859;760
2207207;Padre Marcos;PI;22;Nordeste;SUDESTE PIAUIENSE;ALTO MEDIO CANINDE;-7.355;-40.904;True;7340;3538;3662;2744;1285;1454;4596;2253;2208
2207306;Paes Landim;PI;22;Nordeste;SUDESTE PIAUIENSE;ALTO MEDIO CANINDE;-7.778;-42.256;True;4462;2266;2196;2468;1171;1297;1994;1095;899
2207355;Pajeú do Piauí;PI;22;Nordeste;SUDOESTE PIAUIENSE;SAO RAIMUNDO NONATO;-7.856;-42.822;True;3616;1905;1711;1412;703;709;2204;1202;1002
2207405;Palmeira do Piauí;PI;22;Nordeste;SUDOESTE PIAUIENSE;ALTO MEDIO GURGUEIA;-8.727;-44.236;True;4985;2574;2411;1584;777;807;3401;1797;1604
2207504;Palmeirais;PI;22;Nordeste;CENTRO-NORTE PIAUIENSE;MEDIO PARNAIBA PIAUIENSE;-5.978;-43.063;True;13721;6853;6868;5093;2427;2666;8628;4426;4202
2207553;Paquetá;PI;22;Nordeste;SUDESTE PIAUIENSE;PICOS;-7.104;-41.704;True;4531;2339;2192;559;278;281;3972;2061;1911
2207603;Parnaguá;PI;22;Nordeste;SUDOESTE PIAUIENSE;CHAPADAS DO EXTREMO SUL PIAUIENSE;-10.227;-44.639;True;10313;5474;4817;5236;2677;2559;5077;2797;2258
2207702;Parnaíba;PI;22;Nordeste;NORTE PIAUIENSE;LITORAL PIAUIENSE;-2.905;-41.777;True;140839;67390;73395;132591;63025;69512;8248;4365;3883
2207751;Passagem Franca do Piauí;PI;22;Nordeste;CENTRO-NORTE PIAUIENSE;MEDIO PARNAIBA PIAUIENSE;-5.858;-42.44;True;4127;2055;1977;2158;1021;1097;1969;1034;880
2207777;Patos do Piauí;PI;22;Nordeste;SUDESTE PIAUIENSE;ALTO MEDIO CANINDE;-7.668;-41.244;True;6171;3146;3025;1560;740;820;4611;2406;2205
2207793;Pau D'Arco do Piauí;PI;22;Nordeste;CENTRO-NORTE PIAUIENSE;CAMPO MAIOR;-5.261;-42.394;True;3713;1937;1772;406;209;197;3307;1728;1575
2207801;Paulistana;PI;22;Nordeste;SUDESTE PIAUIENSE;ALTO MEDIO CANINDE;-8.144;-41.15;True;16930;8176;8742;9810;4588;5222;7120;3588;3520
2207850;Pavussu;PI;22;Nordeste;SUDOESTE PIAUIENSE;FLORIANO;-7.966;-43.223;True;4291;2267;2007;1916;970;942;2375;1297;1065
2207900;Pedro Ii;PI;22;Nordeste;CENTRO-NORTE PIAUIENSE;CAMPO MAIOR;-4.425;-41.459;True;36675;18168;18447;21740;10471;11228;14935;7697;7219
2207934;Pedro Laurentino;PI;22;Nordeste;SUDESTE PIAUIENSE;ALTO MEDIO CANINDE;-8.068;-42.285;True;2105;1071;1030;721;336;385;1384;735;645
2207959;Nova Santa Rita;PI;22;Nordeste;SUDESTE PIAUIENSE;ALTO MEDIO CANINDE;-8.087;-42.052;True;4284;2149;1991;719;342;377;3565;1807;1614
2208007;Picos;PI;22;Nordeste;SUDESTE PIAUIENSE;PICOS;-7.077;-41.467;True;70450;33650;36490;54648;25749;28703;15802;7901;7787
2208106;Pimenteiras;PI;22;Nordeste;CENTRO-NORTE PIAUIENSE;VALENCA DO PIAUI;-6.245;-41.419;True;11722;5942;5752;4622;2274;2348;7100;3668;3404
2208205;Pio Ix;PI;22;Nordeste;SUDESTE PIAUIENSE;PIO IX;-6.838;-40.579;True;17123;8603;8513;5018;2343;2675;12105;6260;5838
2208304;Piracuruca;PI;22;Nordeste;NORTE PIAUIENSE;LITORAL PIAUIENSE;-3.928;-41.709;True;25625;12722;12860;17614;8462;9134;8011;4260;3726
2208403;Piripiri;PI;22;Nordeste;NORTE PIAUIENSE;BAIXO PARNAIBA PIAUIENSE;-4.273;-41.777;True;60249;29203;30946;42862;20181;22618;17387;9022;8328
2208502;Porto;PI;22;Nordeste;NORTE PIAUIENSE;BAIXO PARNAIBA PIAUIENSE;-3.893;-42.71;True;11492;5767;5604;7385;3577;3690;4107;2190;1914
2208551;Porto Alegre do Piauí;PI;22;Nordeste;SUDOESTE PIAUIENSE;BERTOLINIA;-6.967;-44.182;True;2468;1272;1167;1620;797;794;848;475;373
2208601;Prata do Piauí;PI;22;Nordeste;CENTRO-NORTE PIAUIENSE;VALENCA DO PIAUI;-5.667;-42.207;True;3159;1600;1559;2635;1315;1320;524;285;239
2208650;Queimada Nova;PI;22;Nordeste;SUDESTE PIAUIENSE;ALTO MEDIO CANINDE;-8.579;-41.419;True;9146;4598;4548;1023;488;535;8123;4110;4013
2208700;Redenção do Gurguéia;PI;22;Nordeste;SUDOESTE PIAUIENSE;ALTO MEDIO GURGUEIA;-9.487;-44.586;True;8263;4183;4060;5236;2555;2665;3027;1628;1395
2208809;Regeneração;PI;22;Nordeste;CENTRO-NORTE PIAUIENSE;MEDIO PARNAIBA PIAUIENSE;-6.238;-42.688;True;17633;8474;8837;13558;6431;6986;4075;2043;1851
2208858;Riacho Frio;PI;22;Nordeste;SUDOESTE PIAUIENSE;CHAPADAS DO EXTREMO SUL PIAUIENSE;-10.125;-44.953;True;4884;2554;2245;2019;984;1014;2865;1570;1231
2208874;Ribeira do Piauí;PI;22;Nordeste;SUDESTE PIAUIENSE;ALTO MEDIO CANINDE;-7.691;-42.713;True;4103;2073;2030;813;391;422;3290;1682;1608
2208908;Ribeiro Gonçalves;PI;22;Nordeste;SUDOESTE PIAUIENSE;ALTO PARNAIBA PIAUIENSE;-7.558;-45.242;True;6577;3290;3187;3555;1706;1753;3022;1584;1434
2209005;Rio Grande do Piauí;PI;22;Nordeste;SUDOESTE PIAUIENSE;FLORIANO;-7.775;-43.142;True;6430;3241;3189;3880;1888;1992;2550;1353;1197
2209104;Santa Cruz do Piauí;PI;22;Nordeste;SUDESTE PIAUIENSE;PICOS;-7.185;-41.768;True;5790;2835;2934;3912;1850;2054;1878;985;880
2209153;Santa Cruz dos Milagres;PI;22;Nordeste;CENTRO-NORTE PIAUIENSE;VALENCA DO PIAUI;-5.804;-41.956;True;3352;1651;1648;1894;908;971;1458;743;677
2209203;Santa Filomena;PI;22;Nordeste;SUDOESTE PIAUIENSE;ALTO PARNAIBA PIAUIENSE;-9.112;-45.922;True;5999;3172;2825;3221;1634;1587;2778;1538;1238
2209302;Santa Luz;PI;22;Nordeste;SUDOESTE PIAUIENSE;ALTO MEDIO GURGUEIA;-8.954;-44.129;True;5280;2755;2525;2929;1511;1418;2351;1244;1107
2209351;Santana do Piauí;PI;22;Nordeste;SUDESTE PIAUIENSE;PICOS;-6.948;-41.519;True;4841;2412;2429;1914;959;955;2927;1453;1474
2209377;Santa Rosa do Piauí;PI;22;Nordeste;SUDESTE PIAUIENSE;PICOS;-6.799;-42.288;True;5149;2557;2592;3625;1781;1844;1524;776;748
2209401;Santo Antônio de Lisboa;PI;22;Nordeste;SUDESTE PIAUIENSE;PIO IX;-6.981;-41.234;True;5729;2862;2863;3601;1765;1836;2128;1097;1027
2209450;Santo Antônio dos Milagres;PI;22;Nordeste;CENTRO-NORTE PIAUIENSE;MEDIO PARNAIBA PIAUIENSE;-6.047;-42.71;True;1963;979;984;752;378;374;1211;601;610
2209500;Santo Inácio do Piauí;PI;22;Nordeste;SUDESTE PIAUIENSE;ALTO MEDIO CANINDE;-7.43;-41.911;True;3626;1839;1787;2177;1049;1128;1449;790;659
2209559;São Braz do Piauí;PI;22;Nordeste;SUDOESTE PIAUIENSE;SAO RAIMUNDO NONATO;-8.962;-43.004;True;4311;2231;2052;1048;525;523;3263;1706;1529
2209609;São Félix do Piauí;PI;22;Nordeste;CENTRO-NORTE PIAUIENSE;VALENCA DO PIAUI;-5.933;-42.114;True;3132;1541;1591;1663;791;872;1469;750;719
2209658;São Francisco de Assis do Piauí;PI;22;Nordeste;SUDESTE PIAUIENSE;ALTO MEDIO CANINDE;-8.238;-41.686;True;5015;2555;2458;1137;541;596;3878;2014;1862
2209708;São Francisco do Piauí;PI;22;Nordeste;SUDOESTE PIAUIENSE;FLORIANO;-7.251;-42.543;True;6276;3213;3063;1691;789;902;4585;2424;2161
2209757;São Gonçalo do Gurguéia;PI;22;Nordeste;SUDOESTE PIAUIENSE;ALTO MEDIO GURGUEIA;-10.03;-45.303;True;2455;1279;1158;1101;552;537;1354;727;621
2209807;São Gonçalo do Piauí;PI;22;Nordeste;CENTRO-NORTE PIAUIENSE;MEDIO PARNAIBA PIAUIENSE;-5.993;-42.703;True;4342;2173;2169;3178;1571;1607;1164;602;562
2209856;São João da Canabrava;PI;22;Nordeste;SUDESTE PIAUIENSE;PICOS;-6.817;-41.343;True;4364;2061;2186;1270;564;659;3094;1497;1527
2209872;São João da Fronteira;PI;22;Nordeste;NORTE PIAUIENSE;LITORAL PIAUIENSE;-3.956;-41.258;True;5008;2525;2465;1753;846;905;3255;1679;1560
2209906;São João da Serra;PI;22;Nordeste;CENTRO-NORTE PIAUIENSE;CAMPO MAIOR;-5.514;-41.899;True;6672;3283;3389;3503;1669;1834;3169;1614;1555
2209955;São João da Varjota;PI;22;Nordeste;SUDESTE PIAUIENSE;PICOS;-6.942;-41.89;True;4776;2371;2397;1255;600;647;3521;1771;1750
2209971;São João do Arraial;PI;22;Nordeste;NORTE PIAUIENSE;BAIXO PARNAIBA PIAUIENSE;-3.819;-42.446;True;7081;3540;3436;3484;1716;1762;3597;1824;1674
2210003;São João do Piauí;PI;22;Nordeste;SUDESTE PIAUIENSE;ALTO MEDIO CANINDE;-8.358;-42.247;True;18689;9139;9492;12088;5699;6355;6601;3440;3137
2210052;São José do Divino;PI;22;Nordeste;NORTE PIAUIENSE;LITORAL PIAUIENSE;-3.811;-41.833;True;5045;2618;2424;2633;1304;1326;2412;1314;1098
2210102;São José do Peixe;PI;22;Nordeste;SUDOESTE PIAUIENSE;FLORIANO;-7.494;-42.564;True;3730;1869;1804;1848;859;932;1882;1010;872
2210201;São José do Piauí;PI;22;Nordeste;SUDESTE PIAUIENSE;PICOS;-6.872;-41.475;True;6808;3420;3383;2030;992;1038;4778;2428;2345
2210300;São Julião;PI;22;Nordeste;SUDESTE PIAUIENSE;PIO IX;-7.085;-40.826;True;5908;2940;2943;2776;1320;1439;3132;1620;1504
2210359;São Lourenço do Piauí;PI;22;Nordeste;SUDOESTE PIAUIENSE;SAO RAIMUNDO NONATO;-9.169;-42.545;True;4899;2225;2178;1099;440;468;3800;1785;1710
2210375;São Luis do Piauí;PI;22;Nordeste;SUDESTE PIAUIENSE;PICOS;-6.825;-41.324;True;2596;1250;1314;719;344;375;1877;906;939
2210383;São Miguel da Baixa Grande;PI;22;Nordeste;CENTRO-NORTE PIAUIENSE;VALENCA DO PIAUI;-5.864;-42.186;True;2083;1057;1026;1348;658;690;735;399;336
2210391;São Miguel do Fidalgo;PI;22;Nordeste;SUDOESTE PIAUIENSE;FLORIANO;-7.586;-42.37;True;3078;1598;1480;1037;491;546;2041;1107;934
2210409;São Miguel do Tapuio;PI;22;Nordeste;CENTRO-NORTE PIAUIENSE;CAMPO MAIOR;-5.504;-41.323;True;19201;9860;9297;7036;3367;3653;12165;6493;5644
2210508;São Pedro do Piauí;PI;22;Nordeste;CENTRO-NORTE PIAUIENSE;MEDIO PARNAIBA PIAUIENSE;-5.929;-42.719;True;13083;6478;6515;7751;3743;3926;5332;2735;2589
2210607;São Raimundo Nonato;PI;22;Nordeste;SUDOESTE PIAUIENSE;SAO RAIMUNDO NONATO;-9.015;-42.699;True;30852;15155;15633;19670;9380;10243;11182;5775;5390
2210623;Sebastião Barros;PI;22;Nordeste;SUDOESTE PIAUIENSE;CHAPADAS DO EXTREMO SUL PIAUIENSE;-10.817;-44.834;True;4178;2224;1916;923;481;442;3255;1743;1474
2210631;Sebastião Leal;PI;22;Nordeste;SUDOESTE PIAUIENSE;BERTOLINIA;-7.566;-44.064;True;4080;2097;1913;1732;878;854;2348;1219;1059
2210656;Sigefredo Pacheco;PI;22;Nordeste;CENTRO-NORTE PIAUIENSE;CAMPO MAIOR;-4.918;-41.732;True;9506;4824;4573;3032;1491;1533;6474;3333;3040
2210706;SimõEs;PI;22;Nordeste;SUDESTE PIAUIENSE;ALTO MEDIO CANINDE;-7.599;-40.818;True;13734;6834;6885;5535;2616;2912;8199;4218;3973
2210805;Simplício Mendes;PI;22;Nordeste;SUDESTE PIAUIENSE;ALTO MEDIO CANINDE;-7.854;-41.91;True;11472;5817;5642;6931;3373;3553;4541;2444;2089
2210904;Socorro do Piauí;PI;22;Nordeste;SUDESTE PIAUIENSE;ALTO MEDIO CANINDE;-7.866;-42.491;True;4599;2341;2247;1732;855;877;2867;1486;1370
2210938;Sussuapara;PI;22;Nordeste;SUDESTE PIAUIENSE;PICOS;-7.043;-41.384;True;5537;2726;2802;1414;689;725;4123;2037;2077
2210953;Tamboril do Piauí;PI;22;Nordeste;SUDOESTE PIAUIENSE;SAO RAIMUNDO NONATO;-8.4;-42.914;True;2897;1498;1399;1505;753;752;1392;745;647
2210979;Tanque do Piauí;PI;22;Nordeste;SUDESTE PIAUIENSE;PICOS;-6.6;-42.282;True;2605;1284;1307;1212;588;624;1393;696;683
2211001;Teresina;PI;22;Nordeste;CENTRO-NORTE PIAUIENSE;TERESINA;-5.089;-42.802;True;779939;361346;410775;735164;338491;389283;44775;22855;21492
2211100;União;PI;22;Nordeste;CENTRO-NORTE PIAUIENSE;TERESINA;-4.586;-42.864;True;41661;20835;20620;19952;9554;10264;21709;11281;10356
2211209;Uruçuí;PI;22;Nordeste;SUDOESTE PIAUIENSE;ALTO PARNAIBA PIAUIENSE;-7.229;-44.556;True;19017;9375;9354;13204;6363;6678;5813;3012;2676
2211308;Valença do Piauí;PI;22;Nordeste;CENTRO-NORTE PIAUIENSE;VALENCA DO PIAUI;-6.408;-41.746;True;19716;9267;10441;13917;6345;7566;5799;2922;2875
2211357;Várzea Branca;PI;22;Nordeste;SUDOESTE PIAUIENSE;SAO RAIMUNDO NONATO;-9.239;-42.964;True;5178;2608;2497;1225;608;617;3953;2000;1880
2211407;Várzea Grande;PI;22;Nordeste;CENTRO-NORTE PIAUIENSE;VALENCA DO PIAUI;-6.545;-42.246;True;4429;2108;2321;2582;1189;1393;1847;919;928
2211506;Vera Mendes;PI;22;Nordeste;SUDESTE PIAUIENSE;ALTO MEDIO CANINDE;-7.603;-41.483;True;3097;1566;1522;999;477;522;2098;1089;1000
2211605;Vila Nova do Piauí;PI;22;Nordeste;SUDESTE PIAUIENSE;ALTO MEDIO CANINDE;-7.136;-40.94;True;3030;1560;1470;682;338;344;2348;1222;1126
2211704;Wall Ferraz;PI;22;Nordeste;SUDESTE PIAUIENSE;PICOS;-7.233;-41.91;True;4452;2274;2178;1193;571;622;3259;1703;1556
2300101;Abaiara;CE;23;Nordeste;SUL CEARENSE;BREJO SANTO;-7.359;-39.046;True;10227;5136;5075;4138;2033;2099;6089;3103;2976
2300150;Acarapé;CE;23;Nordeste;NORTE CEARENSE;BATURITE;-4.224;-38.708;True;14658;7287;7367;7781;3749;4028;6877;3538;3339
2300200;Acaraú;CE;23;Nordeste;NOROESTE CEARENSE;LITORAL DE CAMOCIM E ACARAU;-2.886;-40.12;True;52123;26392;25692;27135;13438;13680;24988;12954;12012
2300309;Acopiara;CE;23;Nordeste;SERTOES CEARENSES;SERTAO DE SENADOR POMPEU;-6.095;-39.453;True;48703;24541;24162;24494;11746;12748;24209;12795;11414
2300408;Aiuaba;CE;23;Nordeste;SERTOES CEARENSES;SERTAO DE INHAMUNS;-6.574;-40.124;True;15585;7580;7589;3630;1675;1940;11955;5905;5649
2300507;Alcântaras;CE;23;Nordeste;NOROESTE CEARENSE;MERUOCA;-3.589;-40.546;True;10270;4996;5274;3088;1456;1632;7182;3540;3642
2300606;Altaneira;CE;23;Nordeste;SUL CEARENSE;CARIRIACU;-7.002;-39.741;True;6417;3009;3146;4485;2051;2205;1932;958;941
2300705;Alto Santo;CE;23;Nordeste;JAGUARIBE;BAIXO JAGUARIBE;-5.521;-38.272;True;19154;9658;9453;7509;3570;3925;11645;6088;5528
2300754;Amontada;CE;23;Nordeste;NORTE CEARENSE;ITAPIPOCA;-3.361;-39.831;True;37513;19477;18031;14125;7080;7042;23388;12397;10989
2300804;Antonina do Norte;CE;23;Nordeste;CENTRO-SUL CEARENSE;VARZEA ALEGRE;-6.775;-39.989;True;6761;3271;3490;4657;2158;2499;2104;1113;991
2300903;Apuiarés;CE;23;Nordeste;NORTE CEARENSE;MEDIO CURU;-3.949;-39.432;True;13649;6966;6654;6056;3004;3047;7593;3962;3607
2301000;Aquiraz;CE;23;Nordeste;METROPOLITANA DE FORTALEZA;FORTALEZA;-3.901;-38.391;True;67265;34620;32645;59894;30364;29530;7371;4256;3115
2301109;Aracati;CE;23;Nordeste;JAGUARIBE;LITORAL DE ARACATI;-4.562;-37.77;True;66049;32155;32865;41742;19866;21490;24307;12289;11375
2301208;Aracoiaba;CE;23;Nordeste;NORTE CEARENSE;BATURITE;-4.371;-38.814;True;24423;12204;11946;13175;6434;6658;11248;5770;5288
2301257;Ararendá;CE;23;Nordeste;SERTOES CEARENSES;SERTAO DE CRATEUS;-4.753;-40.833;True;10649;5224;5425;4863;2332;2531;5786;2892;2894
2301307;Araripe;CE;23;Nordeste;SUL CEARENSE;CHAPADA DO ARARIPE;-7.213;-40.046;True;21214;10067;10077;12851;5748;6175;8363;4319;3902
2301406;Aratuba;CE;23;Nordeste;NORTE CEARENSE;BATURITE;-4.418;-39.045;True;12129;6211;5892;3042;1433;1609;9087;4778;4283
2301505;Arneiroz;CE;23;Nordeste;SERTOES CEARENSES;SERTAO DE INHAMUNS;-6.324;-40.161;True;7302;3697;3604;2572;1227;1345;4730;2470;2259
2301604;Assaré;CE;23;Nordeste;SUL CEARENSE;CHAPADA DO ARARIPE;-6.874;-39.875;True;21616;10696;10843;10117;4732;5364;11499;5964;5479
2301703;Aurora;CE;23;Nordeste;SUL CEARENSE;BARRO;-6.943;-38.968;True;24480;12225;12252;10873;5233;5640;13607;6992;6612
2301802;Baixio;CE;23;Nordeste;CENTRO-SUL CEARENSE;LAVRAS DA MANGABEIRA;-6.73;-38.717;True;5780;2921;2859;2948;1432;1516;2832;1489;1343
2301851;Banabuiú;CE;23;Nordeste;SERTOES CEARENSES;SERTAO DE QUIXERAMOBIM;-5.31;-38.921;True;17448;8914;8514;8435;4115;4316;9013;4799;4198
2301901;Barbalha;CE;23;Nordeste;SUL CEARENSE;CARIRI;-7.305;-39.302;True;50386;24558;25706;34133;16355;17745;16253;8203;7961
2301950;Barreira;CE;23;Nordeste;NORTE CEARENSE;CHOROZINHO;-4.287;-38.643;True;18453;9191;9262;7227;3509;3718;11226;5682;5544
2302008;Barro;CE;23;Nordeste;SUL CEARENSE;BARRO;-7.177;-38.782;True;20673;10221;10345;12006;5805;6192;8667;4416;4153
2302057;Barroquinha;CE;23;Nordeste;NOROESTE CEARENSE;LITORAL DE CAMOCIM E ACARAU;-3.019;-41.137;True;14812;7546;7258;9717;4807;4910;5095;2739;2348
2302107;Baturité;CE;23;Nordeste;NORTE CEARENSE;BATURITE;-4.329;-38.885;True;31669;15698;15965;22912;11107;11805;8757;4591;4160
2302206;Beberibe;CE;23;Nordeste;NORTE CEARENSE;CASCAVEL;-4.18;-38.131;True;46155;23070;22445;19881;9771;9916;26274;13299;12529
2302305;Bela Cruz;CE;23;Nordeste;NOROESTE CEARENSE;LITORAL DE CAMOCIM E ACARAU;-3.051;-40.168;True;29566;15049;14428;12274;6049;6225;17292;9000;8203
2302404;Boa Viagem;CE;23;Nordeste;SERTOES CEARENSES;SERTAO DE QUIXERAMOBIM;-5.128;-39.732;True;53538;26973;26565;25770;12371;13399;27768;14602;13166
2302503;Brejo Santo;CE;23;Nordeste;SUL CEARENSE;BREJO SANTO;-7.493;-38.985;True;39613;18970;20299;24346;11330;12749;15267;7640;7550
2302602;Camocim;CE;23;Nordeste;NOROESTE CEARENSE;LITORAL DE CAMOCIM E ACARAU;-2.902;-40.841;True;58470;28855;29401;43234;20918;22199;15236;7937;7202
2302701;Campos Sales;CE;23;Nordeste;SUL CEARENSE;CHAPADA DO ARARIPE;-7.074;-40.376;True;25553;12112;13101;18309;8479;9588;7244;3633;3513
2302800;Canindé;CE;23;Nordeste;NORTE CEARENSE;CANINDE;-4.359;-39.312;True;73878;36674;37052;44392;21256;23109;29486;15418;13943
2302909;Capistrano;CE;23;Nordeste;NORTE CEARENSE;BATURITE;-4.47;-38.901;True;16403;8347;8021;5790;2838;2952;10613;5509;5069
2303006;Caridade;CE;23;Nordeste;NORTE CEARENSE;CANINDE;-4.232;-39.193;True;17977;9061;8792;9656;4711;4844;8321;4350;3948
2303105;Cariré;CE;23;Nordeste;NOROESTE CEARENSE;SOBRAL;-3.951;-40.473;True;18527;9200;9277;7816;3767;4040;10711;5433;5237
2303204;Caririaçu;CE;23;Nordeste;SUL CEARENSE;CARIRIACU;-7.042;-39.284;True;26325;12753;13543;11797;5526;6251;14528;7227;7292
2303303;Cariús;CE;23;Nordeste;CENTRO-SUL CEARENSE;VARZEA ALEGRE;-6.537;-39.497;True;18649;9343;9186;7678;3644;3921;10971;5699;5265
2303402;Carnaubal;CE;23;Nordeste;NOROESTE CEARENSE;IBIAPABA;-4.167;-40.943;True;16001;7945;7875;7617;3714;3889;8384;4231;3986
2303501;Cascavel;CE;23;Nordeste;NORTE CEARENSE;CASCAVEL;-4.131;-38.236;True;63932;31680;31984;53947;26448;27289;9985;5232;4695
2303600;Catarina;CE;23;Nordeste;SERTOES CEARENSES;SERTAO DE INHAMUNS;-6.131;-39.878;True;17028;8390;8638;8585;4037;4548;8443;4353;4090
2303659;Catunda;CE;23;Nordeste;NOROESTE CEARENSE;SANTA QUITERIA;-4.648;-40.201;True;10508;5380;5125;5130;2526;2601;5378;2854;2524
2303709;Caucaia;CE;23;Nordeste;METROPOLITANA DE FORTALEZA;FORTALEZA;-3.733;-38.656;True;316906;;;;;;;;
2303808;Cedro;CE;23;Nordeste;CENTRO-SUL CEARENSE;IGUATU;-6.607;-39.062;True;24607;12167;12436;14480;6963;7513;10127;5204;4923
2303907;Chaval;CE;23;Nordeste;NOROESTE CEARENSE;LITORAL DE CAMOCIM E ACARAU;-3.034;-41.244;True;12215;5960;6252;8816;4209;4604;3399;1751;1648
2303931;Choró;CE;23;Nordeste;SERTOES CEARENSES;SERTAO DE QUIXERAMOBIM;-4.843;-39.141;True;12790;6624;6163;3511;1730;1781;9279;4894;4382
2303956;Chorozinho;CE;23;Nordeste;NORTE CEARENSE;CHOROZINHO;-4.3;-38.497;True;18261;9268;8921;10624;5270;5295;7637;3998;3626
2304004;Coreaú;CE;23;Nordeste;NOROESTE CEARENSE;COREAU;-3.533;-40.657;True;21171;10611;10560;12112;5832;6280;9059;4779;4280
2304103;Crateús;CE;23;Nordeste;SERTOES CEARENSES;SERTAO DE CRATEUS;-5.178;-40.678;True;72386;35415;36904;49847;23714;26089;22539;11701;10815
2304202;Crato;CE;23;Nordeste;SUL CEARENSE;CARIRI;-7.234;-39.409;True;111198;51729;57382;92884;42802;48593;18314;8927;8789
2304236;Croatá;CE;23;Nordeste;NOROESTE CEARENSE;IBIAPABA;-4.4;-40.911;True;17317;8511;8780;7072;3364;3700;10245;5147;5080
2304251;Cruz;CE;23;Nordeste;NOROESTE CEARENSE;LITORAL DE CAMOCIM E ACARAU;-2.918;-40.172;True;22144;10974;11052;9539;4656;4883;12605;6318;6169
2304269;Deputado Irapuan Pinheiro;CE;23;Nordeste;SERTOES CEARENSES;SERTAO DE SENADOR POMPEU;-5.917;-39.268;True;9108;4569;4535;3717;1768;1945;5391;2801;2590
2304277;Ererê;CE;23;Nordeste;JAGUARIBE;SERRA DO PEREIRO;-6.032;-38.349;True;6927;3489;3437;3291;1578;1713;3636;1911;1724
2304285;Eusébio;CE;23;Nordeste;METROPOLITANA DE FORTALEZA;FORTALEZA;-3.89;-38.451;True;38189;18972;19093;38189;18972;19093;;;
2304301;Farias Brito;CE;23;Nordeste;SUL CEARENSE;CARIRIACU;-6.931;-39.566;True;19244;9320;9672;8091;3810;4226;11153;5510;5446
2304350;Forquilha;CE;23;Nordeste;NOROESTE CEARENSE;SOBRAL;-3.798;-40.261;True;20181;10057;9953;13550;6594;6801;6631;3463;3152
2304400;Fortaleza;CE;23;Nordeste;METROPOLITANA DE FORTALEZA;FORTALEZA;-3.717;-38.543;True;2431415;;;;;;;;
2304459;Fortim;CE;23;Nordeste;JAGUARIBE;LITORAL DE ARACATI;-4.452;-37.797;True;14072;7084;6895;9589;4801;4771;4483;2283;2124
2304509;Frecheirinha;CE;23;Nordeste;NOROESTE CEARENSE;COREAU;-3.76;-40.816;True;12830;6316;6368;7102;3418;3682;5728;2898;2686
2304608;General Sampaio;CE;23;Nordeste;NORTE CEARENSE;MEDIO CURU;-4.053;-39.454;True;6540;3322;3185;2685;1301;1351;3855;2021;1834
2304657;Graça;CE;23;Nordeste;NOROESTE CEARENSE;SOBRAL;-4.046;-40.753;True;15297;7580;7713;5697;2725;2972;9600;4855;4741
2304707;Granja;CE;23;Nordeste;NOROESTE CEARENSE;LITORAL DE CAMOCIM E ACARAU;-3.12;-40.826;True;51410;26300;24996;25217;12469;12692;26193;13831;12304
2304806;Granjeiro;CE;23;Nordeste;SUL CEARENSE;CARIRIACU;-6.888;-39.218;True;4931;2397;2516;1312;627;683;3619;1770;1833
2304905;Groaíras;CE;23;Nordeste;NOROESTE CEARENSE;SOBRAL;-3.913;-40.383;True;9456;4660;4790;6499;3141;3352;2957;1519;1438
2304954;Guaiúba;CE;23;Nordeste;METROPOLITANA DE FORTALEZA;FORTALEZA;-4.04;-38.637;True;22405;11347;10966;17461;8804;8647;4944;2543;2319
2305001;Guaraciaba do Norte;CE;23;Nordeste;NOROESTE CEARENSE;IBIAPABA;-4.167;-40.748;True;36705;18218;18470;17250;8382;8851;19455;9836;9619
2305100;Guaramiranga;CE;23;Nordeste;NORTE CEARENSE;BATURITE;-4.263;-38.933;True;4307;2203;2086;2387;1224;1163;1920;979;923
2305209;Hidrolândia;CE;23;Nordeste;NOROESTE CEARENSE;SANTA QUITERIA;-4.408;-40.438;True;18534;9283;9246;10503;5145;5358;8031;4138;3888
2305233;Horizonte;CE;23;Nordeste;METROPOLITANA DE FORTALEZA;PACAJUS;-4.099;-38.496;True;48660;24300;24273;42457;21049;21333;6203;3251;2940
2305266;Ibaretama;CE;23;Nordeste;SERTOES CEARENSES;SERTAO DE QUIXERAMOBIM;-4.804;-38.753;True;12728;6572;6156;4190;2094;2096;8538;4478;4060
2305308;Ibiapina;CE;23;Nordeste;NOROESTE CEARENSE;IBIAPABA;-3.923;-40.889;True;23088;11542;11520;9687;4690;4992;13401;6852;6528
2305332;Ibicuitinga;CE;23;Nordeste;JAGUARIBE;BAIXO JAGUARIBE;-4.974;-38.639;True;11000;5718;5273;5602;2867;2735;5398;2851;2538
2305357;Icapuí;CE;23;Nordeste;JAGUARIBE;LITORAL DE ARACATI;-4.713;-37.355;True;18186;9410;8768;5578;2839;2739;12608;6571;6029
2305407;Icó;CE;23;Nordeste;CENTRO-SUL CEARENSE;IGUATU;-6.401;-38.862;True;63262;30829;32012;28817;13497;15165;34445;17332;16847
2305506;Iguatu;CE;23;Nordeste;CENTRO-SUL CEARENSE;IGUATU;-6.359;-39.299;True;92260;44752;47496;69748;33156;36583;22512;11596;10913
2305605;Independência;CE;23;Nordeste;SERTOES CEARENSES;SERTAO DE CRATEUS;-5.396;-40.309;True;25413;12755;12635;10833;5130;5703;14580;7625;6932
2305654;Ipaporanga;CE;23;Nordeste;SERTOES CEARENSES;SERTAO DE CRATEUS;-4.9;-40.759;True;11353;5654;5695;3596;1718;1878;7757;3936;3817
2305704;Ipaumirim;CE;23;Nordeste;CENTRO-SUL CEARENSE;LAVRAS DA MANGABEIRA;-6.79;-38.719;True;11591;5764;5824;6639;3213;3426;4952;2551;2398
2305803;Ipu;CE;23;Nordeste;NOROESTE CEARENSE;IPU;-4.322;-40.711;True;39438;19429;19860;23496;11203;12217;15942;8226;7643
2305902;Ipueiras;CE;23;Nordeste;NOROESTE CEARENSE;IPU;-4.542;-40.719;True;38044;18812;19230;18247;8840;9405;19797;9972;9825
2306009;Iracema;CE;23;Nordeste;JAGUARIBE;SERRA DO PEREIRO;-5.812;-38.306;True;14313;7120;7186;9977;4816;5154;4336;2304;2032
2306108;Irauçuba;CE;23;Nordeste;NOROESTE CEARENSE;SOBRAL;-3.746;-39.783;True;21921;11182;10674;13362;6624;6738;8559;4558;3936
2306207;Itaiçaba;CE;23;Nordeste;JAGUARIBE;LITORAL DE ARACATI;-4.674;-37.822;True;7462;3677;3715;4018;1911;2107;3444;1766;1608
2306256;Itaitinga;CE;23;Nordeste;METROPOLITANA DE FORTALEZA;FORTALEZA;-3.969;-38.528;True;31107;15473;15440;28519;14151;14174;2588;1322;1266
2306306;Itapagé;CE;23;Nordeste;NORTE CEARENSE;URUBURETAMA;-3.687;-39.586;True;45426;22528;22798;31951;15434;16438;13475;7094;6360
2306405;Itapipoca;CE;23;Nordeste;NORTE CEARENSE;ITAPIPOCA;-3.494;-39.579;True;107281;54132;52789;60240;29352;30718;47041;24780;22071
2306504;Itapiúna;CE;23;Nordeste;NORTE CEARENSE;BATURITE;-4.564;-38.922;True;17602;8927;8643;8393;4071;4322;9209;4856;4321
2306553;Itarema;CE;23;Nordeste;NOROESTE CEARENSE;LITORAL DE CAMOCIM E ACARAU;-2.92;-39.915;True;34296;17762;16515;13950;7034;6897;20346;10728;9618
2306603;Itatira;CE;23;Nordeste;NORTE CEARENSE;CANINDE;-4.529;-39.622;True;17689;9024;8600;7812;3817;3958;9877;5207;4642
2306702;Jaguaretama;CE;23;Nordeste;JAGUARIBE;MEDIO JAGUARIBE;-5.613;-38.767;True;17851;8928;8635;8208;3785;4181;9643;5143;4454
2306801;Jaguaribara;CE;23;Nordeste;JAGUARIBE;MEDIO JAGUARIBE;-5.658;-38.62;True;9780;4923;4812;6415;3113;3284;3365;1810;1528
2306900;Jaguaribe;CE;23;Nordeste;JAGUARIBE;MEDIO JAGUARIBE;-5.891;-38.622;True;35237;17344;17807;22455;10654;11750;12782;6690;6057
2307007;Jaguaruana;CE;23;Nordeste;JAGUARIBE;BAIXO JAGUARIBE;-4.834;-37.781;True;30965;15534;15386;18037;8765;9240;12928;6769;6146
2307106;Jardim;CE;23;Nordeste;SUL CEARENSE;CARIRI;-7.582;-39.298;True;25853;12727;13094;7910;3754;4156;17943;8973;8938
2307205;Jati;CE;23;Nordeste;SUL CEARENSE;BREJO SANTO;-7.686;-39.016;True;7270;3568;3630;4399;2112;2274;2871;1456;1356
2307254;Jijoca de Jericoacoara;CE;23;Nordeste;NOROESTE CEARENSE;LITORAL DE CAMOCIM E ACARAU;-2.794;-40.513;True;15442;7766;7676;4615;2221;2394;10827;5545;5282
2307304;Juazeiro do Norte;CE;23;Nordeste;SUL CEARENSE;CARIRI;-7.213;-39.315;True;242139;;;;;;;;
2307403;Jucás;CE;23;Nordeste;CENTRO-SUL CEARENSE;VARZEA ALEGRE;-6.525;-39.528;True;22890;11274;11600;12495;5927;6565;10395;5347;5035
2307502;Lavras da Mangabeira;CE;23;Nordeste;CENTRO-SUL CEARENSE;LAVRAS DA MANGABEIRA;-6.753;-38.972;True;29872;14932;14911;16954;8240;8700;12918;6692;6211
2307601;Limoeiro do Norte;CE;23;Nordeste;JAGUARIBE;BAIXO JAGUARIBE;-5.146;-38.098;True;53289;26106;27175;30188;14423;15758;23101;11683;11417
2307635;Madalena;CE;23;Nordeste;SERTOES CEARENSES;SERTAO DE QUIXERAMOBIM;-4.857;-39.577;True;17051;8596;8455;6228;2960;3268;10823;5636;5187
2307650;Maracanaú;CE;23;Nordeste;METROPOLITANA DE FORTALEZA;FORTALEZA;-3.877;-38.626;True;197301;;;;;;;;
2307700;Maranguape;CE;23;Nordeste;METROPOLITANA DE FORTALEZA;FORTALEZA;-3.89;-38.686;True;102982;50684;52143;80792;39101;41572;22190;11583;10571
2307809;Marco;CE;23;Nordeste;NOROESTE CEARENSE;LITORAL DE CAMOCIM E ACARAU;-3.124;-40.147;True;23107;11520;11068;14037;6883;6861;9070;4637;4207
2307908;Martinópole;CE;23;Nordeste;NOROESTE CEARENSE;LITORAL DE CAMOCIM E ACARAU;-3.226;-40.697;True;10304;5182;5122;7966;3921;4045;2338;1261;1077
2308005;Massapê;CE;23;Nordeste;NOROESTE CEARENSE;SOBRAL;-3.523;-40.343;True;33256;16494;16744;22660;10977;11671;10596;5517;5073
2308104;Mauriti;CE;23;Nordeste;SUL CEARENSE;BARRO;-7.389;-38.774;True;41679;20757;20866;21277;10367;10889;20402;10390;9977
2308203;Meruoca;CE;23;Nordeste;NOROESTE CEARENSE;MERUOCA;-3.542;-40.455;True;12148;6095;6034;6490;3201;3289;5658;2894;2745
2308302;Milagres;CE;23;Nordeste;SUL CEARENSE;BREJO SANTO;-7.313;-38.946;True;27355;13299;13902;11508;5412;5987;15847;7887;7915
2308351;Milhã;CE;23;Nordeste;SERTOES CEARENSES;SERTAO DE SENADOR POMPEU;-5.675;-39.194;True;14111;7111;6947;6559;3196;3363;7552;3915;3584
2308377;Miraíma;CE;23;Nordeste;NOROESTE CEARENSE;SOBRAL;-3.569;-39.97;True;12131;6335;5796;6208;3149;3059;5923;3186;2737
2308401;Missão Velha;CE;23;Nordeste;SUL CEARENSE;CARIRI;-7.25;-39.143;True;33690;16558;16895;14617;7024;7520;19073;9534;9375
2308500;Mombaça;CE;23;Nordeste;SERTOES CEARENSES;SERTAO DE SENADOR POMPEU;-5.743;-39.628;True;44364;22258;22097;18693;8822;9868;25671;13436;12229
2308609;Monsenhor Tabosa;CE;23;Nordeste;SERTOES CEARENSES;SERTAO DE CRATEUS;-4.789;-40.063;True;16557;8289;8268;8771;4213;4558;7786;4076;3710
2308708;Morada Nova;CE;23;Nordeste;JAGUARIBE;BAIXO JAGUARIBE;-5.107;-38.373;True;61751;31156;30460;33807;16490;17230;27944;14666;13230
2308807;Moraújo;CE;23;Nordeste;NOROESTE CEARENSE;COREAU;-3.467;-40.681;True;8005;4052;3944;3232;1572;1660;4773;2480;2284
2308906;Morrinhos;CE;23;Nordeste;NOROESTE CEARENSE;LITORAL DE CAMOCIM E ACARAU;-3.229;-40.125;True;21111;10318;9962;8878;4216;4267;12233;6102;5695
2309003;Mucambo;CE;23;Nordeste;NOROESTE CEARENSE;SOBRAL;-3.909;-40.747;True;14007;6730;7273;8487;3887;4596;5520;2843;2677
2309102;Mulungu;CE;23;Nordeste;NORTE CEARENSE;BATURITE;-4.306;-38.996;True;10975;5581;5392;4077;1970;2107;6898;3611;3285
2309201;Nova Olinda;CE;23;Nordeste;SUL CEARENSE;CARIRI;-7.092;-39.681;True;12974;6329;6515;7750;3716;4001;5224;2613;2514
2309300;Nova Russas;CE;23;Nordeste;SERTOES CEARENSES;SERTAO DE CRATEUS;-4.707;-40.563;True;30615;14988;15600;22194;10616;11570;8421;4372;4030
2309409;Novo Oriente;CE;23;Nordeste;SERTOES CEARENSES;SERTAO DE CRATEUS;-5.534;-40.774;True;27418;13667;13641;13755;6665;7045;13663;7002;6596
2309458;Ocara;CE;23;Nordeste;NORTE CEARENSE;CHOROZINHO;-4.491;-38.597;True;23359;12037;11322;7131;3585;3546;16228;8452;7776
2309508;Orós;CE;23;Nordeste;CENTRO-SUL CEARENSE;IGUATU;-6.244;-38.914;True;21268;10375;10885;15562;7489;8073;5706;2886;2812
2309607;Pacajus;CE;23;Nordeste;METROPOLITANA DE FORTALEZA;PACAJUS;-4.173;-38.461;True;54881;26950;27873;44339;21540;22767;10542;5410;5106
2309706;Pacatuba;CE;23;Nordeste;METROPOLITANA DE FORTALEZA;FORTALEZA;-3.984;-38.62;True;65772;32236;33413;57244;27772;29363;8528;4464;4050
2309805;Pacoti;CE;23;Nordeste;NORTE CEARENSE;BATURITE;-4.225;-38.923;True;11097;5637;5440;4490;2187;2297;6607;3450;3143
2309904;Pacujá;CE;23;Nordeste;NOROESTE CEARENSE;SOBRAL;-3.988;-40.697;True;5950;2874;3076;3700;1763;1937;2250;1111;1139
2310001;Palhano;CE;23;Nordeste;JAGUARIBE;BAIXO JAGUARIBE;-4.745;-37.959;True;8797;4418;4317;4379;2161;2218;4418;2257;2099
2310100;Palmácia;CE;23;Nordeste;NORTE CEARENSE;BATURITE;-4.15;-38.846;True;10352;5262;5076;4510;2232;2278;5842;3030;2798
2310209;Paracuru;CE;23;Nordeste;NORTE CEARENSE;BAIXO CURU;-3.41;-39.031;True;30665;15477;15148;19650;9702;9922;11015;5775;5226
2310258;Paraipaba;CE;23;Nordeste;NORTE CEARENSE;BAIXO CURU;-3.439;-39.148;True;28192;14465;13677;13231;6636;6558;14961;7829;7119
2310308;Parambu;CE;23;Nordeste;SERTOES CEARENSES;SERTAO DE INHAMUNS;-6.211;-40.694;True;30596;15045;15518;12891;6070;6821;17705;8975;8697
2310407;Paramoti;CE;23;Nordeste;NORTE CEARENSE;CANINDE;-4.097;-39.239;True;11573;5934;5636;5149;2520;2626;6424;3414;3010
2310506;Pedra Branca;CE;23;Nordeste;SERTOES CEARENSES;SERTAO DE SENADOR POMPEU;-5.454;-39.717;True;40762;20262;20377;20720;9868;10785;20042;10394;9592
2310605;Penaforte;CE;23;Nordeste;SUL CEARENSE;BREJO SANTO;-7.829;-39.077;True;7715;3772;3918;5517;2657;2838;2198;1115;1080
2310704;Pentecoste;CE;23;Nordeste;NORTE CEARENSE;MEDIO CURU;-3.793;-39.27;True;33717;17030;16500;20359;9952;10368;13358;7078;6132
2310803;Pereiro;CE;23;Nordeste;JAGUARIBE;SERRA DO PEREIRO;-6.045;-38.461;True;15291;7550;7736;5518;2633;2882;9773;4917;4854
2310852;Pindoretama;CE;23;Nordeste;NORTE CEARENSE;CASCAVEL;-4.028;-38.306;True;17143;8580;8551;10375;5119;5244;6768;3461;3307
2310902;Piquet Carneiro;CE;23;Nordeste;SERTOES CEARENSES;SERTAO DE SENADOR POMPEU;-5.804;-39.418;True;14736;7458;7278;6475;3117;3358;8261;4341;3920
2310951;Pires Ferreira;CE;23;Nordeste;NOROESTE CEARENSE;IPU;-4.247;-40.645;True;9483;4811;4672;3058;1507;1551;6425;3304;3121
2311009;Poranga;CE;23;Nordeste;NOROESTE CEARENSE;IPU;-4.745;-40.926;True;11905;5980;5921;7805;3882;3919;4100;2098;2002
2311108;Porteiras;CE;23;Nordeste;SUL CEARENSE;CARIRI;-7.535;-39.118;True;14792;7248;7488;5093;2437;2656;9699;4811;4832
2311207;Potengi;CE;23;Nordeste;SUL CEARENSE;CHAPADA DO ARARIPE;-7.091;-40.027;True;9670;4555;4751;3968;1792;2075;5702;2763;2676
2311231;Potiretama;CE;23;Nordeste;JAGUARIBE;SERRA DO PEREIRO;-5.668;-38.251;True;6478;3326;3146;2469;1207;1262;4009;2119;1884
2311264;Quiterianópolis;CE;23;Nordeste;SERTOES CEARENSES;SERTAO DE CRATEUS;-5.843;-40.701;True;20079;10047;9976;5952;2874;3078;14127;7173;6898
2311306;Quixadá;CE;23;Nordeste;SERTOES CEARENSES;SERTAO DE QUIXERAMOBIM;-4.971;-39.015;True;76105;37860;38233;52991;25592;27393;23114;12268;10840
2311355;Quixelô;CE;23;Nordeste;CENTRO-SUL CEARENSE;IGUATU;-6.254;-39.202;True;15708;7932;7770;4720;2266;2454;10988;5666;5316
2311405;Quixeramobim;CE;23;Nordeste;SERTOES CEARENSES;SERTAO DE QUIXERAMOBIM;-5.199;-39.293;True;68966;34491;34378;39576;18882;20674;29390;15609;13704
2311504;Quixeré;CE;23;Nordeste;JAGUARIBE;BAIXO JAGUARIBE;-5.074;-37.989;True;18652;9231;9421;11111;5393;5718;7541;3838;3703
2311603;Redenção;CE;23;Nordeste;NORTE CEARENSE;BATURITE;-4.226;-38.731;True;25702;12791;12849;14790;7207;7565;10912;5584;5284
2311702;Reriutaba;CE;23;Nordeste;NOROESTE CEARENSE;IPU;-4.142;-40.582;True;19310;9546;9718;9840;4758;5052;9470;4788;4666
2311801;Russas;CE;23;Nordeste;JAGUARIBE;BAIXO JAGUARIBE;-4.94;-37.976;True;63975;31601;32152;40839;19677;20994;23136;11924;11158
2311900;Saboeiro;CE;23;Nordeste;SERTOES CEARENSES;SERTAO DE INHAMUNS;-6.542;-39.907;True;16282;8059;8223;8366;3983;4383;7916;4076;3840
2311959;Salitre;CE;23;Nordeste;SUL CEARENSE;CHAPADA DO ARARIPE;-7.285;-40.457;True;15798;7702;7531;5818;2812;2970;9980;4890;4561
2312007;Santana do Acaraú;CE;23;Nordeste;NOROESTE CEARENSE;SOBRAL;-3.461;-40.212;True;28741;14491;14112;14481;7019;7453;14260;7472;6659
2312106;Santana do Cariri;CE;23;Nordeste;SUL CEARENSE;CARIRI;-7.188;-39.737;True;17574;8723;8606;8955;4349;4517;8619;4374;4089
2312205;Santa Quitéria;CE;23;Nordeste;NOROESTE CEARENSE;SANTA QUITERIA;-4.332;-40.157;True;43344;21810;21477;20736;10002;10734;22608;11808;10743
2312304;São Benedito;CE;23;Nordeste;NOROESTE CEARENSE;IBIAPABA;-4.049;-40.865;True;43077;21395;21659;23322;11309;11990;19755;10086;9669
2312403;São Gonçalo do Amarante;CE;23;Nordeste;NORTE CEARENSE;BAIXO CURU;-3.606;-38.969;True;40312;20494;19663;25141;12575;12453;15171;7919;7210
2312502;São João do Jaguaribe;CE;23;Nordeste;JAGUARIBE;BAIXO JAGUARIBE;-5.271;-38.274;True;8310;4076;4234;3075;1444;1631;5235;2632;2603
2312601;São Luís do Curu;CE;23;Nordeste;NORTE CEARENSE;MEDIO CURU;-3.67;-39.243;True;12052;6019;5954;7827;3776;4018;4225;2243;1936
2312700;Senador Pompeu;CE;23;Nordeste;SERTOES CEARENSES;SERTAO DE SENADOR POMPEU;-5.588;-39.372;True;25290;12305;12809;14866;6944;7772;10424;5361;5037
2312809;Senador Sá;CE;23;Nordeste;NOROESTE CEARENSE;SOBRAL;-3.351;-40.463;True;6274;3158;3116;4587;2242;2345;1687;916;771
2312908;Sobral;CE;23;Nordeste;NOROESTE CEARENSE;SOBRAL;-3.674;-40.239;True;176895;;;;;;;;4387
2313005;Solonópole;CE;23;Nordeste;SERTOES CEARENSES;SERTAO DE SENADOR POMPEU;-5.733;-39.008;True;17340;8726;8576;8129;3907;4189;9211;4819;5245
2313104;Tabuleiro do Norte;CE;23;Nordeste;JAGUARIBE;BAIXO JAGUARIBE;-5.247;-38.131;True;28291;13814;14390;17365;8160;9145;10926;5654;5899
2313203;Tamboril;CE;23;Nordeste;SERTOES CEARENSES;SERTAO DE CRATEUS;-4.832;-40.321;True;25459;12771;12667;13233;6454;6768;12226;6317;3260
2313252;Tarrafas;CE;23;Nordeste;CENTRO-SUL CEARENSE;VARZEA ALEGRE;-6.684;-39.761;True;8734;4312;4421;2203;1042;1161;6531;3270;11898
2313302;Tauá;CE;23;Nordeste;SERTOES CEARENSES;SERTAO DE INHAMUNS;-6.003;-40.293;True;54273;26665;27376;29440;13877;15478;24833;12788;4699
2313351;Tejuçuoca;CE;23;Nordeste;NORTE CEARENSE;MEDIO CURU;-3.989;-39.581;True;15062;7812;7248;5140;2591;2549;9922;5221;10556
2313401;Tianguá;CE;23;Nordeste;NOROESTE CEARENSE;IBIAPABA;-3.732;-40.992;True;64612;32111;32484;42648;20717;21928;21964;11394;15910
2313500;Trairi;CE;23;Nordeste;NORTE CEARENSE;ITAPIPOCA;-3.278;-39.269;True;48620;24996;23624;15178;7464;7714;33442;17532;3710
2313559;Tururu;CE;23;Nordeste;NORTE CEARENSE;URUBURETAMA;-3.581;-39.437;True;13350;6868;6470;5439;2679;2760;7911;4189;7457
2313609;Ubajara;CE;23;Nordeste;NOROESTE CEARENSE;IBIAPABA;-3.854;-40.921;True;29569;14812;14753;14195;6899;7296;15374;7913;1776
2313708;Umari;CE;23;Nordeste;CENTRO-SUL CEARENSE;LAVRAS DA MANGABEIRA;-6.648;-38.7;True;7591;3832;3734;3869;1908;1958;3722;1924;3530
2313757;Umirim;CE;23;Nordeste;NORTE CEARENSE;URUBURETAMA;-3.677;-39.35;True;18195;9329;8864;10697;5363;5334;7498;3966;2923
2313807;Uruburetama;CE;23;Nordeste;NORTE CEARENSE;URUBURETAMA;-3.625;-39.508;True;19218;9656;9562;13021;6382;6639;6197;3274;2698
2313906;Uruoca;CE;23;Nordeste;NOROESTE CEARENSE;COREAU;-3.314;-40.557;True;12973;6600;6356;7243;3571;3658;5730;3029;1578
2313955;Varjota;CE;23;Nordeste;NOROESTE CEARENSE;IPU;-4.194;-40.477;True;17087;8495;8592;13854;6840;7014;3233;1655;7655
2314003;Várzea Alegre;CE;23;Nordeste;CENTRO-SUL CEARENSE;VARZEA ALEGRE;-6.789;-39.296;True;37740;18441;19226;21997;10396;11571;15743;8045;17742
2314102;Viçosa do Ceará;CE;23;Nordeste;NOROESTE CEARENSE;IBIAPABA;-3.562;-41.092;True;52855;26691;26151;16504;8082;8409;36351;18609;
2400109;Acari;RN;24;Nordeste;CENTRAL POTIGUAR;SERIDO ORIENTAL;-6.436;-36.639;True;10911;5317;5532;8557;4049;4449;2354;1268;1083
2400208;Açu;RN;24;Nordeste;OESTE POTIGUAR;VALE DO ACU;-5.577;-36.909;True;51262;25232;25893;38273;18606;19642;12989;6626;6251
2400307;Afonso Bezerra;RN;24;Nordeste;CENTRAL POTIGUAR;ANGICOS;-5.498;-36.506;True;10339;5154;5063;5778;2759;3001;4561;2395;2062
2400406;Água Nova;RN;24;Nordeste;OESTE POTIGUAR;SERRA DE SAO MIGUEL;-6.209;-38.297;True;2843;1424;1419;1816;897;919;1027;527;500
2400505;Alexandria;RN;24;Nordeste;OESTE POTIGUAR;PAU DOS FERROS;-6.413;-38.016;True;13729;6759;6905;8917;4240;4671;4812;2519;2234
2400604;Almino Afonso;RN;24;Nordeste;OESTE POTIGUAR;UMARIZAL;-6.152;-37.766;True;4948;2512;2436;3370;1673;1697;1578;839;739
2400703;Alto do Rodrigues;RN;24;Nordeste;OESTE POTIGUAR;VALE DO ACU;-5.288;-36.762;True;11443;5683;5569;7471;3648;3697;3972;2035;1872
2400802;Angicos;RN;24;Nordeste;CENTRAL POTIGUAR;ANGICOS;-5.666;-36.601;True;11227;5401;5629;9566;4576;4903;1661;825;726
2400901;Antônio Martins;RN;24;Nordeste;OESTE POTIGUAR;UMARIZAL;-6.213;-37.906;True;6997;3564;3427;3653;1826;1827;3344;1738;1600
2401008;Apodi;RN;24;Nordeste;OESTE POTIGUAR;CHAPADA DO APODI;-5.664;-37.799;True;34632;17289;17144;16827;8070;8709;17805;9219;8435
2401107;Areia Branca;RN;24;Nordeste;OESTE POTIGUAR;MOSSORO;-4.956;-37.137;True;24398;11945;12452;19531;9439;10092;4867;2506;2360
2401206;Arês;RN;24;Nordeste;LESTE POTIGUAR;LITORAL SUL;-6.194;-35.16;True;12236;6088;6097;7373;3651;3722;4863;2437;2375
2401305;Augusto Severo;RN;24;Nordeste;OESTE POTIGUAR;MEDIO OESTE;-5.864;-37.31;True;8936;4530;4406;4682;2249;2433;4254;2281;1973
2401404;Baía Formosa;RN;24;Nordeste;LESTE POTIGUAR;LITORAL SUL;-6.369;-35.008;True;8466;4298;4168;6959;3531;3428;1507;767;740
2401453;Baraúna;RN;24;Nordeste;OESTE POTIGUAR;MOSSORO;-5.08;-37.617;True;23098;11287;10778;14351;6686;6768;8747;4601;4010
2401503;Barcelona;RN;24;Nordeste;AGRESTE POTIGUAR;BORBOREMA POTIGUAR;-5.951;-35.926;True;3928;1995;1931;1579;755;822;2349;1240;1109
2401602;Bento Fernandes;RN;24;Nordeste;AGRESTE POTIGUAR;BAIXA VERDE;-5.694;-35.82;True;5006;2571;2422;1945;979;966;3061;1592;1456
2401651;Bodó;RN;24;Nordeste;CENTRAL POTIGUAR;SERRA DE SANTANA;-5.988;-36.413;True;2542;1308;1234;1395;700;695;1147;608;539
2401701;Bom Jesus;RN;24;Nordeste;AGRESTE POTIGUAR;AGRESTE POTIGUAR;-5.984;-35.581;True;8478;4185;4269;6437;3119;3311;2041;1066;958
2401800;Brejinho;RN;24;Nordeste;AGRESTE POTIGUAR;AGRESTE POTIGUAR;-6.191;-35.357;True;11135;5551;5479;8383;4125;4174;2752;1426;1305
2401859;Caiçara do Norte;RN;24;Nordeste;CENTRAL POTIGUAR;MACAU;-5.078;-36.068;True;6384;3201;2979;6318;3163;2951;66;38;28
2401909;Caiçara do Rio do Vento;RN;24;Nordeste;CENTRAL POTIGUAR;ANGICOS;-5.76;-35.998;True;3064;1462;1497;2090;993;1074;974;469;423
2402006;Caicó;RN;24;Nordeste;CENTRAL POTIGUAR;SERIDO OCIDENTAL;-6.458;-37.098;True;60656;29389;31237;54986;26336;28623;5670;3053;2614
2402105;Campo Redondo;RN;24;Nordeste;AGRESTE POTIGUAR;BORBOREMA POTIGUAR;-6.243;-36.183;True;10462;5247;5215;5461;2655;2806;5001;2592;2409
2402204;Canguaretama;RN;24;Nordeste;LESTE POTIGUAR;LITORAL SUL;-6.38;-35.129;True;29334;14445;14552;19135;9361;9584;10199;5084;4968
2402303;Caraúbas;RN;24;Nordeste;OESTE POTIGUAR;CHAPADA DO APODI;-5.793;-37.557;True;19739;9866;9873;13034;6286;6748;6705;3580;3125
2402402;Carnaúba dos Dantas;RN;24;Nordeste;CENTRAL POTIGUAR;SERIDO ORIENTAL;-6.556;-36.595;True;6836;3422;3362;5352;2665;2673;1484;757;689
2402501;Carnaubais;RN;24;Nordeste;OESTE POTIGUAR;VALE DO ACU;-5.341;-36.833;True;9284;4531;4474;4543;2169;2250;4741;2362;2224
2402600;Ceará-Mirim;RN;24;Nordeste;LESTE POTIGUAR;MACAIBA;-5.634;-35.426;True;65450;32329;32635;32947;15708;16944;32503;16621;15691
2402709;Cerro Corá;RN;24;Nordeste;CENTRAL POTIGUAR;SERRA DE SANTANA;-6.046;-36.346;True;10890;5354;5226;5013;2283;2471;5877;3071;2755
2402808;Coronel Ezequiel;RN;24;Nordeste;AGRESTE POTIGUAR;BORBOREMA POTIGUAR;-6.383;-36.215;True;5255;2669;2586;2269;1098;1171;2986;1571;1415
2402907;Coronel João Pessoa;RN;24;Nordeste;OESTE POTIGUAR;SERRA DE SAO MIGUEL;-6.26;-38.444;True;4827;2391;2414;1825;864;939;3002;1527;1475
2403004;Cruzeta;RN;24;Nordeste;CENTRAL POTIGUAR;SERIDO ORIENTAL;-6.412;-36.79;True;7825;3858;3967;5930;2856;3074;1895;1002;893
2403103;Currais Novos;RN;24;Nordeste;CENTRAL POTIGUAR;SERIDO ORIENTAL;-6.261;-36.515;True;42066;20026;21697;37365;17569;19489;4701;2457;2208
2403202;Doutor Severiano;RN;24;Nordeste;OESTE POTIGUAR;SERRA DE SAO MIGUEL;-6.094;-38.375;True;6431;3167;3264;2640;1286;1354;3791;1881;1910
2403251;Parnamirim;RN;24;Nordeste;LESTE POTIGUAR;NATAL;-5.916;-35.263;True;172751;79822;86388;172751;79822;86388;;;
2403301;Encanto;RN;24;Nordeste;OESTE POTIGUAR;SERRA DE SAO MIGUEL;-6.111;-38.306;True;5158;2545;2613;2227;1057;1170;2931;1488;1443
2403400;Equador;RN;24;Nordeste;CENTRAL POTIGUAR;SERIDO ORIENTAL;-6.945;-36.718;True;5875;2996;2879;4728;2357;2371;1147;639;508
2403509;Espírito Santo;RN;24;Nordeste;LESTE POTIGUAR;LITORAL SUL;-6.332;-35.309;True;10132;5048;4848;5101;2502;2463;5031;2546;2385
2403608;Extremoz;RN;24;Nordeste;LESTE POTIGUAR;NATAL;-5.706;-35.307;True;21792;10608;10697;12787;6074;6403;9005;4534;4294
2403707;Felipe Guerra;RN;24;Nordeste;OESTE POTIGUAR;CHAPADA DO APODI;-5.603;-37.689;True;5680;2842;2838;3742;1822;1920;1938;1020;918
2403756;Fernando Pedroza;RN;24;Nordeste;CENTRAL POTIGUAR;ANGICOS;-5.697;-36.531;True;2876;1467;1409;2457;1229;1228;419;238;181
2403806;Florânia;RN;24;Nordeste;CENTRAL POTIGUAR;SERRA DE SANTANA;-6.127;-36.818;True;8313;4069;4098;6309;3033;3276;2004;1036;822
2403905;Francisco Dantas;RN;24;Nordeste;OESTE POTIGUAR;PAU DOS FERROS;-6.078;-38.119;True;2928;1494;1434;1648;808;840;1280;686;594
2404002;Frutuoso Gomes;RN;24;Nordeste;OESTE POTIGUAR;UMARIZAL;-6.158;-37.84;True;4360;2153;2207;2777;1323;1454;1583;830;753
2404101;Galinhos;RN;24;Nordeste;CENTRAL POTIGUAR;MACAU;-5.091;-36.275;True;2149;1097;1042;1258;638;620;891;459;422
2404200;Goianinha;RN;24;Nordeste;LESTE POTIGUAR;LITORAL SUL;-6.267;-35.21;True;20347;10084;10012;14371;7145;7202;5976;2939;2810
2404309;Governador Dix-Sept Rosado;RN;24;Nordeste;OESTE POTIGUAR;CHAPADA DO APODI;-5.459;-37.521;True;12374;6344;6005;6506;3229;3277;5868;3115;2728
2404408;Grossos;RN;24;Nordeste;OESTE POTIGUAR;MOSSORO;-4.98;-37.155;True;9441;4623;4546;7103;3440;3424;2338;1183;1122
2404507;Guamaré;RN;24;Nordeste;CENTRAL POTIGUAR;MACAU;-5.108;-36.32;True;11737;5787;5727;4232;2061;2171;7505;3726;3556
2404606;Ielmo Marinho;RN;24;Nordeste;AGRESTE POTIGUAR;AGRESTE POTIGUAR;-5.824;-35.553;True;11649;6063;5586;1425;712;713;10224;5351;4873
2404705;Ipanguaçu;RN;24;Nordeste;OESTE POTIGUAR;VALE DO ACU;-5.498;-36.855;True;13444;6827;6580;5100;2524;2563;8344;4303;4017
2404804;Ipueira;RN;24;Nordeste;CENTRAL POTIGUAR;SERIDO OCIDENTAL;-6.814;-37.199;True;2035;1022;1003;1782;877;905;253;145;98
2404853;Itajá;RN;24;Nordeste;OESTE POTIGUAR;VALE DO ACU;-5.644;-36.871;True;6410;3251;3110;5386;2707;2649;1024;544;461
2404903;Itaú;RN;24;Nordeste;OESTE POTIGUAR;PAU DOS FERROS;-5.84;-37.993;True;5758;2832;2926;4810;2348;2462;948;484;464
2405009;Jaçanã;RN;24;Nordeste;AGRESTE POTIGUAR;BORBOREMA POTIGUAR;-6.426;-36.205;True;7788;3841;3947;5495;2644;2851;2293;1197;1096
2405108;Jandaíra;RN;24;Nordeste;AGRESTE POTIGUAR;BAIXA VERDE;-5.356;-36.128;True;6447;3337;3110;3684;1841;1843;2763;1496;1267
2405207;Janduís;RN;24;Nordeste;OESTE POTIGUAR;MEDIO OESTE;-6.016;-37.409;True;5416;2724;2684;3784;1839;1945;1632;885;739
2405306;Januário Cicco;RN;24;Nordeste;AGRESTE POTIGUAR;AGRESTE POTIGUAR;-6.158;-35.601;True;8294;4248;4046;3062;1505;1557;5232;2743;2489
2405405;Japi;RN;24;Nordeste;AGRESTE POTIGUAR;BORBOREMA POTIGUAR;-6.465;-35.947;True;5610;2820;2790;4025;2021;2004;1585;799;786
2405504;Jardim de Angicos;RN;24;Nordeste;CENTRAL POTIGUAR;ANGICOS;-5.654;-35.969;True;2536;1312;1224;482;237;245;2054;1075;979
2405603;Jardim de Piranhas;RN;24;Nordeste;CENTRAL POTIGUAR;SERIDO OCIDENTAL;-6.379;-37.352;True;13704;6867;6837;10588;5188;5400;3116;1679;1437
2405702;Jardim do Seridó;RN;24;Nordeste;CENTRAL POTIGUAR;SERIDO ORIENTAL;-6.584;-36.774;True;12013;5834;6165;9577;4562;5015;2436;1272;1150
2405801;João Câmara;RN;24;Nordeste;AGRESTE POTIGUAR;BAIXA VERDE;-5.538;-35.82;True;30423;15007;15277;20930;10017;10831;9493;4990;4446
2405900;João Dias;RN;24;Nordeste;OESTE POTIGUAR;UMARIZAL;-6.274;-37.796;True;2723;1342;1381;1299;623;676;1424;719;705
2406007;José da Penha;RN;24;Nordeste;OESTE POTIGUAR;PAU DOS FERROS;-6.317;-38.281;True;5982;2920;3062;3383;1599;1784;2599;1321;1278
2406106;Jucurutu;RN;24;Nordeste;OESTE POTIGUAR;VALE DO ACU;-6.034;-37.02;True;17501;8875;8626;10510;5111;5399;6991;3764;3227
2406155;Jundiá;RN;24;Nordeste;AGRESTE POTIGUAR;AGRESTE POTIGUAR;-6.271;-35.345;True;3517;1871;1642;850;442;404;2667;1429;1238
2406205;Lagoa D'Anta;RN;24;Nordeste;AGRESTE POTIGUAR;AGRESTE POTIGUAR;-6.391;-35.598;True;5940;2900;2934;3717;1768;1847;2223;1132;1087
2406304;Lagoa de Pedras;RN;24;Nordeste;AGRESTE POTIGUAR;AGRESTE POTIGUAR;-6.149;-35.438;True;6989;3474;3331;2308;1132;1161;4681;2342;2170
2406403;Lagoa de Velhos;RN;24;Nordeste;AGRESTE POTIGUAR;BORBOREMA POTIGUAR;-6.004;-35.872;True;2699;1399;1300;1709;881;828;990;518;472
2406502;Lagoa Nova;RN;24;Nordeste;CENTRAL POTIGUAR;SERRA DE SANTANA;-6.096;-36.469;True;13167;6551;6563;6139;2986;3148;7028;3565;3415
2406601;Lagoa Salgada;RN;24;Nordeste;AGRESTE POTIGUAR;AGRESTE POTIGUAR;-6.134;-35.494;True;7179;3614;3529;4819;2363;2423;2360;1251;1106
2406700;Lajes;RN;24;Nordeste;CENTRAL POTIGUAR;ANGICOS;-5.7;-36.245;True;10412;5170;5223;8338;4026;4307;2074;1144;916
2406809;Lajes Pintadas;RN;24;Nordeste;AGRESTE POTIGUAR;BORBOREMA POTIGUAR;-6.15;-36.117;True;4217;2162;2055;2258;1102;1156;1959;1060;899
2406908;Lucrécia;RN;24;Nordeste;OESTE POTIGUAR;UMARIZAL;-6.12;-37.816;True;3418;1697;1719;2161;1061;1100;1257;636;619
2407005;Luís Gomes;RN;24;Nordeste;OESTE POTIGUAR;SERRA DE SAO MIGUEL;-6.414;-38.389;True;9763;4810;4947;6548;3139;3406;3215;1671;1541
2407104;Macaíba;RN;24;Nordeste;LESTE POTIGUAR;MACAIBA;-5.858;-35.354;True;63337;30830;31366;40111;19416;20499;23226;11414;10867
2407203;Macau;RN;24;Nordeste;CENTRAL POTIGUAR;MACAU;-5.115;-36.634;True;27132;13178;13736;20989;10038;10828;6143;3140;2908
2407252;Major Sales;RN;24;Nordeste;OESTE POTIGUAR;SERRA DE SAO MIGUEL;-6.406;-38.324;True;3459;1722;1737;2827;1395;1432;632;327;305
2407302;Marcelino Vieira;RN;24;Nordeste;OESTE POTIGUAR;PAU DOS FERROS;-6.294;-38.167;True;8112;3970;4117;4540;2138;2402;3572;1832;1715
2407401;Martins;RN;24;Nordeste;OESTE POTIGUAR;UMARIZAL;-6.088;-37.911;True;8089;3958;4131;4345;2087;2258;3744;1871;1873
2407500;Maxaranguape;RN;24;Nordeste;LESTE POTIGUAR;LITORAL NORDESTE;-5.516;-35.262;True;8969;4573;4389;3515;1749;1766;5454;2824;2623
2407609;Messias Targino;RN;24;Nordeste;OESTE POTIGUAR;MEDIO OESTE;-6.079;-37.514;True;3795;1925;1870;3194;1603;1591;601;322;279
2407708;Montanhas;RN;24;Nordeste;LESTE POTIGUAR;LITORAL SUL;-6.486;-35.288;True;12393;5939;6066;9476;4435;4678;2917;1504;1388
2407807;Monte Alegre;RN;24;Nordeste;AGRESTE POTIGUAR;AGRESTE POTIGUAR;-6.068;-35.332;True;20590;10244;10157;8330;4017;4310;12260;6227;5847
2407906;Monte das Gameleiras;RN;24;Nordeste;AGRESTE POTIGUAR;BORBOREMA POTIGUAR;-6.441;-35.783;True;2394;1233;1161;1399;700;699;995;533;462
2408003;Mossoró;RN;24;Nordeste;OESTE POTIGUAR;MOSSORO;-5.188;-37.344;True;234390;112269;120232;214238;101642;111097;20152;10627;9135
2408102;Natal;RN;24;Nordeste;LESTE POTIGUAR;NATAL;-5.795;-35.209;True;774230;357050;402737;774230;357050;402737;;;
2408201;Nísia Floresta;RN;24;Nordeste;LESTE POTIGUAR;MACAIBA;-6.091;-35.209;True;22906;11733;11083;9165;4570;4560;13741;7163;6523
2408300;Nova Cruz;RN;24;Nordeste;AGRESTE POTIGUAR;AGRESTE POTIGUAR;-6.478;-35.434;True;35280;17264;17782;23955;11558;12222;11325;5706;5560
2408409;Olho-D'Água do Borges;RN;24;Nordeste;OESTE POTIGUAR;UMARIZAL;-5.956;-37.706;True;4442;2289;2126;3262;1649;1613;1180;640;513
2408508;Ouro Branco;RN;24;Nordeste;CENTRAL POTIGUAR;SERIDO ORIENTAL;-6.701;-36.946;True;4973;2439;2383;3317;1565;1604;1656;874;779
2408607;Paraná;RN;24;Nordeste;OESTE POTIGUAR;PAU DOS FERROS;-6.486;-38.313;True;3886;2024;1859;647;328;319;3239;1696;1540
2408706;Paraú;RN;24;Nordeste;OESTE POTIGUAR;MEDIO OESTE;-5.774;-37.101;True;3880;1915;1965;3067;1476;1591;813;439;374
2408805;Parazinho;RN;24;Nordeste;AGRESTE POTIGUAR;BAIXA VERDE;-5.223;-35.838;True;4772;2377;2322;3035;1502;1533;1737;875;789
2408904;Parelhas;RN;24;Nordeste;CENTRAL POTIGUAR;SERIDO ORIENTAL;-6.688;-36.658;True;19972;9754;10123;16577;7985;8511;3395;1769;1612
2408953;Rio do Fogo;RN;24;Nordeste;LESTE POTIGUAR;LITORAL NORDESTE;-5.273;-35.383;True;9753;4933;4702;3784;1882;1784;5969;3051;2918
2409100;Passa e Fica;RN;24;Nordeste;AGRESTE POTIGUAR;AGRESTE POTIGUAR;-6.436;-35.643;True;10372;5200;5032;6000;2939;3029;4372;2261;2003
2409209;Passagem;RN;24;Nordeste;AGRESTE POTIGUAR;AGRESTE POTIGUAR;-6.279;-35.378;True;2629;1280;1288;1246;605;630;1383;675;658
2409308;Patu;RN;24;Nordeste;OESTE POTIGUAR;UMARIZAL;-6.11;-37.637;True;11303;5605;5696;9088;4389;4697;2215;1216;999
2409332;Santa Maria;RN;24;Nordeste;AGRESTE POTIGUAR;AGRESTE POTIGUAR;-5.84;-35.695;True;4659;2361;2270;3053;1515;1515;1606;846;755
2409407;Pau dos Ferros;RN;24;Nordeste;OESTE POTIGUAR;PAU DOS FERROS;-6.111;-38.209;True;26728;12905;13728;24168;11550;12526;2560;1355;1202
2409506;Pedra Grande;RN;24;Nordeste;LESTE POTIGUAR;LITORAL NORDESTE;-5.15;-35.879;True;3918;2001;1917;1230;598;632;2688;1403;1285
2409605;Pedra Preta;RN;24;Nordeste;CENTRAL POTIGUAR;ANGICOS;-5.583;-36.105;True;2659;1337;1252;936;456;480;1723;881;772
2409704;Pedro Avelino;RN;24;Nordeste;CENTRAL POTIGUAR;ANGICOS;-5.522;-36.388;True;7405;3637;3478;4297;2079;2196;3108;1558;1282
2409803;Pedro Velho;RN;24;Nordeste;LESTE POTIGUAR;LITORAL SUL;-6.439;-35.221;True;13673;6905;6720;6128;3043;3085;7545;3862;3635
2409902;Pendências;RN;24;Nordeste;OESTE POTIGUAR;VALE DO ACU;-5.26;-36.722;True;12505;6111;6087;9848;4800;4782;2657;1311;1305
2410009;PilõEs;RN;24;Nordeste;OESTE POTIGUAR;PAU DOS FERROS;-6.269;-38.043;True;3381;1706;1675;2451;1212;1239;930;494;436
2410108;Poço Branco;RN;24;Nordeste;AGRESTE POTIGUAR;BAIXA VERDE;-5.623;-35.663;True;12288;6263;6022;6953;3476;3477;5335;2787;2545
2410207;Portalegre;RN;24;Nordeste;OESTE POTIGUAR;PAU DOS FERROS;-6.024;-37.988;True;6855;3352;3503;3387;1587;1800;3468;1765;1703
2410256;Porto do Mangue;RN;24;Nordeste;OESTE POTIGUAR;VALE DO ACU;-5.068;-36.782;True;4792;2519;2266;2818;1455;1363;1974;1064;903
2410306;Presidente Juscelino;RN;24;Nordeste;AGRESTE POTIGUAR;AGRESTE POTIGUAR;-6.106;-35.713;True;8283;4262;3994;5003;2505;2477;3280;1757;1517
2410405;Pureza;RN;24;Nordeste;LESTE POTIGUAR;LITORAL NORDESTE;-5.467;-35.556;True;8030;4043;3877;2869;1365;1504;5161;2678;2373
2410504;Rafael Fernandes;RN;24;Nordeste;OESTE POTIGUAR;PAU DOS FERROS;-6.195;-38.226;True;4608;2308;2300;2617;1291;1326;1991;1017;974
2410603;Rafael Godeiro;RN;24;Nordeste;OESTE POTIGUAR;UMARIZAL;-6.076;-37.717;True;3131;1581;1550;1916;963;953;1215;618;597
2410702;Riacho da Cruz;RN;24;Nordeste;OESTE POTIGUAR;PAU DOS FERROS;-5.936;-37.946;True;3025;1533;1492;2594;1302;1292;431;231;200
2410801;Riacho de Santana;RN;24;Nordeste;OESTE POTIGUAR;SERRA DE SAO MIGUEL;-6.263;-38.316;True;4292;2148;2144;1761;852;909;2531;1296;1235
2410900;Riachuelo;RN;24;Nordeste;AGRESTE POTIGUAR;AGRESTE POTIGUAR;-5.815;-35.825;True;6824;3438;3340;4206;2060;2100;2618;1378;1240
2411007;Rodolfo Fernandes;RN;24;Nordeste;OESTE POTIGUAR;PAU DOS FERROS;-5.788;-38.06;True;4569;2258;2311;3842;1874;1968;727;384;343
2411056;Tibau;RN;24;Nordeste;OESTE POTIGUAR;MOSSORO;-4.837;-37.253;True;3750;1828;1761;3368;1623;1584;382;205;177
2411106;Ruy Barbosa;RN;24;Nordeste;AGRESTE POTIGUAR;BORBOREMA POTIGUAR;-5.881;-35.935;True;3625;1862;1763;1370;668;702;2255;1194;1061
2411205;Santa Cruz;RN;24;Nordeste;AGRESTE POTIGUAR;BORBOREMA POTIGUAR;-6.229;-36.023;True;33736;16497;17222;28055;13537;14504;5681;2960;2718
2411403;Santana do Matos;RN;24;Nordeste;CENTRAL POTIGUAR;SERRA DE SANTANA;-5.958;-36.656;True;14312;7206;7104;6588;3164;3422;7724;4042;3682
2411429;Santana do Seridó;RN;24;Nordeste;CENTRAL POTIGUAR;SERIDO ORIENTAL;-6.771;-36.733;True;2729;1297;1290;1613;794;819;1116;503;471
2411502;Santo Antônio;RN;24;Nordeste;AGRESTE POTIGUAR;AGRESTE POTIGUAR;-6.311;-35.479;True;21263;10694;10474;13349;6555;6735;7914;4139;3739
2411601;São Bento do Norte;RN;24;Nordeste;CENTRAL POTIGUAR;MACAU;-5.093;-35.959;True;3529;1764;1711;1099;542;557;2430;1222;1154
2411700;São Bento do Trairí;RN;24;Nordeste;AGRESTE POTIGUAR;BORBOREMA POTIGUAR;-6.342;-36.087;True;3702;1798;1784;1888;861;940;1814;937;844
2411809;São Fernando;RN;24;Nordeste;CENTRAL POTIGUAR;SERIDO OCIDENTAL;-6.376;-37.184;True;3381;1719;1659;2152;1050;1099;1229;669;560
2411908;São Francisco do Oeste;RN;24;Nordeste;OESTE POTIGUAR;PAU DOS FERROS;-5.975;-38.152;True;3669;1858;1811;2691;1355;1336;978;503;475
2412005;São Gonçalo do Amarante;RN;24;Nordeste;LESTE POTIGUAR;MACAIBA;-5.793;-35.329;True;77363;37045;38620;65209;31113;32780;12154;5932;5840
2412104;São João do Sabugi;RN;24;Nordeste;CENTRAL POTIGUAR;SERIDO OCIDENTAL;-6.718;-37.201;True;5765;2811;2954;4577;2173;2404;1188;638;550
2412203;São José de Mipibu;RN;24;Nordeste;LESTE POTIGUAR;MACAIBA;-6.075;-35.238;True;36990;18363;18369;17984;8687;9222;19006;9676;9147
2412302;São José do Campestre;RN;24;Nordeste;AGRESTE POTIGUAR;BORBOREMA POTIGUAR;-6.316;-35.714;True;11744;5859;5881;9637;4728;4905;2107;1131;976
2412401;São José do Seridó;RN;24;Nordeste;CENTRAL POTIGUAR;SERIDO ORIENTAL;-6.449;-36.878;True;3925;1973;1948;2934;1448;1486;991;525;462
2412500;São Miguel;RN;24;Nordeste;OESTE POTIGUAR;SERRA DE SAO MIGUEL;-6.212;-38.497;True;22579;10818;11761;13186;6212;6974;9393;4606;4787
2412559;São Miguel de Touros;RN;24;Nordeste;LESTE POTIGUAR;LITORAL NORDESTE;-5.125;-35.639;True;8810;4628;4171;3679;1899;1780;5131;2729;2391
2412609;São Paulo do Potengi;RN;24;Nordeste;AGRESTE POTIGUAR;AGRESTE POTIGUAR;-5.895;-35.763;True;14483;7090;7267;11103;5349;5700;3380;1741;1567
2412708;São Pedro;RN;24;Nordeste;AGRESTE POTIGUAR;AGRESTE POTIGUAR;-5.898;-35.634;True;6433;3215;3124;3468;1622;1766;2965;1593;1358
2412807;São Rafael;RN;24;Nordeste;OESTE POTIGUAR;VALE DO ACU;-5.799;-36.921;True;8116;4138;3978;5369;2651;2718;2747;1487;1260
2412906;São Tomé;RN;24;Nordeste;AGRESTE POTIGUAR;BORBOREMA POTIGUAR;-5.973;-36.075;True;11115;5623;5492;6091;2940;3151;5024;2683;2341
2413003;São Vicente;RN;24;Nordeste;CENTRAL POTIGUAR;SERRA DE SANTANA;-6.216;-36.684;True;5819;2872;2947;3451;1643;1808;2368;1229;1139
2413102;Senador Elói de Souza;RN;24;Nordeste;AGRESTE POTIGUAR;AGRESTE POTIGUAR;-6.036;-35.693;True;5906;2682;2570;2535;1058;1116;3371;1624;1454
2413201;Senador Georgino Avelino;RN;24;Nordeste;LESTE POTIGUAR;LITORAL SUL;-6.163;-35.123;True;3690;1827;1863;3650;1806;1844;40;21;19
2413300;Serra de São Bento;RN;24;Nordeste;AGRESTE POTIGUAR;BORBOREMA POTIGUAR;-6.417;-35.704;True;5801;2939;2854;3104;1541;1563;2697;1398;1291
2413359;Serra do Mel;RN;24;Nordeste;OESTE POTIGUAR;MOSSORO;-5.17;-37.029;True;9216;4791;4404;1780;900;880;7436;3891;3524
2413409;Serra Negra do Norte;RN;24;Nordeste;CENTRAL POTIGUAR;SERIDO OCIDENTAL;-6.666;-37.397;True;7241;3671;3570;2606;1235;1371;4635;2436;2199
2413508;Serrinha;RN;24;Nordeste;AGRESTE POTIGUAR;AGRESTE POTIGUAR;-6.276;-35.499;True;6740;3513;3222;2030;1021;1006;4710;2492;2216
2413557;Serrinha dos Pintos;RN;24;Nordeste;OESTE POTIGUAR;UMARIZAL;-6.11;-37.956;True;4360;2217;2143;1966;976;990;2394;1241;1153
2413607;Severiano Melo;RN;24;Nordeste;OESTE POTIGUAR;PAU DOS FERROS;-5.777;-37.958;True;5671;2765;2789;2077;979;1095;3594;1786;1694
2413706;Sítio Novo;RN;24;Nordeste;AGRESTE POTIGUAR;BORBOREMA POTIGUAR;-6.104;-35.911;True;5212;2431;2306;2322;1066;1102;2890;1365;1204
2413805;Taboleiro Grande;RN;24;Nordeste;OESTE POTIGUAR;PAU DOS FERROS;-5.93;-38.045;True;2278;1139;1139;1954;963;991;324;176;148
2413904;Taipu;RN;24;Nordeste;LESTE POTIGUAR;LITORAL NORDESTE;-5.622;-35.597;True;11768;6009;5649;4153;2060;2065;7615;3949;3584
2414001;Tangará;RN;24;Nordeste;AGRESTE POTIGUAR;BORBOREMA POTIGUAR;-6.199;-35.802;True;13081;6603;6439;8854;4363;4491;4227;2240;1948
2414100;Tenente Ananias;RN;24;Nordeste;OESTE POTIGUAR;PAU DOS FERROS;-6.465;-38.18;True;9311;4724;4569;6266;3138;3128;3045;1586;1441
2414159;Tenente Laurentino Cruz;RN;24;Nordeste;CENTRAL POTIGUAR;SERRA DE SANTANA;-6.148;-36.719;True;5120;2483;2397;1286;581;616;3834;1902;1781
2414209;Tibau do Sul;RN;24;Nordeste;LESTE POTIGUAR;LITORAL SUL;-6.187;-35.092;True;10959;5437;5189;7026;3434;3268;3933;2003;1921
2414308;Timbaúba dos Batistas;RN;24;Nordeste;CENTRAL POTIGUAR;SERIDO OCIDENTAL;-6.465;-37.274;True;2295;1145;1150;1902;933;969;393;212;181
2414407;Touros;RN;24;Nordeste;LESTE POTIGUAR;LITORAL NORDESTE;-5.199;-35.461;True;29436;15051;14369;7842;3853;3989;21594;11198;10380
2414456;Triunfo Potiguar;RN;24;Nordeste;OESTE POTIGUAR;MEDIO OESTE;-5.867;-37.189;True;3272;1675;1568;1816;917;899;1456;758;669
2414506;Umarizal;RN;24;Nordeste;OESTE POTIGUAR;UMARIZAL;-5.991;-37.814;True;10640;5188;5348;8553;4112;4405;2087;1076;943
2414605;Upanema;RN;24;Nordeste;OESTE POTIGUAR;MEDIO OESTE;-5.642;-37.258;True;12719;6588;5991;5903;2906;2954;6816;3682;3037
2414704;Várzea;RN;24;Nordeste;AGRESTE POTIGUAR;AGRESTE POTIGUAR;-6.348;-35.376;True;5276;2625;2581;4153;2013;2070;1123;612;511
2414753;Venha-Ver;RN;24;Nordeste;OESTE POTIGUAR;SERRA DE SAO MIGUEL;-6.326;-38.484;True;3494;1748;1746;958;474;484;2536;1274;1262
2414803;Vera Cruz;RN;24;Nordeste;AGRESTE POTIGUAR;AGRESTE POTIGUAR;-6.044;-35.428;True;10313;5180;5111;5020;2506;2514;5293;2674;2597
2414902;Viçosa;RN;24;Nordeste;OESTE POTIGUAR;PAU DOS FERROS;-5.994;-37.944;True;1769;871;880;1687;825;844;82;46;36
2415008;Vila Flor;RN;24;Nordeste;LESTE POTIGUAR;LITORAL SUL;-6.314;-35.077;True;2647;1312;1331;2562;1266;1294;85;46;37
2500106;Água Branca;PB;25;Nordeste;SERTAO PARAIBANO;SERRA DO TEIXEIRA;-7.512;-37.641;True;9224;4603;4621;3719;1773;1946;5505;2830;2675
2500205;Aguiar;PB;25;Nordeste;SERTAO PARAIBANO;PIANCO;-7.092;-38.171;True;5629;2743;2886;2492;1158;1334;3137;1585;1552
2500304;Alagoa Grande;PB;25;Nordeste;AGRESTE PARAIBANO;BREJO PARAIBANO;-7.089;-35.635;True;27448;13248;14063;16396;7736;8616;11052;5512;5447
2500403;Alagoa Nova;PB;25;Nordeste;AGRESTE PARAIBANO;BREJO PARAIBANO;-7.071;-35.758;True;19163;9489;9654;9219;4434;4785;9944;5055;4869
2500502;Alagoinha;PB;25;Nordeste;AGRESTE PARAIBANO;GUARABIRA;-6.95;-35.545;True;13025;6467;6530;8247;4030;4217;4778;2437;2313
2500536;Alcantil;PB;25;Nordeste;BORBOREMA;CARIRI ORIENTAL;-7.744;-36.056;True;5068;2524;2492;2010;985;1025;3058;1539;1467
2500577;Algodão de Jandaíra;PB;25;Nordeste;AGRESTE PARAIBANO;CURIMATAU OCIDENTAL;-6.816;-35.922;True;2342;1213;1129;1145;564;581;1197;649;548
2500601;Alhandra;PB;25;Nordeste;MATA PARAIBANA;LITORAL SUL;-7.439;-34.914;True;18183;8931;8913;10942;5336;5517;7241;3595;3396
2500700;São João do Rio do Peixe;PB;25;Nordeste;SERTAO PARAIBANO;CAJAZEIRAS;-6.729;-38.449;True;17773;8684;9035;6654;3111;3543;11119;5573;5492
2500734;Amparo;PB;25;Nordeste;BORBOREMA;CARIRI OCIDENTAL;-7.568;-37.064;True;2007;1008;999;960;445;515;1047;563;484
2500775;Aparecida;PB;25;Nordeste;SERTAO PARAIBANO;SOUSA;-6.784;-38.087;True;7323;3620;3667;3410;1624;1765;3913;1996;1902
2500809;Araçagi;PB;25;Nordeste;AGRESTE PARAIBANO;GUARABIRA;-6.853;-35.381;True;17376;8684;8650;6360;3078;3282;11016;5606;5368
2500908;Arara;PB;25;Nordeste;AGRESTE PARAIBANO;CURIMATAU OCIDENTAL;-6.828;-35.758;True;12356;5927;6380;8299;3862;4437;4057;2065;1943
2501005;Araruna;PB;25;Nordeste;AGRESTE PARAIBANO;CURIMATAU ORIENTAL;-6.558;-35.742;True;19191;9459;9533;8945;4212;4607;10246;5247;4926
2501104;Areia;PB;25;Nordeste;AGRESTE PARAIBANO;BREJO PARAIBANO;-6.963;-35.692;True;24992;12284;12643;14037;6732;7305;10955;5552;5338
2501153;Areia de Baraúnas;PB;25;Nordeste;SERTAO PARAIBANO;PATOS;-7.123;-36.941;True;2096;1048;1048;1000;496;504;1096;552;544
2501203;Areial;PB;25;Nordeste;AGRESTE PARAIBANO;ESPERANCA;-7.048;-35.931;True;6234;3006;3228;4192;1976;2216;2042;1030;1012
2501302;Aroeiras;PB;25;Nordeste;AGRESTE PARAIBANO;UMBUZEIRO;-7.545;-35.708;True;19174;9322;9811;8444;4005;4439;10730;5317;5372
2501351;Assunção;PB;25;Nordeste;BORBOREMA;CARIRI OCIDENTAL;-7.074;-36.731;True;3336;1658;1653;2415;1182;1233;921;476;420
2501401;Baía da Traição;PB;25;Nordeste;MATA PARAIBANA;LITORAL NORTE;-6.688;-34.936;True;7630;3902;3714;3076;1559;1517;4554;2343;2197
2501500;Bananeiras;PB;25;Nordeste;AGRESTE PARAIBANO;BREJO PARAIBANO;-6.75;-35.633;True;21670;10842;10780;8504;4062;4442;13166;6780;6338
2501534;Baraúna;PB;25;Nordeste;BORBOREMA;SERIDO ORIENTAL PARAIBANO;-6.643;-36.254;True;3864;1881;1914;2734;1326;1405;1130;555;509
2501575;Barra de Santana;PB;25;Nordeste;BORBOREMA;CARIRI ORIENTAL;-7.52;-36;True;8619;4311;4150;741;362;367;7878;3949;3783
2501609;Barra de Santa Rosa;PB;25;Nordeste;AGRESTE PARAIBANO;CURIMATAU OCIDENTAL;-6.72;-36.061;True;12848;6472;6351;7069;3415;3649;5779;3057;2702
2501708;Barra de São Miguel;PB;25;Nordeste;BORBOREMA;CARIRI ORIENTAL;-7.751;-36.318;True;5435;2736;2593;2270;1117;1150;3165;1619;1443
2501807;Bayeux;PB;25;Nordeste;MATA PARAIBANA;JOAO PESSOA;-7.125;-34.932;True;92891;44276;48002;92257;43962;47691;634;314;311
2501906;Belém;PB;25;Nordeste;AGRESTE PARAIBANO;GUARABIRA;-6.747;-35.519;True;17173;8464;8708;13920;6739;7180;3253;1725;1528
2502003;Belém do Brejo do Cruz;PB;25;Nordeste;SERTAO PARAIBANO;CATOLE DO ROCHA;-6.189;-37.536;True;7040;3542;3469;4925;2421;2504;2115;1121;965
2502052;Bernardino Batista;PB;25;Nordeste;SERTAO PARAIBANO;CAJAZEIRAS;-6.452;-38.551;True;3164;1597;1567;742;378;364;2422;1219;1203
2502102;Boa Ventura;PB;25;Nordeste;SERTAO PARAIBANO;ITAPORANGA;-7.414;-38.216;True;5800;2879;2921;3441;1664;1777;2359;1215;1144
2502151;Boa Vista;PB;25;Nordeste;AGRESTE PARAIBANO;CAMPINA GRANDE;-7.259;-36.24;True;5673;2798;2857;3223;1546;1670;2450;1252;1187
2502201;Bom Jesus;PB;25;Nordeste;SERTAO PARAIBANO;CAJAZEIRAS;-6.817;-38.65;True;2233;1159;1074;935;467;468;1298;692;606
2502300;Bom Sucesso;PB;25;Nordeste;SERTAO PARAIBANO;CATOLE DO ROCHA;-6.445;-37.929;True;5152;2531;2621;1889;900;989;3263;1631;1632
2502409;Bonito de Santa Fé;PB;25;Nordeste;SERTAO PARAIBANO;CAJAZEIRAS;-7.313;-38.515;True;10253;5039;5214;6612;3182;3430;3641;1857;1784
2502508;Boqueirão;PB;25;Nordeste;BORBOREMA;CARIRI ORIENTAL;-7.482;-36.135;True;15877;7838;8039;11345;5472;5873;4532;2366;2166
2502607;Igaracy;PB;25;Nordeste;SERTAO PARAIBANO;PIANCO;-7.181;-38.149;True;6334;3104;3230;3995;1892;2103;2339;1212;1127
2502706;Borborema;PB;25;Nordeste;AGRESTE PARAIBANO;BREJO PARAIBANO;-6.801;-35.626;True;5009;2461;2543;3439;1666;1768;1570;795;775
2502805;Brejo do Cruz;PB;25;Nordeste;SERTAO PARAIBANO;CATOLE DO ROCHA;-6.349;-37.498;True;12424;6192;6214;9197;4456;4727;3227;1736;1487
2502904;Brejo dos Santos;PB;25;Nordeste;SERTAO PARAIBANO;CATOLE DO ROCHA;-6.377;-37.825;True;5743;2860;2883;4582;2250;2332;1161;610;551
2503001;Caaporã;PB;25;Nordeste;MATA PARAIBANA;LITORAL SUL;-7.516;-34.908;True;19388;9663;9647;15471;7658;7735;3917;2005;1912
2503100;Cabaceiras;PB;25;Nordeste;BORBOREMA;CARIRI ORIENTAL;-7.489;-36.287;True;4907;2427;2475;2099;981;1113;2808;1446;1362
2503209;Cabedelo;PB;25;Nordeste;MATA PARAIBANA;JOAO PESSOA;-6.981;-34.834;False;49728;23222;25303;49718;23216;25299;10;6;4
2503308;Cachoeira dos Índios;PB;25;Nordeste;SERTAO PARAIBANO;CAJAZEIRAS;-6.927;-38.674;True;8388;4262;4126;3095;1518;1577;5293;2744;2549
2503407;Cacimba de Areia;PB;25;Nordeste;SERTAO PARAIBANO;PATOS;-7.129;-37.157;True;3485;1759;1726;1281;623;658;2204;1136;1068
2503506;Cacimba de Dentro;PB;25;Nordeste;AGRESTE PARAIBANO;CURIMATAU ORIENTAL;-6.642;-35.79;True;17108;8362;8700;8579;4108;4464;8529;4254;4236
2503555;Cacimbas;PB;25;Nordeste;SERTAO PARAIBANO;SERRA DO TEIXEIRA;-7.211;-37.058;True;6787;3312;3473;1659;801;858;5128;2511;2615
2503605;Caiçara;PB;25;Nordeste;AGRESTE PARAIBANO;GUARABIRA;-6.554;-35.411;True;7314;3666;3570;5082;2489;2515;2232;1177;1055
2503704;Cajazeiras;PB;25;Nordeste;SERTAO PARAIBANO;CAJAZEIRAS;-6.89;-38.562;True;56051;26718;29219;44527;20836;23600;11524;5882;5619
2503753;Cajazeirinhas;PB;25;Nordeste;SERTAO PARAIBANO;SOUSA;-6.961;-37.806;True;3057;1581;1471;912;469;443;2145;1112;1028
2503803;Caldas Brandão;PB;25;Nordeste;AGRESTE PARAIBANO;ITABAIANA;-7.103;-35.326;True;5363;2640;2723;2925;1414;1511;2438;1226;1212
2503902;Camalaú;PB;25;Nordeste;BORBOREMA;CARIRI OCIDENTAL;-7.889;-36.823;True;5761;2858;2891;2748;1295;1453;3013;1563;1438
2504009;Campina Grande;PB;25;Nordeste;AGRESTE PARAIBANO;CAMPINA GRANDE;-7.231;-35.881;True;371060;174038;193935;354048;165691;185579;17012;8347;8356
2504033;Capim;PB;25;Nordeste;MATA PARAIBANA;LITORAL NORTE;-6.916;-35.172;True;5207;2628;2579;4597;2317;2280;610;311;299
2504074;Caraúbas;PB;25;Nordeste;BORBOREMA;CARIRI ORIENTAL;-7.727;-36.492;True;3824;1937;1887;1375;669;706;2449;1268;1181
2504108;Carrapateira;PB;25;Nordeste;SERTAO PARAIBANO;CAJAZEIRAS;-7.039;-38.344;True;2389;1258;1117;1451;762;689;938;496;428
2504157;Casserengue;PB;25;Nordeste;AGRESTE PARAIBANO;CURIMATAU ORIENTAL;-6.783;-35.821;True;6762;3378;3305;3203;1579;1611;3559;1799;1694
2504207;Catingueira;PB;25;Nordeste;SERTAO PARAIBANO;PIANCO;-7.126;-37.609;True;4849;2454;2395;2775;1374;1401;2074;1080;994
2504306;Catolé do Rocha;PB;25;Nordeste;SERTAO PARAIBANO;CATOLE DO ROCHA;-6.344;-37.747;True;27548;13526;14018;19897;9473;10424;7651;4053;3594
2504355;Caturité;PB;25;Nordeste;BORBOREMA;CARIRI ORIENTAL;-7.42;-36.027;True;4467;2210;2199;988;488;500;3479;1722;1699
2504405;Conceição;PB;25;Nordeste;SERTAO PARAIBANO;ITAPORANGA;-7.562;-38.509;True;17496;8707;8789;10485;5021;5464;7011;3686;3325
2504504;Condado;PB;25;Nordeste;SERTAO PARAIBANO;SOUSA;-6.91;-37.601;True;6702;3274;3401;4361;2092;2266;2341;1182;1135
2504603;Conde;PB;25;Nordeste;MATA PARAIBANA;JOAO PESSOA;-7.26;-34.908;True;19925;9855;9582;12719;6154;6105;7206;3701;3477
2504702;Congo;PB;25;Nordeste;BORBOREMA;CARIRI OCIDENTAL;-7.797;-36.66;True;4770;2455;2309;2644;1290;1351;2126;1165;958
2504801;Coremas;PB;25;Nordeste;SERTAO PARAIBANO;PIANCO;-7.014;-37.946;True;15236;7528;7702;11177;5411;5766;4059;2117;1936
2504850;Coxixola;PB;25;Nordeste;BORBOREMA;CARIRI OCIDENTAL;-7.627;-36.606;True;1705;876;826;681;335;343;1024;541;483
2504900;Cruz do Espírito Santo;PB;25;Nordeste;MATA PARAIBANA;SAPE;-7.14;-35.086;True;15281;7634;7582;7008;3405;3576;8273;4229;4006
2505006;Cubati;PB;25;Nordeste;BORBOREMA;SERIDO ORIENTAL PARAIBANO;-6.868;-36.351;True;6356;3103;3248;4321;2036;2282;2035;1067;966
2505105;Cuité;PB;25;Nordeste;AGRESTE PARAIBANO;CURIMATAU OCIDENTAL;-6.485;-36.157;True;20197;9841;10291;12971;6091;6869;7226;3750;3422
2505204;Cuitegi;PB;25;Nordeste;AGRESTE PARAIBANO;GUARABIRA;-6.893;-35.523;True;7047;3535;3510;5676;2797;2879;1371;738;631
2505238;Cuité de Mamanguape;PB;25;Nordeste;MATA PARAIBANA;LITORAL NORTE;-6.915;-35.252;True;6505;3248;3257;1742;855;887;4763;2393;2370
2505279;Curral de Cima;PB;25;Nordeste;MATA PARAIBANA;LITORAL NORTE;-6.717;-35.269;True;5469;2779;2690;494;232;262;4975;2547;2428
2505303;Curral Velho;PB;25;Nordeste;SERTAO PARAIBANO;ITAPORANGA;-7.581;-38.198;True;2781;1449;1332;1588;805;783;1193;644;549
2505352;Damião;PB;25;Nordeste;AGRESTE PARAIBANO;CURIMATAU OCIDENTAL;-6.632;-35.91;True;4807;2436;2369;2044;1009;1035;2763;1427;1334
2505402;Desterro;PB;25;Nordeste;SERTAO PARAIBANO;SERRA DO TEIXEIRA;-7.291;-37.094;True;7929;3868;4061;4500;2119;2381;3429;1749;1680
2505501;Vista Serrana;PB;25;Nordeste;SERTAO PARAIBANO;SOUSA;-6.738;-37.567;True;3253;1688;1533;1361;699;636;1892;989;897
2505600;Diamante;PB;25;Nordeste;SERTAO PARAIBANO;ITAPORANGA;-7.428;-38.264;True;6582;3307;3275;3656;1762;1894;2926;1545;1381
2505709;Dona Inês;PB;25;Nordeste;AGRESTE PARAIBANO;CURIMATAU ORIENTAL;-6.618;-35.632;True;10832;5513;5318;4447;2189;2258;6385;3324;3060
2505808;Duas Estradas;PB;25;Nordeste;AGRESTE PARAIBANO;GUARABIRA;-6.685;-35.418;True;3748;1823;1925;2831;1359;1472;917;464;453
2505907;Emas;PB;25;Nordeste;SERTAO PARAIBANO;PIANCO;-7.108;-37.716;True;3257;1643;1614;1932;948;984;1325;695;630
2506004;Esperança;PB;25;Nordeste;AGRESTE PARAIBANO;ESPERANCA;-7.023;-35.86;True;29801;14491;15131;20484;9758;10642;9317;4733;4489
2506103;Fagundes;PB;25;Nordeste;AGRESTE PARAIBANO;CAMPINA GRANDE;-7.355;-35.775;True;11830;5828;5947;5346;2568;2774;6484;3260;3173
2506202;Frei Martinho;PB;25;Nordeste;BORBOREMA;SERIDO ORIENTAL PARAIBANO;-6.403;-36.456;True;2935;1461;1450;1681;809;851;1254;652;599
2506251;Gado Bravo;PB;25;Nordeste;AGRESTE PARAIBANO;UMBUZEIRO;-7.583;-35.791;True;8236;4081;4135;759;362;397;7477;3719;3738
2506301;Guarabira;PB;25;Nordeste;AGRESTE PARAIBANO;GUARABIRA;-6.855;-35.49;True;54200;26243;27954;47377;22699;24678;6823;3544;3276
2506400;Gurinhém;PB;25;Nordeste;AGRESTE PARAIBANO;ITABAIANA;-7.124;-35.424;True;13209;6611;6583;5670;2792;2878;7539;3819;3705
2506509;Gurjão;PB;25;Nordeste;BORBOREMA;CARIRI ORIENTAL;-7.247;-36.489;True;2985;1485;1500;1903;905;998;1082;580;502
2506608;Ibiara;PB;25;Nordeste;SERTAO PARAIBANO;ITAPORANGA;-7.501;-38.405;True;6139;3061;3072;3527;1715;1812;2612;1346;1260
2506707;Imaculada;PB;25;Nordeste;SERTAO PARAIBANO;SERRA DO TEIXEIRA;-7.39;-37.509;True;11451;5747;5691;4989;2428;2561;6462;3319;3130
2506806;Ingá;PB;25;Nordeste;AGRESTE PARAIBANO;ITABAIANA;-7.268;-35.613;True;18168;8745;9246;11254;5355;5839;6914;3390;3407
2506905;Itabaiana;PB;25;Nordeste;AGRESTE PARAIBANO;ITABAIANA;-7.329;-35.333;True;24752;11936;12803;19987;9538;10443;4765;2398;2360
2507002;Itaporanga;PB;25;Nordeste;SERTAO PARAIBANO;ITAPORANGA;-7.304;-38.15;True;22425;11013;11407;16323;7813;8507;6102;3200;2900
2507101;Itapororoca;PB;25;Nordeste;MATA PARAIBANA;LITORAL NORTE;-6.83;-35.247;True;15966;8061;7881;9945;4906;5034;6021;3155;2847
2507200;Itatuba;PB;25;Nordeste;AGRESTE PARAIBANO;ITABAIANA;-7.375;-35.628;True;9841;4833;5006;5531;2687;2844;4310;2146;2162
2507309;Jacaraú;PB;25;Nordeste;MATA PARAIBANA;LITORAL NORTE;-6.612;-35.293;True;13708;6811;6814;7431;3580;3839;6277;3231;2975
2507408;Jericó;PB;25;Nordeste;SERTAO PARAIBANO;CATOLE DO ROCHA;-6.554;-37.809;True;7825;3850;3975;4691;2222;2469;3134;1628;1506
2507507;João Pessoa;PB;25;Nordeste;MATA PARAIBANA;JOAO PESSOA;-7.115;-34.863;True;674762;306534;349335;674762;306534;349335;;;
2507606;Juarez Távora;PB;25;Nordeste;AGRESTE PARAIBANO;ITABAIANA;-7.172;-35.583;True;7618;3678;3940;5697;2737;2960;1921;941;980
2507705;Juazeirinho;PB;25;Nordeste;BORBOREMA;SERIDO ORIENTAL PARAIBANO;-7.068;-36.578;True;15899;7871;8025;8152;3937;4214;7747;3934;3811
2507804;Junco do Seridó;PB;25;Nordeste;BORBOREMA;SERIDO OCIDENTAL PARAIBANO;-6.997;-36.713;True;6486;3277;3205;4102;2041;2057;2384;1236;1148
2507903;Juripiranga;PB;25;Nordeste;MATA PARAIBANA;SAPE;-7.373;-35.238;True;10240;5104;5113;9453;4705;4725;787;399;388
2508000;Juru;PB;25;Nordeste;SERTAO PARAIBANO;SERRA DO TEIXEIRA;-7.537;-37.819;True;10222;5104;5111;4232;2034;2191;5990;3070;2920
2508109;Lagoa;PB;25;Nordeste;SERTAO PARAIBANO;CATOLE DO ROCHA;-6.571;-37.916;True;4807;2390;2409;2226;1074;1152;2581;1316;1257
2508208;Lagoa de Dentro;PB;25;Nordeste;AGRESTE PARAIBANO;GUARABIRA;-6.673;-35.379;True;7258;3547;3711;3857;1854;2003;3401;1693;1708
2508307;Lagoa Seca;PB;25;Nordeste;AGRESTE PARAIBANO;CAMPINA GRANDE;-7.171;-35.854;True;24937;12252;12608;9200;4348;4829;15737;7904;7779
2508406;Lastro;PB;25;Nordeste;SERTAO PARAIBANO;SOUSA;-6.516;-38.18;True;2834;1443;1391;1255;633;622;1579;810;769
2508505;Livramento;PB;25;Nordeste;BORBOREMA;CARIRI OCIDENTAL;-7.374;-36.946;True;7105;3465;3605;3516;1634;1882;3589;1831;1723
2508554;Logradouro;PB;25;Nordeste;AGRESTE PARAIBANO;GUARABIRA;-6.614;-35.443;True;3816;1883;1933;1683;790;893;2133;1093;1040
2508604;Lucena;PB;25;Nordeste;MATA PARAIBANA;JOAO PESSOA;-6.9;-34.869;True;10943;5455;5488;9085;4477;4608;1858;978;880
2508703;Mãe D'Água;PB;25;Nordeste;SERTAO PARAIBANO;PATOS;-7.259;-37.427;True;4017;1977;2040;1518;726;792;2499;1251;1248
2508802;Malta;PB;25;Nordeste;SERTAO PARAIBANO;SOUSA;-6.904;-37.522;True;5634;2726;2895;4902;2333;2556;732;393;339
2508901;Mamanguape;PB;25;Nordeste;MATA PARAIBANA;LITORAL NORTE;-6.839;-35.126;True;40283;19939;20322;32687;15960;16709;7596;3979;3613
2509008;Manaíra;PB;25;Nordeste;SERTAO PARAIBANO;SERRA DO TEIXEIRA;-7.706;-38.154;True;10986;5551;5435;5821;2887;2934;5165;2664;2501
2509057;Marcação;PB;25;Nordeste;MATA PARAIBANA;LITORAL NORTE;-6.77;-35.015;True;7287;3741;3524;3099;1538;1543;4188;2203;1981
2509107;Mari;PB;25;Nordeste;MATA PARAIBANA;SAPE;-7.06;-35.319;True;20526;10118;10392;17111;8375;8733;3415;1743;1659
2509156;Marizópolis;PB;25;Nordeste;SERTAO PARAIBANO;SOUSA;-6.842;-38.347;True;6214;3095;3119;5379;2653;2726;835;442;393
2509206;Massaranduba;PB;25;Nordeste;AGRESTE PARAIBANO;CAMPINA GRANDE;-7.2;-35.789;True;12494;6056;6419;4242;1938;2304;8252;4118;4115
2509305;Mataraca;PB;25;Nordeste;MATA PARAIBANA;LITORAL NORTE;-6.601;-35.051;True;6984;3553;3431;5992;3039;2953;992;514;478
2509339;Matinhas;PB;25;Nordeste;AGRESTE PARAIBANO;BREJO PARAIBANO;-7.125;-35.767;True;4178;2102;2076;651;312;339;3527;1790;1737
2509370;Mato Grosso;PB;25;Nordeste;SERTAO PARAIBANO;CATOLE DO ROCHA;-6.534;-37.725;True;2601;1298;1303;1151;567;584;1450;731;719
2509396;Maturéia;PB;25;Nordeste;SERTAO PARAIBANO;SERRA DO TEIXEIRA;-7.267;-37.351;True;5785;2789;2863;3516;1696;1810;2269;1093;1053
2509404;Mogeiro;PB;25;Nordeste;AGRESTE PARAIBANO;ITABAIANA;-7.299;-35.479;True;12305;6040;6248;5288;2502;2782;7017;3538;3466
2509503;Montadas;PB;25;Nordeste;AGRESTE PARAIBANO;ESPERANCA;-7.088;-35.959;True;4558;2305;2251;2770;1350;1420;1788;955;831
2509602;Monte Horebe;PB;25;Nordeste;SERTAO PARAIBANO;CAJAZEIRAS;-7.215;-38.586;True;4345;2175;2170;2449;1178;1271;1896;997;899
2509701;Monteiro;PB;25;Nordeste;BORBOREMA;CARIRI OCIDENTAL;-7.889;-37.12;True;29980;14685;15171;18791;8916;9796;11189;5769;5375
2509800;Mulungu;PB;25;Nordeste;AGRESTE PARAIBANO;GUARABIRA;-7.024;-35.462;True;9317;4556;4758;4269;2001;2268;5048;2555;2490
2509909;Natuba;PB;25;Nordeste;AGRESTE PARAIBANO;UMBUZEIRO;-7.641;-35.55;True;10216;5071;5145;3060;1446;1614;7156;3625;3531
2510006;Nazarezinho;PB;25;Nordeste;SERTAO PARAIBANO;SOUSA;-6.916;-38.325;True;6933;3452;3455;3064;1459;1605;3869;1993;1850
2510105;Nova Floresta;PB;25;Nordeste;AGRESTE PARAIBANO;CURIMATAU OCIDENTAL;-6.455;-36.203;True;10032;4857;5162;9006;4317;4676;1026;540;486
2510204;Nova Olinda;PB;25;Nordeste;SERTAO PARAIBANO;PIANCO;-7.48;-38.042;True;6280;3096;3184;3110;1493;1617;3170;1603;1567
2510303;Nova Palmeira;PB;25;Nordeste;BORBOREMA;SERIDO ORIENTAL PARAIBANO;-6.678;-36.421;True;3934;1981;1948;2445;1167;1278;1489;814;670
2510402;Olho D'Água;PB;25;Nordeste;SERTAO PARAIBANO;PIANCO;-7.228;-37.751;True;7450;3682;3768;3719;1792;1927;3731;1890;1841
2510501;Olivedos;PB;25;Nordeste;AGRESTE PARAIBANO;CURIMATAU OCIDENTAL;-6.991;-36.244;True;3489;1789;1700;1632;803;829;1857;986;871
2510600;Ouro Velho;PB;25;Nordeste;BORBOREMA;CARIRI OCIDENTAL;-7.62;-37.152;True;2974;1520;1454;2067;1028;1039;907;492;415
2510659;Parari;PB;25;Nordeste;BORBOREMA;CARIRI OCIDENTAL;-7.321;-36.656;True;1245;632;613;580;289;291;665;343;322
2510709;Passagem;PB;25;Nordeste;SERTAO PARAIBANO;PATOS;-7.138;-37.049;True;2124;1054;1070;1045;499;546;1079;555;524
2510808;Patos;PB;25;Nordeste;SERTAO PARAIBANO;PATOS;-7.024;-37.28;True;97276;46067;51042;93605;44115;49326;3671;1952;1716
2510907;Paulista;PB;25;Nordeste;SERTAO PARAIBANO;SOUSA;-6.594;-37.624;True;11619;5798;5816;5183;2469;2709;6436;3329;3107
2511004;Pedra Branca;PB;25;Nordeste;SERTAO PARAIBANO;ITAPORANGA;-7.427;-38.068;True;3743;1831;1912;2185;1052;1133;1558;779;779
2511103;Pedra Lavrada;PB;25;Nordeste;BORBOREMA;SERIDO ORIENTAL PARAIBANO;-6.757;-36.48;True;6810;3431;3379;2935;1419;1516;3875;2012;1863
2511202;Pedras de Fogo;PB;25;Nordeste;MATA PARAIBANA;LITORAL SUL;-7.402;-35.116;True;26279;13166;12809;15408;7543;7651;10871;5623;5158
2511301;Piancó;PB;25;Nordeste;SERTAO PARAIBANO;PIANCO;-7.198;-37.929;True;15881;7578;8279;11091;5105;5962;4790;2473;2317
2511400;Picuí;PB;25;Nordeste;BORBOREMA;SERIDO ORIENTAL PARAIBANO;-6.555;-36.349;True;18716;9254;9462;11213;5318;5895;7503;3936;3567
2511509;Pilar;PB;25;Nordeste;MATA PARAIBANA;SAPE;-7.267;-35.26;True;11301;5517;5595;7614;3663;3828;3687;1854;1767
2511608;PilõEs;PB;25;Nordeste;AGRESTE PARAIBANO;BREJO PARAIBANO;-6.902;-35.623;True;6936;3551;3385;3078;1513;1565;3858;2038;1820
2511707;PilõEzinhos;PB;25;Nordeste;AGRESTE PARAIBANO;GUARABIRA;-6.844;-35.531;True;5319;2639;2680;2593;1246;1347;2726;1393;1333
2511806;Pirpirituba;PB;25;Nordeste;AGRESTE PARAIBANO;GUARABIRA;-6.78;-35.499;True;10232;5032;5189;7759;3738;4021;2473;1294;1168
2511905;Pitimbu;PB;25;Nordeste;MATA PARAIBANA;LITORAL SUL;-7.471;-34.809;True;16140;8189;7951;9567;4773;4794;6573;3416;3157
2512002;Pocinhos;PB;25;Nordeste;AGRESTE PARAIBANO;CURIMATAU OCIDENTAL;-7.077;-36.061;True;15956;7922;7941;8823;4286;4496;7133;3636;3445
2512036;Poço Dantas;PB;25;Nordeste;SERTAO PARAIBANO;CAJAZEIRAS;-6.403;-38.495;True;3919;1956;1917;902;479;423;3017;1477;1494
2512077;Poço de José de Moura;PB;25;Nordeste;SERTAO PARAIBANO;CAJAZEIRAS;-6.575;-38.512;True;3959;1950;2009;1446;678;768;2513;1272;1241
2512101;Pombal;PB;25;Nordeste;SERTAO PARAIBANO;SOUSA;-6.77;-37.802;True;31524;14968;16262;24318;11277;12785;7206;3691;3477
2512200;Prata;PB;25;Nordeste;BORBOREMA;CARIRI OCIDENTAL;-7.691;-37.08;True;3896;1867;1848;2396;1170;1214;1500;697;634
2512309;Princesa Isabel;PB;25;Nordeste;SERTAO PARAIBANO;SERRA DO TEIXEIRA;-7.737;-37.993;True;19330;9314;9877;13138;6218;6838;6192;3096;3039
2512408;Puxinanã;PB;25;Nordeste;AGRESTE PARAIBANO;CAMPINA GRANDE;-7.161;-35.961;True;12881;6342;6428;3878;1832;2015;9003;4510;4413
2512507;Queimadas;PB;25;Nordeste;AGRESTE PARAIBANO;CAMPINA GRANDE;-7.358;-35.898;True;38883;18776;19820;19862;9420;10339;19021;9356;9481
2512606;Quixabá;PB;25;Nordeste;SERTAO PARAIBANO;PATOS;-7.031;-37.149;True;1433;732;701;574;289;285;859;443;416
2512705;Remígio;PB;25;Nordeste;AGRESTE PARAIBANO;CURIMATAU OCIDENTAL;-6.903;-35.834;True;16748;8041;8705;11672;5461;6209;5076;2580;2496
2512721;Pedro Régis;PB;25;Nordeste;MATA PARAIBANA;LITORAL NORTE;-6.633;-35.297;True;5588;2830;2758;1842;914;928;3746;1916;1830
2512747;Riachão;PB;25;Nordeste;AGRESTE PARAIBANO;CURIMATAU ORIENTAL;-6.55;-35.646;True;3405;1693;1712;1777;868;909;1628;825;803
2512754;Riachão do Bacamarte;PB;25;Nordeste;AGRESTE PARAIBANO;ITABAIANA;-7.243;-35.666;True;4172;2054;2114;2699;1310;1385;1473;744;729
2512762;Riachão do Poço;PB;25;Nordeste;MATA PARAIBANA;SAPE;-7.142;-35.291;True;4239;2109;2130;1008;489;519;3231;1620;1611
2512788;Riacho de Santo Antônio;PB;25;Nordeste;BORBOREMA;CARIRI ORIENTAL;-7.693;-36.157;True;1524;773;751;1014;509;505;510;264;246
2512804;Riacho dos Cavalos;PB;25;Nordeste;SERTAO PARAIBANO;CATOLE DO ROCHA;-6.443;-37.651;True;8057;4139;3918;3427;1726;1701;4630;2413;2217
2512903;Rio Tinto;PB;25;Nordeste;MATA PARAIBANA;LITORAL NORTE;-6.803;-35.081;True;23023;11416;11554;12946;6195;6748;10077;5221;4806
2513000;Salgadinho;PB;25;Nordeste;BORBOREMA;SERIDO OCIDENTAL PARAIBANO;-7.103;-36.845;True;3367;1730;1634;570;277;293;2797;1453;1341
2513109;Salgado de São Félix;PB;25;Nordeste;AGRESTE PARAIBANO;ITABAIANA;-7.357;-35.441;True;12526;6095;6366;5262;2505;2757;7264;3590;3609
2513158;Santa Cecília;PB;25;Nordeste;AGRESTE PARAIBANO;UMBUZEIRO;-7.739;-35.879;True;7016;3529;3421;1526;731;795;5490;2798;2626
2513208;Santa Cruz;PB;25;Nordeste;SERTAO PARAIBANO;SOUSA;-6.533;-38.062;True;6480;3279;3197;2835;1407;1428;3645;1872;1769
2513307;Santa Helena;PB;25;Nordeste;SERTAO PARAIBANO;CAJAZEIRAS;-6.72;-38.638;True;6028;3004;3009;2640;1253;1384;3388;1751;1625
2513356;Santa Inês;PB;25;Nordeste;SERTAO PARAIBANO;ITAPORANGA;-7.621;-38.554;True;3707;1931;1776;1347;671;676;2360;1260;1100
2513406;Santa Luzia;PB;25;Nordeste;BORBOREMA;SERIDO OCIDENTAL PARAIBANO;-6.872;-36.919;True;14292;6879;7392;12885;6106;6766;1407;773;626
2513505;Santana de Mangueira;PB;25;Nordeste;SERTAO PARAIBANO;ITAPORANGA;-7.555;-38.332;True;5609;2865;2738;2112;1034;1078;3497;1831;1660
2513604;Santana dos Garrotes;PB;25;Nordeste;SERTAO PARAIBANO;PIANCO;-7.384;-37.986;True;7610;3705;3900;3842;1783;2059;3768;1922;1841
2513653;Santarém;PB;25;Nordeste;SERTAO PARAIBANO;CAJAZEIRAS;-6.49;-38.476;True;2660;1263;1397;746;359;387;1914;904;1010
2513703;Santa Rita;PB;25;Nordeste;MATA PARAIBANA;JOAO PESSOA;-7.114;-34.978;True;122454;59206;62788;105720;50727;54651;16734;8479;8137
2513802;Santa Teresinha;PB;25;Nordeste;SERTAO PARAIBANO;PATOS;-7.116;-37.452;True;4644;2318;2326;2019;959;1060;2625;1359;1266
2513851;Santo André;PB;25;Nordeste;BORBOREMA;CARIRI ORIENTAL;-7.218;-36.633;True;2641;1331;1310;749;351;398;1892;980;912
2513901;São Bento;PB;25;Nordeste;SERTAO PARAIBANO;CATOLE DO ROCHA;-6.486;-37.451;True;29196;14511;14661;22415;11027;11369;6781;3484;3292
2513927;São Bentinho;PB;25;Nordeste;SERTAO PARAIBANO;SOUSA;-6.901;-37.729;True;4049;2010;2039;2702;1324;1378;1347;686;661
2513943;São Domingos do Cariri;PB;25;Nordeste;BORBOREMA;CARIRI ORIENTAL;-7.636;-36.433;True;2265;1110;1119;1099;510;567;1166;600;552
2513968;São Domingos de Pombal;PB;25;Nordeste;SERTAO PARAIBANO;SOUSA;-6.814;-37.942;True;2719;1365;1354;945;474;471;1774;891;883
2513984;São Francisco;PB;25;Nordeste;SERTAO PARAIBANO;SOUSA;-6.619;-38.094;True;3442;1722;1720;1230;615;615;2212;1107;1105
2514008;São João do Cariri;PB;25;Nordeste;BORBOREMA;CARIRI ORIENTAL;-7.391;-36.533;True;4438;2211;2227;2188;1046;1142;2250;1165;1085
2514107;São João do Tigre;PB;25;Nordeste;BORBOREMA;CARIRI OCIDENTAL;-8.079;-36.848;True;4578;2292;2244;1534;738;796;3044;1554;1448
2514206;São José da Lagoa Tapada;PB;25;Nordeste;SERTAO PARAIBANO;SOUSA;-6.941;-38.162;True;7810;3839;3951;3273;1555;1718;4537;2284;2233
2514305;São José de Caiana;PB;25;Nordeste;SERTAO PARAIBANO;ITAPORANGA;-7.249;-38.301;True;5942;3008;2911;2412;1188;1224;3530;1820;1687
2514404;São José de Espinharas;PB;25;Nordeste;SERTAO PARAIBANO;PATOS;-6.847;-37.326;True;4913;2587;2325;1604;794;810;3309;1793;1515
2514453;São José dos Ramos;PB;25;Nordeste;MATA PARAIBANA;SAPE;-7.251;-35.384;True;5482;2763;2646;2070;999;1061;3412;1764;1585
2514503;São José de Piranhas;PB;25;Nordeste;SERTAO PARAIBANO;CAJAZEIRAS;-7.121;-38.502;True;18898;9364;9368;9790;4684;5070;9108;4680;4298
2514552;São José de Princesa;PB;25;Nordeste;SERTAO PARAIBANO;SERRA DO TEIXEIRA;-7.738;-38.094;True;4644;2381;2263;491;237;254;4153;2144;2009
2514602;São José do Bonfim;PB;25;Nordeste;SERTAO PARAIBANO;PATOS;-7.163;-37.309;True;3180;1623;1557;1192;577;615;1988;1046;942
2514651;São José do Brejo do Cruz;PB;25;Nordeste;SERTAO PARAIBANO;CATOLE DO ROCHA;-6.213;-37.352;True;1647;849;787;816;409;396;831;440;391
2514701;São José do Sabugi;PB;25;Nordeste;BORBOREMA;SERIDO OCIDENTAL PARAIBANO;-6.776;-36.799;True;3986;2017;1969;2514;1229;1285;1472;788;684
2514800;São José dos Cordeiros;PB;25;Nordeste;BORBOREMA;CARIRI OCIDENTAL;-7.391;-36.808;True;3973;1980;1993;1530;723;807;2443;1257;1186
2514909;São Mamede;PB;25;Nordeste;BORBOREMA;SERIDO OCIDENTAL PARAIBANO;-6.927;-37.096;True;7782;3892;3890;5712;2755;2957;2070;1137;933
2515005;São Miguel de Taipu;PB;25;Nordeste;MATA PARAIBANA;SAPE;-7.25;-35.21;True;6568;3260;3248;2898;1418;1474;3670;1842;1774
2515104;São Sebastião de Lagoa de Roça;PB;25;Nordeste;AGRESTE PARAIBANO;ESPERANCA;-7.083;-35.835;True;10908;5341;5567;4287;2002;2285;6621;3339;3282
2515203;São Sebastião do Umbuzeiro;PB;25;Nordeste;BORBOREMA;CARIRI OCIDENTAL;-8.152;-37.01;True;3061;1540;1521;2007;963;1044;1054;577;477
2515302;Sapé;PB;25;Nordeste;MATA PARAIBANA;SAPE;-7.095;-35.233;True;46363;22783;23476;35457;17189;18239;10906;5594;5237
2515401;Seridó;PB;25;Nordeste;BORBOREMA;SERIDO ORIENTAL PARAIBANO;-6.934;-36.402;True;9737;4993;4736;4098;2038;2060;5639;2955;2676
2515500;Serra Branca;PB;25;Nordeste;BORBOREMA;CARIRI OCIDENTAL;-7.483;-36.665;True;12413;6038;6371;8632;4022;4606;3781;2016;1765
2515609;Serra da Raiz;PB;25;Nordeste;AGRESTE PARAIBANO;GUARABIRA;-6.687;-35.444;True;3130;1556;1566;2003;1000;995;1127;556;571
2515708;Serra Grande;PB;25;Nordeste;SERTAO PARAIBANO;ITAPORANGA;-7.215;-38.37;True;3038;1527;1511;1737;857;880;1301;670;631
2515807;Serra Redonda;PB;25;Nordeste;AGRESTE PARAIBANO;CAMPINA GRANDE;-7.178;-35.675;True;7651;3652;3999;3520;1628;1892;4131;2024;2107
2515906;Serraria;PB;25;Nordeste;AGRESTE PARAIBANO;BREJO PARAIBANO;-6.82;-35.633;True;6602;3274;3328;3320;1566;1754;3282;1708;1574
2515930;Sertãozinho;PB;25;Nordeste;AGRESTE PARAIBANO;GUARABIRA;-6.751;-35.442;True;4213;2049;2164;2831;1358;1473;1382;691;691
2515971;Sobrado;PB;25;Nordeste;MATA PARAIBANA;SAPE;-7.144;-35.239;True;7340;3696;3644;800;372;428;6540;3324;3216
2516003;Solânea;PB;25;Nordeste;AGRESTE PARAIBANO;CURIMATAU ORIENTAL;-6.778;-35.697;True;27346;13138;14208;19107;8984;10123;8239;4154;4085
2516102;Soledade;PB;25;Nordeste;AGRESTE PARAIBANO;CURIMATAU OCIDENTAL;-7.057;-36.363;True;13128;6494;6634;9523;4636;4887;3605;1858;1747
2516151;Sossêgo;PB;25;Nordeste;AGRESTE PARAIBANO;CURIMATAU OCIDENTAL;-6.769;-36.254;True;2965;1489;1466;1381;675;706;1584;814;760
2516201;Sousa;PB;25;Nordeste;SERTAO PARAIBANO;SOUSA;-6.761;-38.231;True;63783;30666;32744;50024;23745;25963;13759;6921;6781
2516300;Sumé;PB;25;Nordeste;BORBOREMA;CARIRI OCIDENTAL;-7.672;-36.88;True;16456;8078;8184;11962;5685;6153;4494;2393;2031
2516409;Campo de Santana;PB;25;Nordeste;AGRESTE PARAIBANO;CURIMATAU ORIENTAL;-6.488;-35.637;True;9549;4875;4661;4043;2050;1993;5506;2825;2668
2516508;Taperoá;PB;25;Nordeste;BORBOREMA;CARIRI OCIDENTAL;-7.207;-36.827;True;14715;7190;7525;8568;4018;4550;6147;3172;2975
2516607;Tavares;PB;25;Nordeste;SERTAO PARAIBANO;SERRA DO TEIXEIRA;-7.636;-37.878;True;14021;6968;7053;6156;2976;3180;7865;3992;3873
2516706;Teixeira;PB;25;Nordeste;SERTAO PARAIBANO;SERRA DO TEIXEIRA;-7.223;-37.254;True;13685;6768;6917;8908;4289;4619;4777;2479;2298
2516755;Tenório;PB;25;Nordeste;BORBOREMA;SERIDO ORIENTAL PARAIBANO;-6.942;-36.629;True;2806;1476;1330;1590;821;769;1216;655;561
2516805;Triunfo;PB;25;Nordeste;SERTAO PARAIBANO;CAJAZEIRAS;-6.579;-38.597;True;9624;4819;4797;4314;2106;2208;5310;2713;2589
2516904;Uiraúna;PB;25;Nordeste;SERTAO PARAIBANO;CAJAZEIRAS;-6.518;-38.412;True;14454;6894;7457;9991;4671;5317;4463;2223;2140
2517001;Umbuzeiro;PB;25;Nordeste;AGRESTE PARAIBANO;UMBUZEIRO;-7.696;-35.664;True;9173;4353;4692;3724;1727;1931;5449;2626;2761
2517100;Várzea;PB;25;Nordeste;BORBOREMA;SERIDO OCIDENTAL PARAIBANO;-6.772;-36.992;True;2457;1227;1215;1744;822;910;713;405;305
2517209;Vieirópolis;PB;25;Nordeste;SERTAO PARAIBANO;SOUSA;-6.507;-38.256;True;4756;2394;2352;893;448;445;3863;1946;1907
2517407;Zabelê;PB;25;Nordeste;BORBOREMA;CARIRI OCIDENTAL;-8.076;-37.098;True;2024;1030;994;1349;663;686;675;367;308
2600054;Abreu e Lima;PE;26;Nordeste;METROPOLITANA DE RECIFE;RECIFE;-7.912;-34.903;True;92217;44166;46842;84482;39922;43427;7735;4244;3415
2600104;Afogados da Ingazeira;PE;26;Nordeste;SERTAO PERNAMBUCANO;PAJEU;-7.751;-37.639;True;34047;16180;17702;25483;11839;13530;8564;4341;4172
2600203;Afrânio;PE;26;Nordeste;SAO FRANCISCO PERNAMBUCANO;PETROLINA;-8.515;-41.005;True;16471;8230;8168;4939;2300;2639;11532;5930;5529
2600302;Agrestina;PE;26;Nordeste;AGRESTE PERNAMBUCANO;BREJO PERNAMBUCANO;-8.458;-35.945;True;21456;10417;11033;15561;7456;8105;5895;2961;2928
2600401;Água Preta;PE;26;Nordeste;MATA PERNAMBUCANA;MATA MERIDIONAL PERNAMBUCANA;-8.707;-35.531;True;29508;14914;14585;16941;8276;8665;12567;6638;5920
2600500;Águas Belas;PE;26;Nordeste;AGRESTE PERNAMBUCANO;VALE DO IPANEMA;-9.111;-37.123;True;37992;18361;19180;22705;10546;11860;15287;7815;7320
2600609;Alagoinha;PE;26;Nordeste;AGRESTE PERNAMBUCANO;VALE DO IPOJUCA;-8.466;-36.776;True;14016;7012;7000;8114;3892;4222;5902;3120;2778
2600708;Aliança;PE;26;Nordeste;MATA PERNAMBUCANA;MATA SETENTRIONAL PERNAMBUCANA;-7.603;-35.231;True;34740;17289;17205;17162;8355;8693;17578;8934;8512
2600807;Altinho;PE;26;Nordeste;AGRESTE PERNAMBUCANO;BREJO PERNAMBUCANO;-8.49;-36.059;True;21782;10819;10942;12064;5725;6336;9718;5094;4606
2600906;Amaraji;PE;26;Nordeste;MATA PERNAMBUCANA;MATA MERIDIONAL PERNAMBUCANA;-8.383;-35.453;True;20149;10173;9957;15575;7731;7831;4574;2442;2126
2601003;Angelim;PE;26;Nordeste;AGRESTE PERNAMBUCANO;GARANHUNS;-8.89;-36.286;True;9836;4844;4953;5534;2619;2892;4302;2225;2061
2601052;Araçoiaba;PE;26;Nordeste;METROPOLITANA DE RECIFE;ITAMARACA;-7.79;-35.091;True;16520;8066;8281;12986;6254;6565;3534;1812;1716
2601102;Araripina;PE;26;Nordeste;SERTAO PERNAMBUCANO;ARARIPINA;-7.576;-40.498;True;75878;37055;38422;39832;18783;20915;36046;18272;17507
2601201;Arcoverde;PE;26;Nordeste;SERTAO PERNAMBUCANO;SERTAO DO MOXOTO;-8.419;-37.054;True;64863;30154;34286;58949;27124;31440;5914;3030;2846
2601300;Barra de Guabiraba;PE;26;Nordeste;AGRESTE PERNAMBUCANO;BREJO PERNAMBUCANO;-8.42;-35.658;True;12694;6339;6350;10901;5404;5492;1793;935;858
2601409;Barreiros;PE;26;Nordeste;MATA PERNAMBUCANA;MATA MERIDIONAL PERNAMBUCANA;-8.818;-35.186;True;41748;20137;20956;35111;16665;17873;6637;3472;3083
2601508;Belém de Maria;PE;26;Nordeste;MATA PERNAMBUCANA;MATA MERIDIONAL PERNAMBUCANA;-8.614;-35.809;True;9649;4776;4744;6995;3433;3522;2654;1343;1222
2601607;Belém de São Francisco;PE;26;Nordeste;SAO FRANCISCO PERNAMBUCANO;ITAPARICA;-8.758;-38.964;True;20545;9988;10431;12959;6102;6857;7586;3886;3574
2601706;Belo Jardim;PE;26;Nordeste;AGRESTE PERNAMBUCANO;VALE DO IPOJUCA;-8.336;-36.424;True;70963;33665;36017;53285;25017;27907;17678;8648;8110
2601805;Betânia;PE;26;Nordeste;SERTAO PERNAMBUCANO;SERTAO DO MOXOTO;-8.276;-38.034;True;11548;5687;5665;3347;1567;1774;8201;4120;3891
2601904;Bezerros;PE;26;Nordeste;AGRESTE PERNAMBUCANO;VALE DO IPOJUCA;-8.233;-35.797;True;56629;26985;29363;46955;22015;24740;9674;4970;4623
2602001;Bodocó;PE;26;Nordeste;SERTAO PERNAMBUCANO;ARARIPINA;-7.778;-39.941;True;33381;16750;16547;10515;4933;5573;22866;11817;10974
2602100;Bom Conselho;PE;26;Nordeste;AGRESTE PERNAMBUCANO;GARANHUNS;-9.17;-36.68;True;43397;20880;22458;26690;12448;14211;16707;8432;8247
2602209;Bom Jardim;PE;26;Nordeste;AGRESTE PERNAMBUCANO;MEDIO CAPIBARIBE;-7.796;-35.587;True;39023;19090;19919;14531;6926;7605;24492;12164;12314
2602308;Bonito;PE;26;Nordeste;AGRESTE PERNAMBUCANO;BREJO PERNAMBUCANO;-8.47;-35.729;True;39111;19055;19278;25305;11869;12886;13806;7186;6392
2602407;Brejão;PE;26;Nordeste;AGRESTE PERNAMBUCANO;GARANHUNS;-9.03;-36.569;True;9341;4536;4633;3549;1667;1845;5792;2869;2788
2602506;Brejinho;PE;26;Nordeste;SERTAO PERNAMBUCANO;PAJEU;-7.349;-37.286;True;7158;3528;3630;3039;1409;1630;4119;2119;2000
2602605;Brejo da Madre de Deus;PE;26;Nordeste;AGRESTE PERNAMBUCANO;VALE DO IPOJUCA;-8.146;-36.371;True;40265;20068;20189;29806;14557;15245;10459;5511;4944
2602704;Buenos Aires;PE;26;Nordeste;MATA PERNAMBUCANA;MATA SETENTRIONAL PERNAMBUCANA;-7.726;-35.327;True;12962;6462;6493;7727;3771;3956;5235;2691;2537
2602803;Buíque;PE;26;Nordeste;AGRESTE PERNAMBUCANO;VALE DO IPANEMA;-8.623;-37.156;True;49937;24790;25076;18587;8829;9758;31350;15961;15318
2602902;Cabo de Santo Agostinho;PE;26;Nordeste;METROPOLITANA DE RECIFE;SUAPE;-8.287;-35.035;True;163139;79482;83068;144068;69479;74029;19071;10003;9039
2603009;Cabrobó;PE;26;Nordeste;SAO FRANCISCO PERNAMBUCANO;PETROLINA;-8.512;-39.307;True;28851;13965;14637;17696;8195;9373;11155;5770;5264
2603108;Cachoeirinha;PE;26;Nordeste;AGRESTE PERNAMBUCANO;VALE DO IPOJUCA;-8.486;-36.233;True;17421;8411;8975;13141;6251;6884;4280;2160;2091
2603207;Caetés;PE;26;Nordeste;AGRESTE PERNAMBUCANO;GARANHUNS;-8.773;-36.623;True;25219;12264;12776;6846;3199;3647;18373;9065;9129
2603306;Calçado;PE;26;Nordeste;AGRESTE PERNAMBUCANO;GARANHUNS;-8.742;-36.334;True;11337;5707;5605;3699;1806;1887;7638;3901;3718
2603405;Calumbi;PE;26;Nordeste;SERTAO PERNAMBUCANO;PAJEU;-7.941;-38.15;True;7577;3523;3743;2078;979;1099;5499;2544;2644
2603454;Camaragibe;PE;26;Nordeste;METROPOLITANA DE RECIFE;RECIFE;-8.022;-34.981;True;136381;65060;70511;136381;65060;70511;;;
2603504;Camocim de São Félix;PE;26;Nordeste;AGRESTE PERNAMBUCANO;BREJO PERNAMBUCANO;-8.359;-35.762;True;15831;7567;7998;13265;6317;6799;2566;1250;1199
2603603;Camutanga;PE;26;Nordeste;MATA PERNAMBUCANA;MATA SETENTRIONAL PERNAMBUCANA;-7.407;-35.274;True;7921;3948;3963;6606;3251;3348;1315;697;615
2603702;Canhotinho;PE;26;Nordeste;AGRESTE PERNAMBUCANO;GARANHUNS;-8.882;-36.191;True;24218;12345;11873;14067;7067;7000;10151;5278;4873
2603801;Capoeiras;PE;26;Nordeste;AGRESTE PERNAMBUCANO;VALE DO IPOJUCA;-8.735;-36.627;True;19337;9576;9627;5734;2707;3016;13603;6869;6611
2603900;Carnaíba;PE;26;Nordeste;SERTAO PERNAMBUCANO;PAJEU;-7.805;-37.794;True;18345;9068;9204;7069;3365;3704;11276;5703;5500
2603926;Carnaubeira da Penha;PE;26;Nordeste;SAO FRANCISCO PERNAMBUCANO;ITAPARICA;-8.322;-38.744;True;11689;5936;5745;1663;777;886;10026;5159;4859
2604007;Carpina;PE;26;Nordeste;MATA PERNAMBUCANA;MATA SETENTRIONAL PERNAMBUCANA;-7.851;-35.255;True;65390;30930;34090;63480;29995;33138;1910;935;952
2604106;Caruaru;PE;26;Nordeste;AGRESTE PERNAMBUCANO;VALE DO IPOJUCA;-8.283;-35.976;True;289086;;;;;;;;
2604155;Casinhas;PE;26;Nordeste;AGRESTE PERNAMBUCANO;ALTO CAPIBARIBE;-7.741;-35.721;True;14103;6951;7090;1543;728;815;12560;6223;6275
2604205;Catende;PE;26;Nordeste;MATA PERNAMBUCANA;MATA MERIDIONAL PERNAMBUCANA;-8.667;-35.717;True;33479;16257;17222;25713;12207;13506;7766;4050;3716
2604304;Cedro;PE;26;Nordeste;SERTAO PERNAMBUCANO;SALGUEIRO;-7.722;-39.239;True;10240;5093;5147;5772;2798;2974;4468;2295;2173
2604403;Chã de Alegria;PE;26;Nordeste;MATA PERNAMBUCANA;VITORIA DE SANTO ANTAO;-8.001;-35.213;True;11636;5810;5826;8464;4168;4296;3172;1642;1530
2604502;Chã Grande;PE;26;Nordeste;MATA PERNAMBUCANA;VITORIA DE SANTO ANTAO;-8.238;-35.462;True;17563;8768;8766;11803;5768;6024;5760;3000;2742
2604601;Condado;PE;26;Nordeste;MATA PERNAMBUCANA;MATA SETENTRIONAL PERNAMBUCANA;-7.586;-35.106;True;23211;11336;11747;21310;10324;10864;1901;1012;883
2604700;Correntes;PE;26;Nordeste;AGRESTE PERNAMBUCANO;GARANHUNS;-9.129;-36.33;True;16330;7987;8287;8912;4202;4710;7418;3785;3577
2604809;Cortês;PE;26;Nordeste;MATA PERNAMBUCANA;MATA MERIDIONAL PERNAMBUCANA;-8.47;-35.541;True;11616;5760;5856;8313;4015;4298;3303;1745;1558
2604908;Cumaru;PE;26;Nordeste;AGRESTE PERNAMBUCANO;MEDIO CAPIBARIBE;-8.006;-35.697;True;16388;8173;8178;6313;3067;3246;10075;5106;4932
2605004;Cupira;PE;26;Nordeste;AGRESTE PERNAMBUCANO;BREJO PERNAMBUCANO;-8.617;-35.95;True;22106;10489;11611;18739;8745;9994;3367;1744;1617
2605103;Custódia;PE;26;Nordeste;SERTAO PERNAMBUCANO;SERTAO DO MOXOTO;-8.088;-37.643;True;32157;15674;16171;19005;8840;9931;13152;6834;6240
2605152;Dormentes;PE;26;Nordeste;SAO FRANCISCO PERNAMBUCANO;PETROLINA;-8.447;-40.771;True;15595;7985;7591;4919;2421;2481;10676;5564;5110
2605202;Escada;PE;26;Nordeste;MATA PERNAMBUCANA;MATA MERIDIONAL PERNAMBUCANA;-8.359;-35.224;True;59850;29104;30326;49474;23811;25409;10376;5293;4917
2605301;Exu;PE;26;Nordeste;SERTAO PERNAMBUCANO;ARARIPINA;-7.512;-39.724;True;30567;15034;15480;13082;6108;6962;17485;8926;8518
2605400;Feira Nova;PE;26;Nordeste;AGRESTE PERNAMBUCANO;MEDIO CAPIBARIBE;-7.951;-35.389;True;19276;9445;9750;14517;6980;7456;4759;2465;2294
2605459;Fernando de Noronha;PE;26;Nordeste;METROPOLITANA DE RECIFE;FERNANDO DE NORONHA;-3.84;-32.411;True;2801;1417;1355;2801;1417;1355;;;
2605509;Ferreiros;PE;26;Nordeste;MATA PERNAMBUCANA;MATA SETENTRIONAL PERNAMBUCANA;-7.448;-35.244;True;11002;5429;5507;8754;4268;4454;2248;1161;1053
2605608;Flores;PE;26;Nordeste;SERTAO PERNAMBUCANO;PAJEU;-7.866;-37.975;True;21962;10949;10965;9312;4426;4886;12650;6523;6079
2605707;Floresta;PE;26;Nordeste;SAO FRANCISCO PERNAMBUCANO;ITAPARICA;-8.601;-38.568;True;26648;13136;13456;17284;8150;9134;9364;4986;4322
2605806;Frei Miguelinho;PE;26;Nordeste;AGRESTE PERNAMBUCANO;ALTO CAPIBARIBE;-7.94;-35.912;True;14067;6916;7112;2889;1400;1484;11178;5516;5628
2605905;Gameleira;PE;26;Nordeste;MATA PERNAMBUCANA;MATA MERIDIONAL PERNAMBUCANA;-8.584;-35.387;True;26281;13235;12937;19065;9444;9594;7216;3791;3343
2606002;Garanhuns;PE;26;Nordeste;AGRESTE PERNAMBUCANO;GARANHUNS;-8.89;-36.493;True;124996;58768;65566;110135;51184;58316;14861;7584;7250
2606101;Glória do Goitá;PE;26;Nordeste;MATA PERNAMBUCANA;VITORIA DE SANTO ANTAO;-8.002;-35.293;True;27397;13508;13857;14229;6779;7442;13168;6729;6415
2606200;Goiana;PE;26;Nordeste;MATA PERNAMBUCANA;MATA SETENTRIONAL PERNAMBUCANA;-7.561;-35.003;True;71796;35197;36559;55236;26743;28453;16560;8454;8106
2606309;Granito;PE;26;Nordeste;SERTAO PERNAMBUCANO;ARARIPINA;-7.716;-39.615;True;6593;3294;3297;2736;1309;1427;3857;1985;1870
2606408;Gravatá;PE;26;Nordeste;AGRESTE PERNAMBUCANO;VALE DO IPOJUCA;-8.201;-35.565;True;71570;34102;36262;61911;29106;31724;9659;4996;4538
2606507;Iati;PE;26;Nordeste;AGRESTE PERNAMBUCANO;GARANHUNS;-9.046;-36.846;True;17733;8870;8862;7054;3402;3651;10679;5468;5211
2606606;Ibimirim;PE;26;Nordeste;SERTAO PERNAMBUCANO;SERTAO DO MOXOTO;-8.541;-37.69;True;27261;13460;13586;14350;6938;7412;12911;6522;6174
2606705;Ibirajuba;PE;26;Nordeste;AGRESTE PERNAMBUCANO;BREJO PERNAMBUCANO;-8.581;-36.179;True;7545;3816;3729;2833;1355;1478;4712;2461;2251
2606804;Igarassu;PE;26;Nordeste;METROPOLITANA DE RECIFE;ITAMARACA;-7.834;-34.906;True;93748;45009;47731;85547;40765;43841;8201;4244;3890
2606903;Iguaraci;PE;26;Nordeste;SERTAO PERNAMBUCANO;PAJEU;-7.835;-37.515;True;11880;5811;5636;5660;2731;2872;6220;3080;2764
2607000;Inajá;PE;26;Nordeste;SERTAO PERNAMBUCANO;SERTAO DO MOXOTO;-8.903;-37.827;True;14036;7003;7030;7417;3563;3854;6619;3440;3176
2607109;Ingazeira;PE;26;Nordeste;SERTAO PERNAMBUCANO;PAJEU;-7.676;-37.46;True;4444;2233;2211;2228;1093;1135;2216;1140;1076
2607208;Ipojuca;PE;26;Nordeste;METROPOLITANA DE RECIFE;SUAPE;-8.399;-35.064;True;70070;34399;35269;48392;23322;24872;21678;11077;10397
2607307;Ipubi;PE;26;Nordeste;SERTAO PERNAMBUCANO;ARARIPINA;-7.652;-40.149;True;25718;12517;13034;16445;7796;8540;9273;4721;4494
2607406;Itacuruba;PE;26;Nordeste;SAO FRANCISCO PERNAMBUCANO;ITAPARICA;-8.834;-38.704;True;4097;1858;1947;3677;1658;1767;420;200;180
2607505;Itaíba;PE;26;Nordeste;AGRESTE PERNAMBUCANO;VALE DO IPANEMA;-8.948;-37.423;True;26735;13379;13349;8976;4236;4740;17759;9143;8609
2607604;Ilha de Itamaracá;PE;26;Nordeste;METROPOLITANA DE RECIFE;ITAMARACA;-7.748;-34.826;True;17573;9789;7711;13902;6768;7061;3671;3021;650
2607653;Itambé;PE;26;Nordeste;MATA PERNAMBUCANA;MATA SETENTRIONAL PERNAMBUCANA;-7.41;-35.113;True;34944;17063;17283;28555;13793;14337;6389;3270;2946
2607703;Itapetim;PE;26;Nordeste;SERTAO PERNAMBUCANO;PAJEU;-7.378;-37.19;True;13849;6842;7007;7716;3637;4079;6133;3205;2928
2607752;Itapissuma;PE;26;Nordeste;METROPOLITANA DE RECIFE;ITAMARACA;-7.776;-34.892;True;22852;11250;11558;17458;8384;9049;5394;2866;2509
2607802;Itaquitinga;PE;26;Nordeste;MATA PERNAMBUCANA;MATA SETENTRIONAL PERNAMBUCANA;-7.668;-35.102;True;14985;7536;7445;11254;5613;5641;3731;1923;1804
2607901;Jaboatão dos Guararapes;PE;26;Nordeste;METROPOLITANA DE RECIFE;RECIFE;-8.113;-35.015;True;665387;;;;;;;;
2607950;Jaqueira;PE;26;Nordeste;MATA PERNAMBUCANA;MATA MERIDIONAL PERNAMBUCANA;-8.727;-35.793;True;12102;6043;5987;7290;3592;3698;4812;2451;2289
2608008;Jataúba;PE;26;Nordeste;AGRESTE PERNAMBUCANO;VALE DO IPOJUCA;-7.99;-36.496;True;14813;7355;7396;7900;3733;4167;6913;3622;3229
2608057;Jatobá;PE;26;Nordeste;SAO FRANCISCO PERNAMBUCANO;ITAPARICA;-9.183;-38.269;True;13797;6790;7005;5730;2802;2926;8067;3988;4079
2608107;João Alfredo;PE;26;Nordeste;AGRESTE PERNAMBUCANO;MEDIO CAPIBARIBE;-7.856;-35.588;True;28488;13731;14664;13010;6085;6917;15478;7646;7747
2608206;Joaquim Nabuco;PE;26;Nordeste;MATA PERNAMBUCANA;MATA MERIDIONAL PERNAMBUCANA;-8.624;-35.533;True;15947;8001;7946;11321;5570;5751;4626;2431;2195
2608255;Jucati;PE;26;Nordeste;AGRESTE PERNAMBUCANO;GARANHUNS;-8.706;-36.489;True;10500;5224;5265;2524;1243;1281;7976;3981;3984
2608305;Jupi;PE;26;Nordeste;AGRESTE PERNAMBUCANO;GARANHUNS;-8.712;-36.415;True;13628;6740;6884;7028;3335;3691;6600;3405;3193
2608404;Jurema;PE;26;Nordeste;AGRESTE PERNAMBUCANO;GARANHUNS;-8.718;-36.136;True;14760;7162;7432;8624;4087;4525;6136;3075;2907
2608453;Lagoa do Carro;PE;26;Nordeste;MATA PERNAMBUCANA;MATA SETENTRIONAL PERNAMBUCANA;-7.845;-35.32;True;14380;7106;7195;10335;5026;5233;4045;2080;1962
2608503;Lagoa do Itaenga;PE;26;Nordeste;MATA PERNAMBUCANA;MATA SETENTRIONAL PERNAMBUCANA;-7.936;-35.29;True;19987;9727;10208;17077;8274;8763;2910;1453;1445
2608602;Lagoa do Ouro;PE;26;Nordeste;AGRESTE PERNAMBUCANO;GARANHUNS;-9.127;-36.459;True;11655;5777;5862;5403;2580;2820;6252;3197;3042
2608701;Lagoa dos Gatos;PE;26;Nordeste;AGRESTE PERNAMBUCANO;BREJO PERNAMBUCANO;-8.658;-35.9;True;15967;8023;7935;8312;4016;4293;7655;4007;3642
2608750;Lagoa Grande;PE;26;Nordeste;SAO FRANCISCO PERNAMBUCANO;PETROLINA;-8.997;-40.272;True;21125;10579;10489;9540;4597;4943;11585;5982;5546
2608800;Lajedo;PE;26;Nordeste;AGRESTE PERNAMBUCANO;GARANHUNS;-8.664;-36.32;True;33348;15744;17369;23631;10888;12578;9717;4856;4791
2608909;Limoeiro;PE;26;Nordeste;AGRESTE PERNAMBUCANO;MEDIO CAPIBARIBE;-7.875;-35.45;True;55560;26572;28964;43093;20336;22743;12467;6236;6221
2609006;Macaparana;PE;26;Nordeste;MATA PERNAMBUCANA;MATA SETENTRIONAL PERNAMBUCANA;-7.555;-35.453;True;23078;11211;11797;14572;6939;7591;8506;4272;4206
2609105;Machados;PE;26;Nordeste;AGRESTE PERNAMBUCANO;MEDIO CAPIBARIBE;-7.686;-35.515;True;11152;5255;5622;7621;3429;3932;3531;1826;1690
2609154;Manari;PE;26;Nordeste;SERTAO PERNAMBUCANO;SERTAO DO MOXOTO;-8.964;-37.628;True;16540;8223;8287;3261;1534;1727;13279;6689;6560
2609204;Maraial;PE;26;Nordeste;MATA PERNAMBUCANA;MATA MERIDIONAL PERNAMBUCANA;-8.803;-35.829;True;12352;6226;6123;8710;4318;4392;3642;1908;1731
2609303;Mirandiba;PE;26;Nordeste;SERTAO PERNAMBUCANO;SALGUEIRO;-8.119;-38.728;True;13304;6567;6699;6973;3354;3619;6331;3213;3080
2609402;Moreno;PE;26;Nordeste;METROPOLITANA DE RECIFE;RECIFE;-8.119;-35.092;True;52830;25666;26706;46407;22281;23697;6423;3385;3009
2609501;Nazaré da Mata;PE;26;Nordeste;MATA PERNAMBUCANA;MATA SETENTRIONAL PERNAMBUCANA;-7.742;-35.228;True;29202;14161;15006;25868;12369;13480;3334;1792;1526
2609600;Olinda;PE;26;Nordeste;METROPOLITANA DE RECIFE;RECIFE;-8.009;-34.855;True;391433;;;;;;;;
2609709;Orobó;PE;26;Nordeste;AGRESTE PERNAMBUCANO;MEDIO CAPIBARIBE;-7.745;-35.602;True;21632;10501;11106;7080;3324;3756;14552;7177;7350
2609808;Orocó;PE;26;Nordeste;SAO FRANCISCO PERNAMBUCANO;PETROLINA;-8.62;-39.602;True;13167;6436;6480;4394;2030;2306;8773;4406;4174
2609907;Ouricuri;PE;26;Nordeste;SERTAO PERNAMBUCANO;ARARIPINA;-7.883;-40.082;True;63042;30897;31649;31052;14563;16212;31990;16334;15437
2610004;Palmares;PE;26;Nordeste;MATA PERNAMBUCANA;MATA MERIDIONAL PERNAMBUCANA;-8.683;-35.592;True;56643;27362;29213;44590;21073;23449;12053;6289;5764
2610103;Palmeirina;PE;26;Nordeste;AGRESTE PERNAMBUCANO;GARANHUNS;-9.004;-36.326;True;8487;4139;4340;4989;2331;2650;3498;1808;1690
2610202;Panelas;PE;26;Nordeste;AGRESTE PERNAMBUCANO;BREJO PERNAMBUCANO;-8.664;-36.006;True;24918;12332;12576;12262;5789;6473;12656;6543;6103
2610301;Paranatama;PE;26;Nordeste;AGRESTE PERNAMBUCANO;GARANHUNS;-8.921;-36.658;True;11669;5586;5494;2021;960;1051;9648;4626;4443
2610400;Parnamirim;PE;26;Nordeste;SERTAO PERNAMBUCANO;SALGUEIRO;-8.091;-39.578;True;19214;9751;9393;7595;3619;3957;11619;6132;5436
2610509;Passira;PE;26;Nordeste;AGRESTE PERNAMBUCANO;MEDIO CAPIBARIBE;-7.995;-35.581;True;27910;13620;14288;13099;6213;6886;14811;7407;7402
2610608;Paudalho;PE;26;Nordeste;MATA PERNAMBUCANA;MATA SETENTRIONAL PERNAMBUCANA;-7.897;-35.18;True;45777;22274;22866;33270;16158;16830;12507;6116;6036
2610707;Paulista;PE;26;Nordeste;METROPOLITANA DE RECIFE;RECIFE;-7.941;-34.873;True;307284;;;;;;;;
2610806;Pedra;PE;26;Nordeste;AGRESTE PERNAMBUCANO;VALE DO IPANEMA;-8.497;-36.941;True;20132;10089;9993;11786;5740;6001;8346;4349;3992
2610905;Pesqueira;PE;26;Nordeste;AGRESTE PERNAMBUCANO;VALE DO IPOJUCA;-8.358;-36.696;True;61337;29050;30893;43848;20178;22584;17489;8872;8309
2611002;Petrolândia;PE;26;Nordeste;SAO FRANCISCO PERNAMBUCANO;ITAPARICA;-9.069;-38.303;True;30597;14955;15564;21393;10189;11187;9204;4766;4377
2611101;Petrolina;PE;26;Nordeste;SAO FRANCISCO PERNAMBUCANO;PETROLINA;-9.393;-40.508;True;268339;;;;;;;;
2611200;Poção;PE;26;Nordeste;AGRESTE PERNAMBUCANO;VALE DO IPOJUCA;-8.186;-36.705;True;11135;5298;5710;6815;3103;3621;4320;2195;2089
2611309;Pombos;PE;26;Nordeste;MATA PERNAMBUCANA;VITORIA DE SANTO ANTAO;-8.141;-35.396;True;21810;10614;10890;14379;6815;7408;7431;3799;3482
2611408;Primavera;PE;26;Nordeste;MATA PERNAMBUCANA;MATA MERIDIONAL PERNAMBUCANA;-8.331;-35.354;True;11853;5949;5725;7757;3862;3870;4096;2087;1855
2611507;Quipapá;PE;26;Nordeste;MATA PERNAMBUCANA;MATA MERIDIONAL PERNAMBUCANA;-8.828;-36.012;True;24197;12132;11938;12172;5918;6235;12025;6214;5703
2611533;Quixaba;PE;26;Nordeste;SERTAO PERNAMBUCANO;PAJEU;-7.72;-37.848;True;6875;3430;3445;2458;1211;1247;4417;2219;2198
2611606;Recife;PE;26;Nordeste;METROPOLITANA DE RECIFE;RECIFE;-8.054;-34.881;True;1533580;;;;;;;;
2611705;Riacho das Almas;PE;26;Nordeste;AGRESTE PERNAMBUCANO;VALE DO IPOJUCA;-8.134;-35.856;True;18269;9057;9203;8129;3895;4232;10140;5162;4971
2611804;Ribeirão;PE;26;Nordeste;MATA PERNAMBUCANA;MATA MERIDIONAL PERNAMBUCANA;-8.514;-35.378;True;38755;18703;19970;30741;14503;16221;8014;4200;3749
2611903;Rio Formoso;PE;26;Nordeste;MATA PERNAMBUCANA;MATA MERIDIONAL PERNAMBUCANA;-8.664;-35.159;True;21024;10561;10419;12912;6279;6592;8112;4282;3827
2612000;Sairé;PE;26;Nordeste;AGRESTE PERNAMBUCANO;BREJO PERNAMBUCANO;-8.328;-35.706;True;13709;6882;6708;7609;3682;3847;6100;3200;2861
2612109;Salgadinho;PE;26;Nordeste;AGRESTE PERNAMBUCANO;MEDIO CAPIBARIBE;-7.936;-35.633;True;7770;3798;3811;2221;1034;1155;5549;2764;2656
2612208;Salgueiro;PE;26;Nordeste;SERTAO PERNAMBUCANO;SALGUEIRO;-8.067;-39.12;True;53167;25747;27272;41843;19824;21880;11324;5923;5392
2612307;Saloá;PE;26;Nordeste;AGRESTE PERNAMBUCANO;GARANHUNS;-8.976;-36.688;True;15027;7272;7737;6883;3160;3723;8144;4112;4014
2612406;Sanharó;PE;26;Nordeste;AGRESTE PERNAMBUCANO;VALE DO IPOJUCA;-8.361;-36.566;True;17627;8616;9011;10197;4804;5393;7430;3812;3618
2612455;Santa Cruz;PE;26;Nordeste;SERTAO PERNAMBUCANO;ARARIPINA;-8.24;-40.336;True;13644;6864;6780;4095;1923;2172;9549;4941;4608
2612471;Santa Cruz da Baixa Verde;PE;26;Nordeste;SERTAO PERNAMBUCANO;PAJEU;-7.821;-38.153;True;11610;5733;5869;4600;2164;2436;7010;3569;3433
2612505;Santa Cruz do Capibaribe;PE;26;Nordeste;AGRESTE PERNAMBUCANO;ALTO CAPIBARIBE;-7.957;-36.205;True;73680;35655;37952;71813;34639;37103;1867;1016;849
2612554;Santa Filomena;PE;26;Nordeste;SERTAO PERNAMBUCANO;ARARIPINA;-8.163;-40.616;True;13759;6883;6580;2339;1017;1084;11420;5866;5496
2612604;Santa Maria da Boa Vista;PE;26;Nordeste;SAO FRANCISCO PERNAMBUCANO;PETROLINA;-8.809;-39.825;True;39626;19760;19430;14231;6707;7413;25395;13053;12017
2612703;Santa Maria do Cambucá;PE;26;Nordeste;AGRESTE PERNAMBUCANO;ALTO CAPIBARIBE;-7.84;-35.902;True;12348;6145;6202;3002;1446;1556;9346;4699;4646
2612802;Santa Terezinha;PE;26;Nordeste;SERTAO PERNAMBUCANO;PAJEU;-7.378;-37.48;True;9934;4864;5070;5710;2685;3025;4224;2179;2045
2612901;São Benedito do Sul;PE;26;Nordeste;MATA PERNAMBUCANA;MATA MERIDIONAL PERNAMBUCANA;-8.808;-35.952;True;9790;4929;4860;5599;2716;2883;4191;2213;1977
2613008;São Bento do Una;PE;26;Nordeste;AGRESTE PERNAMBUCANO;VALE DO IPOJUCA;-8.523;-36.444;True;47230;23647;23576;24982;12045;12930;22248;11602;10646
2613107;São Caitano;PE;26;Nordeste;AGRESTE PERNAMBUCANO;VALE DO IPOJUCA;-8.326;-36.143;True;34769;17003;17757;25570;12256;13314;9199;4747;4443
2613206;São João;PE;26;Nordeste;AGRESTE PERNAMBUCANO;GARANHUNS;-8.876;-36.367;True;21011;10248;10466;8766;4121;4530;12245;6127;5936
2613305;São Joaquim do Monte;PE;26;Nordeste;AGRESTE PERNAMBUCANO;BREJO PERNAMBUCANO;-8.432;-35.804;True;20869;10299;10339;13470;6469;6829;7399;3830;3510
2613404;São José da Coroa Grande;PE;26;Nordeste;MATA PERNAMBUCANA;MATA MERIDIONAL PERNAMBUCANA;-8.898;-35.148;True;17090;8412;8660;12280;5951;6311;4810;2461;2349
2613503;São José do Belmonte;PE;26;Nordeste;SERTAO PERNAMBUCANO;SALGUEIRO;-7.861;-38.76;True;32704;16302;16386;15275;7342;7921;17429;8960;8465
2613602;São José do Egito;PE;26;Nordeste;SERTAO PERNAMBUCANO;PAJEU;-7.479;-37.274;True;30469;14896;15534;19617;9276;10332;10852;5620;5202
2613701;São Lourenço da Mata;PE;26;Nordeste;METROPOLITANA DE RECIFE;RECIFE;-8.002;-35.018;True;95304;45695;48274;89725;42643;45750;5579;3052;2524
2613800;São Vicente Ferrer;PE;26;Nordeste;AGRESTE PERNAMBUCANO;MEDIO CAPIBARIBE;-7.591;-35.491;True;16598;8238;8354;10773;5257;5514;5825;2981;2840
2613909;Serra Talhada;PE;26;Nordeste;SERTAO PERNAMBUCANO;PAJEU;-7.986;-38.296;True;76198;36436;39728;56667;26259;30376;19531;10177;9352
2614006;Serrita;PE;26;Nordeste;SERTAO PERNAMBUCANO;SALGUEIRO;-7.933;-39.296;True;18228;9147;9068;5812;2808;3004;12416;6339;6064
2614105;Sertânia;PE;26;Nordeste;SERTAO PERNAMBUCANO;SERTAO DO MOXOTO;-8.074;-37.264;True;34069;16289;16581;17056;7809;8670;17013;8480;7911
2614204;Sirinhaém;PE;26;Nordeste;MATA PERNAMBUCANA;MATA MERIDIONAL PERNAMBUCANA;-8.591;-35.116;True;36414;18221;18040;19299;9423;9785;17115;8798;8255
2614303;Moreilândia;PE;26;Nordeste;SERTAO PERNAMBUCANO;ARARIPINA;-7.631;-39.551;True;10424;5207;5213;6267;3039;3224;4157;2168;1989
2614402;Solidão;PE;26;Nordeste;SERTAO PERNAMBUCANO;PAJEU;-7.6;-37.652;True;5837;2940;2888;1673;791;882;4164;2149;2006
2614501;Surubim;PE;26;Nordeste;AGRESTE PERNAMBUCANO;ALTO CAPIBARIBE;-7.832;-35.756;True;53934;25851;27967;39626;18657;20873;14308;7194;7094
2614600;Tabira;PE;26;Nordeste;SERTAO PERNAMBUCANO;PAJEU;-7.591;-37.539;True;25836;12580;12891;18384;8863;9483;7452;3717;3408
2614709;Tacaimbó;PE;26;Nordeste;AGRESTE PERNAMBUCANO;VALE DO IPOJUCA;-8.316;-36.293;True;12095;5947;6123;6576;3150;3414;5519;2797;2709
2614808;Tacaratu;PE;26;Nordeste;SAO FRANCISCO PERNAMBUCANO;ITAPARICA;-9.106;-38.15;True;20552;10382;10128;8990;4388;4588;11562;5994;5540
2614857;Tamandaré;PE;26;Nordeste;MATA PERNAMBUCANA;MATA MERIDIONAL PERNAMBUCANA;-8.76;-35.105;True;18137;9031;9102;12550;6072;6474;5587;2959;2628
2615003;Taquaritinga do Norte;PE;26;Nordeste;AGRESTE PERNAMBUCANO;ALTO CAPIBARIBE;-7.903;-36.044;True;21447;10422;10697;15404;7320;7953;6043;3102;2744
2615102;Terezinha;PE;26;Nordeste;AGRESTE PERNAMBUCANO;GARANHUNS;-9.056;-36.623;True;6496;3147;3329;2381;1102;1266;4115;2045;2063
2615201;Terra Nova;PE;26;Nordeste;SAO FRANCISCO PERNAMBUCANO;PETROLINA;-8.23;-39.376;True;9057;4595;4462;4789;2394;2395;4268;2201;2067
2615300;Timbaúba;PE;26;Nordeste;MATA PERNAMBUCANA;MATA SETENTRIONAL PERNAMBUCANA;-7.505;-35.318;True;51529;24707;26493;43105;20468;22348;8424;4239;4145
2615409;Toritama;PE;26;Nordeste;AGRESTE PERNAMBUCANO;ALTO CAPIBARIBE;-7.999;-36.051;True;29897;14702;15195;28780;14175;14605;1117;527;590
2615508;Tracunhaém;PE;26;Nordeste;MATA PERNAMBUCANA;MATA SETENTRIONAL PERNAMBUCANA;-7.805;-35.24;True;12734;6319;6414;10698;5233;5465;2036;1086;949
2615607;Trindade;PE;26;Nordeste;SERTAO PERNAMBUCANO;ARARIPINA;-7.762;-40.268;True;24642;12073;12427;19717;9592;10099;4925;2481;2328
2615706;Triunfo;PE;26;Nordeste;SERTAO PERNAMBUCANO;PAJEU;-7.838;-38.102;True;15225;7295;7903;7229;3266;3947;7996;4029;3956
2615805;Tupanatinga;PE;26;Nordeste;AGRESTE PERNAMBUCANO;VALE DO IPANEMA;-8.753;-37.34;True;18913;9273;9626;6917;3254;3657;11996;6019;5969
2615904;Tuparetama;PE;26;Nordeste;SERTAO PERNAMBUCANO;PAJEU;-7.602;-37.311;True;8257;4065;4190;6371;3076;3293;1886;989;897
2616001;Venturosa;PE;26;Nordeste;AGRESTE PERNAMBUCANO;VALE DO IPANEMA;-8.575;-36.874;True;15576;7551;7860;9551;4533;5012;6025;3018;2848
2616100;Verdejante;PE;26;Nordeste;SERTAO PERNAMBUCANO;SALGUEIRO;-7.926;-38.972;True;9567;4367;4583;2461;1148;1313;7106;3219;3270
2616183;Vertente do Lério;PE;26;Nordeste;AGRESTE PERNAMBUCANO;ALTO CAPIBARIBE;-7.771;-35.85;True;7500;3661;3793;1680;827;853;5820;2834;2940
2616209;Vertentes;PE;26;Nordeste;AGRESTE PERNAMBUCANO;ALTO CAPIBARIBE;-7.903;-35.988;True;17021;8395;8602;8253;3959;4277;8768;4436;4325
2616308;Vicência;PE;26;Nordeste;MATA PERNAMBUCANA;MATA SETENTRIONAL PERNAMBUCANA;-7.657;-35.327;True;27360;13525;13710;11144;5244;5831;16216;8281;7879
2616407;Vitória de Santo Antão;PE;26;Nordeste;MATA PERNAMBUCANA;VITORIA DE SANTO ANTAO;-8.118;-35.291;True;121233;57987;62206;103928;49026;54150;17305;8961;8056
2616506;Xexéu;PE;26;Nordeste;MATA PERNAMBUCANA;MATA MERIDIONAL PERNAMBUCANA;-8.802;-35.627;True;14224;7070;7141;9069;4436;4628;5155;2634;2513
2700102;Água Branca;AL;27;Nordeste;SERTAO ALAGOANO;SERRANA DO SERTAO ALAGOANO;-9.262;-37.938;True;19316;9654;9610;5365;2608;2753;13951;7046;6857
2700201;Anadia;AL;27;Nordeste;LESTE ALAGOANO;SAO MIGUEL DOS CAMPOS;-9.684;-36.304;True;17274;8832;8437;9109;4644;4465;8165;4188;3972
2700300;Arapiraca;AL;27;Nordeste;AGRESTE ALAGOANO;ARAPIRACA;-9.752;-36.661;True;202398;96445;105026;163708;77196;85752;38690;19249;19274
2700409;Atalaia;AL;27;Nordeste;LESTE ALAGOANO;MATA ALAGOANA;-9.502;-36.023;True;50323;25649;24672;24794;12164;12630;25529;13485;12042
2700508;Barra de Santo Antônio;AL;27;Nordeste;LESTE ALAGOANO;MACEIO;-9.405;-35.507;True;13731;6933;6767;12362;6182;6152;1369;751;615
2700607;Barra de São Miguel;AL;27;Nordeste;LESTE ALAGOANO;MACEIO;-9.84;-35.908;True;7247;3574;3578;6122;3009;3046;1125;565;532
2700706;Batalha;AL;27;Nordeste;SERTAO ALAGOANO;BATALHA;-9.678;-37.125;True;16247;8017;8230;11347;5442;5905;4900;2575;2325
2700805;Belém;AL;27;Nordeste;AGRESTE ALAGOANO;PALMEIRA DOS INDIOS;-9.571;-36.492;True;5031;2462;2569;1864;893;971;3167;1569;1598
2700904;Belo Monte;AL;27;Nordeste;SERTAO ALAGOANO;BATALHA;-9.828;-37.28;True;7238;3647;3584;1197;602;595;6041;3045;2989
2701001;Boca da Mata;AL;27;Nordeste;LESTE ALAGOANO;SAO MIGUEL DOS CAMPOS;-9.641;-36.22;True;25145;12566;12567;16495;8106;8389;8650;4460;4178
2701100;Branquinha;AL;27;Nordeste;LESTE ALAGOANO;MATA ALAGOANA;-9.246;-36.015;True;11796;5960;5682;6830;3274;3402;4966;2686;2280
2701209;Cacimbinhas;AL;27;Nordeste;AGRESTE ALAGOANO;PALMEIRA DOS INDIOS;-9.4;-36.99;True;9843;4859;4982;5216;2537;2677;4627;2322;2305
2701308;Cajueiro;AL;27;Nordeste;LESTE ALAGOANO;MATA ALAGOANA;-9.397;-36.154;True;20076;9917;10156;16024;7810;8211;4052;2107;1945
2701357;Campestre;AL;27;Nordeste;LESTE ALAGOANO;MATA ALAGOANA;-8.846;-35.568;True;6016;2993;3015;5102;2515;2579;914;478;436
2701407;Campo Alegre;AL;27;Nordeste;LESTE ALAGOANO;SAO MIGUEL DOS CAMPOS;-9.782;-36.351;True;45307;22906;22321;18594;9234;9336;26713;13672;12985
2701506;Campo Grande;AL;27;Nordeste;AGRESTE ALAGOANO;ARAPIRACA;-9.958;-36.792;True;9563;4679;4782;3953;1844;2028;5610;2835;2754
2701605;Canapi;AL;27;Nordeste;SERTAO ALAGOANO;SERRANA DO SERTAO ALAGOANO;-9.127;-37.605;True;17793;8932;8861;5081;2408;2673;12712;6524;6188
2701704;Capela;AL;27;Nordeste;LESTE ALAGOANO;MATA ALAGOANA;-9.408;-36.074;True;17034;8415;8614;12733;6120;6610;4301;2295;2004
2701803;Carneiros;AL;27;Nordeste;SERTAO ALAGOANO;SANTANA DO IPANEMA;-9.483;-37.377;True;8044;4009;4035;4428;2137;2291;3616;1872;1744
2701902;Chã Preta;AL;27;Nordeste;LESTE ALAGOANO;SERRANA DOS QUILOMBOS;-9.255;-36.296;True;6953;3541;3412;3685;1801;1884;3268;1740;1528
2702009;Coité do Nóia;AL;27;Nordeste;AGRESTE ALAGOANO;ARAPIRACA;-9.632;-36.579;True;10916;5472;5444;3639;1741;1898;7277;3731;3546
2702108;Colônia Leopoldina;AL;27;Nordeste;LESTE ALAGOANO;MATA ALAGOANA;-8.909;-35.725;True;19363;9796;9526;14454;7133;7280;4909;2663;2246
2702207;Coqueiro Seco;AL;27;Nordeste;LESTE ALAGOANO;MACEIO;-9.638;-35.803;True;5336;2690;2646;4747;2386;2361;589;304;285
2702306;Coruripe;AL;27;Nordeste;LESTE ALAGOANO;SAO MIGUEL DOS CAMPOS;-10.126;-36.176;True;51027;25382;25442;42680;21114;21556;8347;4268;3886
2702355;Craíbas;AL;27;Nordeste;AGRESTE ALAGOANO;ARAPIRACA;-9.618;-36.768;True;22411;11089;11320;7075;3416;3659;15336;7673;7661
2702405;Delmiro Gouveia;AL;27;Nordeste;SERTAO ALAGOANO;ALAGOANA DO SERTAO DO SAO FRANCISCO;-9.386;-37.996;True;46599;22541;24041;33626;15993;17628;12973;6548;6413
2702504;Dois Riachos;AL;27;Nordeste;SERTAO ALAGOANO;SANTANA DO IPANEMA;-9.393;-37.101;True;10885;5445;5435;4826;2324;2502;6059;3121;2933
2702553;Estrela de Alagoas;AL;27;Nordeste;AGRESTE ALAGOANO;PALMEIRA DOS INDIOS;-9.39;-36.76;True;16694;8209;8482;3753;1764;1989;12941;6445;6493
2702603;Feira Grande;AL;27;Nordeste;AGRESTE ALAGOANO;ARAPIRACA;-9.9;-36.678;True;21180;10585;10595;3281;1552;1729;17899;9033;8866
2702702;Feliz Deserto;AL;27;Nordeste;LESTE ALAGOANO;PENEDO;-10.292;-36.306;True;4370;2165;2192;3288;1611;1672;1082;554;520
2702801;Flexeiras;AL;27;Nordeste;LESTE ALAGOANO;MATA ALAGOANA;-9.273;-35.715;True;11928;6085;5791;7630;3757;3850;4298;2328;1941
2702900;Girau do Ponciano;AL;27;Nordeste;AGRESTE ALAGOANO;ARAPIRACA;-9.884;-36.829;True;35162;17502;17649;10511;5101;5410;24651;12401;12239
2703007;Ibateguara;AL;27;Nordeste;LESTE ALAGOANO;SERRANA DOS QUILOMBOS;-8.973;-35.939;True;15359;7598;7448;8805;4285;4510;6554;3313;2938
2703106;Igaci;AL;27;Nordeste;AGRESTE ALAGOANO;PALMEIRA DOS INDIOS;-9.537;-36.634;True;25140;12325;12803;5953;2792;3161;19187;9533;9642
2703205;Igreja Nova;AL;27;Nordeste;LESTE ALAGOANO;PENEDO;-10.125;-36.662;True;22925;11533;11261;4837;2391;2446;18088;9142;8815
2703304;Inhapi;AL;27;Nordeste;SERTAO ALAGOANO;SERRANA DO SERTAO ALAGOANO;-9.219;-37.754;True;17637;8626;8906;6337;2960;3377;11300;5666;5529
2703403;Jacaré dos Homens;AL;27;Nordeste;SERTAO ALAGOANO;BATALHA;-9.636;-37.205;True;5724;2770;2852;2966;1419;1547;2758;1351;1305
2703502;Jacuípe;AL;27;Nordeste;LESTE ALAGOANO;MATA ALAGOANA;-8.842;-35.46;True;6883;3576;3307;3909;1942;1967;2974;1634;1340
2703601;Japaratinga;AL;27;Nordeste;LESTE ALAGOANO;LITORAL NORTE ALAGOANO;-9.088;-35.258;True;7463;3776;3687;3051;1520;1531;4412;2256;2156
2703700;Jaramataia;AL;27;Nordeste;SERTAO ALAGOANO;BATALHA;-9.659;-37.002;True;5939;3011;2859;3317;1639;1622;2622;1372;1237
2703759;Jequiá da Praia;AL;27;Nordeste;LESTE ALAGOANO;LITORAL NORTE ALAGOANO;-10.012;-36.021;True;11430;5840;5570;2539;1248;1291;8891;4592;4279
2703809;Joaquim Gomes;AL;27;Nordeste;LESTE ALAGOANO;MATA ALAGOANA;-9.133;-35.748;True;21735;11094;10620;14089;7007;7069;7646;4087;3551
2703908;Jundiá;AL;27;Nordeste;LESTE ALAGOANO;MATA ALAGOANA;-8.935;-35.574;True;4569;2378;2191;2914;1463;1451;1655;915;740
2704005;Junqueiro;AL;27;Nordeste;LESTE ALAGOANO;SAO MIGUEL DOS CAMPOS;-9.925;-36.476;True;24460;12077;12362;7578;3611;3964;16882;8466;8398
2704104;Lagoa da Canoa;AL;27;Nordeste;AGRESTE ALAGOANO;ARAPIRACA;-9.83;-36.738;True;17889;8848;9041;8883;4313;4570;9006;4535;4471
2704203;Limoeiro de Anadia;AL;27;Nordeste;AGRESTE ALAGOANO;ARAPIRACA;-9.741;-36.503;True;25484;12766;12713;2146;1020;1126;23338;11746;11587
2704302;Maceió;AL;27;Nordeste;LESTE ALAGOANO;MACEIO;-9.666;-35.735;True;896965;415411;468831;896067;414972;468461;898;439;370
2704401;Major Isidoro;AL;27;Nordeste;SERTAO ALAGOANO;BATALHA;-9.532;-36.985;True;18811;9267;9541;9349;4449;4897;9462;4818;4644
2704500;Maragogi;AL;27;Nordeste;LESTE ALAGOANO;LITORAL NORTE ALAGOANO;-9.012;-35.222;True;25726;13181;12410;17112;8437;8588;8614;4744;3822
2704609;Maravilha;AL;27;Nordeste;SERTAO ALAGOANO;SANTANA DO IPANEMA;-9.236;-37.35;True;10203;5205;4998;4665;2325;2340;5538;2880;2658
2704708;Marechal Deodoro;AL;27;Nordeste;LESTE ALAGOANO;MACEIO;-9.71;-35.895;True;45141;22391;22716;37578;18575;18983;7563;3816;3733
2704807;Maribondo;AL;27;Nordeste;AGRESTE ALAGOANO;PALMEIRA DOS INDIOS;-9.577;-36.305;True;13865;6744;7120;9896;4742;5154;3969;2002;1966
2704906;Mar Vermelho;AL;27;Nordeste;AGRESTE ALAGOANO;PALMEIRA DOS INDIOS;-9.448;-36.388;True;4014;2036;1978;1667;823;844;2347;1213;1134
2705002;Mata Grande;AL;27;Nordeste;SERTAO ALAGOANO;SERRANA DO SERTAO ALAGOANO;-9.118;-37.734;True;24599;12265;12202;5240;2479;2748;19359;9786;9454
2705101;Matriz de Camaragibe;AL;27;Nordeste;LESTE ALAGOANO;MATA ALAGOANA;-9.152;-35.533;True;24656;12262;12394;20373;9948;10425;4283;2314;1969
2705200;Messias;AL;27;Nordeste;LESTE ALAGOANO;MATA ALAGOANA;-9.383;-35.842;True;15072;7436;7634;13612;6684;6928;1460;752;706
2705309;Minador do Negrão;AL;27;Nordeste;AGRESTE ALAGOANO;PALMEIRA DOS INDIOS;-9.305;-36.865;True;5160;2568;2592;2078;1000;1078;3082;1568;1514
2705408;Monteirópolis;AL;27;Nordeste;SERTAO ALAGOANO;BATALHA;-9.603;-37.248;True;7090;3503;3587;2789;1367;1422;4301;2136;2165
2705507;Murici;AL;27;Nordeste;LESTE ALAGOANO;MATA ALAGOANA;-9.307;-35.943;True;25964;12925;12982;20839;10200;10588;5125;2725;2394
2705606;Novo Lino;AL;27;Nordeste;LESTE ALAGOANO;MATA ALAGOANA;-8.915;-35.647;True;11903;6085;5799;6978;3466;3495;4925;2619;2304
2705705;Olho D'Água das Flores;AL;27;Nordeste;SERTAO ALAGOANO;BATALHA;-9.536;-37.294;True;19885;9517;10352;13533;6357;7173;6352;3160;3179
2705804;Olho D'Água do Casado;AL;27;Nordeste;SERTAO ALAGOANO;ALAGOANA DO SERTAO DO SAO FRANCISCO;-9.501;-37.832;True;8139;4093;4046;4213;2068;2145;3926;2025;1901
2705903;Olho D'Água Grande;AL;27;Nordeste;AGRESTE ALAGOANO;TRAIPU;-10.058;-36.817;True;4817;2400;2375;1205;596;609;3612;1804;1766
2706000;Olivença;AL;27;Nordeste;SERTAO ALAGOANO;BATALHA;-9.519;-37.191;True;10522;5353;5169;2538;1229;1309;7984;4124;3860
2706109;Ouro Branco;AL;27;Nordeste;SERTAO ALAGOANO;SANTANA DO IPANEMA;-9.167;-37.357;True;11049;5559;5482;6634;3212;3422;4415;2347;2060
2706208;Palestina;AL;27;Nordeste;SERTAO ALAGOANO;SANTANA DO IPANEMA;-9.672;-37.329;True;4878;2391;2487;3179;1555;1624;1699;836;863
2706307;Palmeira dos Índios;AL;27;Nordeste;AGRESTE ALAGOANO;PALMEIRA DOS INDIOS;-9.407;-36.628;True;70151;33690;36408;50052;23568;26482;20099;10122;9926
2706406;Pão de Açúcar;AL;27;Nordeste;SERTAO ALAGOANO;SANTANA DO IPANEMA;-9.748;-37.437;True;23855;11796;12055;10455;4971;5484;13400;6825;6571
2706422;Pariconha;AL;27;Nordeste;SERTAO ALAGOANO;SERRANA DO SERTAO ALAGOANO;-9.254;-38.006;True;10209;5167;5037;2708;1335;1373;7501;3832;3664
2706448;Paripueira;AL;27;Nordeste;LESTE ALAGOANO;MACEIO;-9.465;-35.552;True;9725;4729;4936;8438;4039;4377;1287;690;559
2706505;Passo de Camaragibe;AL;27;Nordeste;LESTE ALAGOANO;LITORAL NORTE ALAGOANO;-9.238;-35.493;True;13826;7058;6768;6893;3455;3438;6933;3603;3330
2706604;Paulo Jacinto;AL;27;Nordeste;AGRESTE ALAGOANO;PALMEIRA DOS INDIOS;-9.366;-36.37;True;7534;3714;3820;4998;2430;2568;2536;1284;1252
2706703;Penedo;AL;27;Nordeste;LESTE ALAGOANO;PENEDO;-10.29;-36.586;True;59020;28710;30075;43880;21033;22784;15140;7677;7291
2706802;Piaçabuçu;AL;27;Nordeste;LESTE ALAGOANO;PENEDO;-10.406;-36.434;True;17466;8573;8514;10394;5093;5265;7072;3480;3249
2706901;Pilar;AL;27;Nordeste;LESTE ALAGOANO;MACEIO;-9.597;-35.957;True;31627;15408;16160;30077;14616;15402;1550;792;758
2707008;Pindoba;AL;27;Nordeste;LESTE ALAGOANO;SERRANA DOS QUILOMBOS;-9.475;-36.29;True;3126;1586;1517;1651;829;811;1475;757;706
2707107;Piranhas;AL;27;Nordeste;SERTAO ALAGOANO;ALAGOANA DO SERTAO DO SAO FRANCISCO;-9.624;-37.757;True;23910;11813;12095;13476;6496;6980;10434;5317;5115
2707206;Poço das Trincheiras;AL;27;Nordeste;SERTAO ALAGOANO;SANTANA DO IPANEMA;-9.313;-37.286;True;12205;6255;5939;1921;951;959;10284;5304;4980
2707305;Porto Calvo;AL;27;Nordeste;LESTE ALAGOANO;MATA ALAGOANA;-9.045;-35.398;True;25129;12603;12519;18345;9022;9323;6784;3581;3196
2707404;Porto de Pedras;AL;27;Nordeste;LESTE ALAGOANO;LITORAL NORTE ALAGOANO;-9.158;-35.295;True;10321;5297;5021;5441;2691;2750;4880;2606;2271
2707503;Porto Real do Colégio;AL;27;Nordeste;LESTE ALAGOANO;PENEDO;-10.186;-36.84;True;17947;8890;8994;6073;2911;3162;11874;5979;5832
2707602;Quebrangulo;AL;27;Nordeste;AGRESTE ALAGOANO;PALMEIRA DOS INDIOS;-9.319;-36.471;True;11289;5651;5625;6564;3186;3375;4725;2465;2250
2707701;Rio Largo;AL;27;Nordeste;LESTE ALAGOANO;MACEIO;-9.478;-35.853;True;65432;31444;33135;53542;25629;27316;11890;5815;5819
2707800;Roteiro;AL;27;Nordeste;LESTE ALAGOANO;SAO MIGUEL DOS CAMPOS;-9.833;-35.978;True;6692;3361;3326;5749;2893;2851;943;468;475
2707909;Santa Luzia do Norte;AL;27;Nordeste;LESTE ALAGOANO;MACEIO;-9.603;-35.822;True;7248;3546;3658;6396;3103;3249;852;443;409
2708006;Santana do Ipanema;AL;27;Nordeste;SERTAO ALAGOANO;SANTANA DO IPANEMA;-9.378;-37.245;True;42296;20455;21756;25465;11900;13562;16831;8555;8194
2708105;Santana do Mundaú;AL;27;Nordeste;LESTE ALAGOANO;SERRANA DOS QUILOMBOS;-9.168;-36.222;True;11663;5888;5768;6197;3013;3180;5466;2875;2588
2708204;São Brás;AL;27;Nordeste;AGRESTE ALAGOANO;TRAIPU;-10.128;-36.901;True;6820;3388;3331;3180;1596;1571;3640;1792;1760
2708303;São José da Laje;AL;27;Nordeste;LESTE ALAGOANO;SERRANA DOS QUILOMBOS;-9.01;-36.058;True;22282;11109;11173;14273;6898;7375;8009;4211;3798
2708402;São José da Tapera;AL;27;Nordeste;SERTAO ALAGOANO;SANTANA DO IPANEMA;-9.558;-37.381;True;30129;15016;15044;10984;5239;5698;19145;9777;9346
2708501;São Luís do Quitunde;AL;27;Nordeste;LESTE ALAGOANO;MATA ALAGOANA;-9.318;-35.561;True;31647;15831;15461;19532;9597;9838;12115;6234;5623
2708600;São Miguel dos Campos;AL;27;Nordeste;LESTE ALAGOANO;SAO MIGUEL DOS CAMPOS;-9.781;-36.094;True;51473;25155;26292;46708;22710;23982;4765;2445;2310
2708709;São Miguel dos Milagres;AL;27;Nordeste;LESTE ALAGOANO;LITORAL NORTE ALAGOANO;-9.266;-35.373;True;7219;3598;3621;2287;1129;1158;4932;2469;2463
2708808;São Sebastião;AL;27;Nordeste;AGRESTE ALAGOANO;ARAPIRACA;-9.934;-36.554;True;31002;15379;15452;11413;5608;5779;19589;9771;9673
2708907;Satuba;AL;27;Nordeste;LESTE ALAGOANO;MACEIO;-9.563;-35.824;True;14154;6944;7210;11029;5336;5693;3125;1608;1517
2708956;Senador Rui Palmeira;AL;27;Nordeste;SERTAO ALAGOANO;SANTANA DO IPANEMA;-9.354;-37.507;True;12641;6170;6386;4095;1879;2182;8546;4291;4204
2709004;Tanque D'Arca;AL;27;Nordeste;AGRESTE ALAGOANO;PALMEIRA DOS INDIOS;-9.532;-36.433;True;5695;2830;2865;2032;961;1071;3663;1869;1794
2709103;Taquarana;AL;27;Nordeste;AGRESTE ALAGOANO;ARAPIRACA;-9.645;-36.497;True;18157;8929;9227;4107;1900;2207;14050;7029;7020
2709152;Teotônio Vilela;AL;27;Nordeste;LESTE ALAGOANO;SAO MIGUEL DOS CAMPOS;-9.905;-36.353;True;40291;19968;20091;32988;16201;16582;7303;3767;3509
2709202;Traipu;AL;27;Nordeste;AGRESTE ALAGOANO;TRAIPU;-9.971;-37.003;True;24911;12401;12092;7863;3824;4014;17048;8577;8078
2709301;União dos Palmares;AL;27;Nordeste;LESTE ALAGOANO;SERRANA DOS QUILOMBOS;-9.163;-36.032;True;60619;29478;31076;44513;21049;23412;16106;8429;7664
2709400;Viçosa;AL;27;Nordeste;LESTE ALAGOANO;SERRANA DOS QUILOMBOS;-9.371;-36.241;True;26050;12838;13141;18907;9139;9758;7143;3699;3383
2800100;Amparo de São Francisco;SE;28;Nordeste;LESTE SERGIPANO;PROPRIA;-10.134;-36.93;True;2197;1114;1078;1319;651;668;878;463;410
2800209;Aquidabã;SE;28;Nordeste;AGRESTE SERGIPANO;NOSSA SENHORA DAS DORES;-10.281;-37.019;True;19185;9386;9717;10467;4996;5455;8718;4390;4262
2800308;Aracaju;SE;28;Nordeste;LESTE SERGIPANO;ARACAJU;-10.911;-37.072;True;520303;235358;270409;520303;235358;270409;;;
2800407;Arauá;SE;28;Nordeste;LESTE SERGIPANO;BOQUIM;-11.262;-37.62;True;11633;5887;5695;4441;2201;2240;7192;3686;3455
2800506;Areia Branca;SE;28;Nordeste;AGRESTE SERGIPANO;AGRESTE DE ITABAIANA;-10.758;-37.315;True;16072;8192;7823;7514;3872;3618;8558;4320;4205
2800605;Barra dos Coqueiros;SE;28;Nordeste;LESTE SERGIPANO;ARACAJU;-10.909;-37.039;True;19218;9385;9810;16135;7818;8301;3083;1567;1509
2800670;Boquim;SE;28;Nordeste;LESTE SERGIPANO;BOQUIM;-11.147;-37.621;True;24472;12030;12398;14979;7149;7792;9493;4881;4606
2800704;Brejo Grande;SE;28;Nordeste;LESTE SERGIPANO;PROPRIA;-10.429;-36.466;True;7760;3955;3753;4089;2030;2043;3671;1925;1710
2801009;Campo do Brito;SE;28;Nordeste;AGRESTE SERGIPANO;AGRESTE DE ITABAIANA;-10.733;-37.493;True;16122;7851;8053;7549;3615;3896;8573;4236;4157
2801108;Canhoba;SE;28;Nordeste;LESTE SERGIPANO;PROPRIA;-10.138;-36.985;True;3910;2044;1850;1497;758;739;2413;1286;1111
2801207;Canindé de São Francisco;SE;28;Nordeste;SERTAO SERGIPANO;SERGIPANA DO SERTAO DO SAO FRANCISCO;-9.642;-37.788;True;21806;10878;10870;11970;5802;6160;9836;5076;4710
2801306;Capela;SE;28;Nordeste;LESTE SERGIPANO;COTINGUIBA;-10.503;-37.053;True;27913;13737;13961;16536;7918;8475;11377;5819;5486
2801405;Carira;SE;28;Nordeste;SERTAO SERGIPANO;CARIRA;-10.361;-37.701;True;18965;9381;9467;10230;4906;5299;8735;4475;4168
2801504;Carmópolis;SE;28;Nordeste;LESTE SERGIPANO;BAIXO COTINGUIBA;-10.648;-36.989;True;11911;5493;5607;9716;4431;4549;2195;1062;1058
2801603;Cedro de São João;SE;28;Nordeste;LESTE SERGIPANO;PROPRIA;-10.252;-36.884;True;5358;2686;2665;4759;2376;2383;599;310;282
2801702;Cristinápolis;SE;28;Nordeste;LESTE SERGIPANO;BOQUIM;-11.476;-37.755;True;15867;8008;7855;7866;3828;4034;8001;4180;3821
2801900;Cumbe;SE;28;Nordeste;AGRESTE SERGIPANO;NOSSA SENHORA DAS DORES;-10.355;-37.183;True;3741;1887;1854;2199;1083;1116;1542;804;738
2802007;Divina Pastora;SE;28;Nordeste;LESTE SERGIPANO;COTINGUIBA;-10.689;-37.148;True;4198;2125;2065;2059;1001;1050;2139;1124;1015
2802106;Estância;SE;28;Nordeste;LESTE SERGIPANO;ESTANCIA;-11.268;-37.438;True;61368;30098;31241;51901;25078;26819;9467;5020;4422
2802205;Feira Nova;SE;28;Nordeste;SERTAO SERGIPANO;SERGIPANA DO SERTAO DO SAO FRANCISCO;-10.264;-37.313;True;5628;2841;2780;3680;1806;1874;1948;1035;906
2802304;Frei Paulo;SE;28;Nordeste;SERTAO SERGIPANO;CARIRA;-10.549;-37.534;True;12589;6204;6373;7057;3388;3669;5532;2816;2704
2802403;Gararu;SE;28;Nordeste;SERTAO SERGIPANO;SERGIPANA DO SERTAO DO SAO FRANCISCO;-9.968;-37.083;True;11606;5942;5664;2800;1356;1444;8806;4586;4220
2802502;General Maynard;SE;28;Nordeste;LESTE SERGIPANO;BAIXO COTINGUIBA;-10.689;-36.984;True;2773;1366;1381;1731;848;883;1042;518;498
2802601;Gracho Cardoso;SE;28;Nordeste;SERTAO SERGIPANO;SERGIPANA DO SERTAO DO SAO FRANCISCO;-10.227;-37.198;True;5554;2828;2609;2587;1274;1286;2967;1554;1323
2802700;Ilha das Flores;SE;28;Nordeste;LESTE SERGIPANO;PROPRIA;-10.436;-36.54;True;8598;4272;4258;4343;2151;2155;4255;2121;2103
2802809;Indiaroba;SE;28;Nordeste;LESTE SERGIPANO;ESTANCIA;-11.519;-37.512;True;17089;8819;8256;5299;2553;2743;11790;6266;5513
2802908;Itabaiana;SE;28;Nordeste;AGRESTE SERGIPANO;AGRESTE DE ITABAIANA;-10.685;-37.425;True;83161;39993;41917;62777;29655;32249;20384;10338;9668
2803005;Itabaianinha;SE;28;Nordeste;LESTE SERGIPANO;BOQUIM;-11.274;-37.79;True;37431;18738;18670;18032;8726;9291;19399;10012;9379
2803104;Itabi;SE;28;Nordeste;SERTAO SERGIPANO;SERGIPANA DO SERTAO DO SAO FRANCISCO;-10.126;-37.103;True;4736;2353;2376;2483;1196;1280;2253;1157;1096
2803203;Itaporanga D'Ajuda;SE;28;Nordeste;LESTE SERGIPANO;ESTANCIA;-10.998;-37.311;True;28131;13991;14001;9272;4397;4858;18859;9594;9143
2803302;Japaratuba;SE;28;Nordeste;LESTE SERGIPANO;JAPARATUBA;-10.593;-36.94;True;15450;7737;7594;7375;3600;3742;8075;4137;3852
2803401;Japoatã;SE;28;Nordeste;LESTE SERGIPANO;JAPARATUBA;-10.347;-36.801;True;13539;6789;6618;3970;1945;1974;9569;4844;4644
2803500;Lagarto;SE;28;Nordeste;AGRESTE SERGIPANO;AGRESTE DE LAGARTO;-10.917;-37.65;True;88980;43658;44955;45104;21379;23517;43876;22279;21438
2803609;Laranjeiras;SE;28;Nordeste;LESTE SERGIPANO;BAIXO COTINGUIBA;-10.806;-37.17;True;23923;11710;12014;21870;10678;10993;2053;1032;1021
2803708;Macambira;SE;28;Nordeste;AGRESTE SERGIPANO;AGRESTE DE ITABAIANA;-10.666;-37.541;True;6295;3121;3173;2393;1111;1282;3902;2010;1891
2803807;Malhada dos Bois;SE;28;Nordeste;AGRESTE SERGIPANO;NOSSA SENHORA DAS DORES;-10.349;-36.924;True;3658;1710;1691;1647;762;774;2011;948;917
2803906;Malhador;SE;28;Nordeste;AGRESTE SERGIPANO;AGRESTE DE ITABAIANA;-10.658;-37.305;True;11728;5929;5765;5341;2604;2737;6387;3325;3028
2804003;Maruim;SE;28;Nordeste;LESTE SERGIPANO;BAIXO COTINGUIBA;-10.738;-37.082;True;15150;7389;7698;11214;5416;5760;3936;1973;1938
2804102;Moita Bonita;SE;28;Nordeste;AGRESTE SERGIPANO;AGRESTE DE ITABAIANA;-10.578;-37.343;True;10910;5318;5305;4256;2080;2143;6654;3238;3162
2804201;Monte Alegre de Sergipe;SE;28;Nordeste;SERTAO SERGIPANO;SERGIPANA DO SERTAO DO SAO FRANCISCO;-10.027;-37.562;True;13199;6710;6447;7512;3692;3811;5687;3018;2636
2804300;Muribeca;SE;28;Nordeste;AGRESTE SERGIPANO;NOSSA SENHORA DAS DORES;-10.427;-36.959;True;7225;3606;3549;3154;1532;1622;4071;2074;1927
2804409;Neópolis;SE;28;Nordeste;LESTE SERGIPANO;PROPRIA;-10.32;-36.579;True;18909;9456;9408;10500;5122;5356;8409;4334;4052
2804458;Nossa Senhora Aparecida;SE;28;Nordeste;SERTAO SERGIPANO;CARIRA;-10.443;-37.489;True;8517;4326;4172;3085;1502;1583;5432;2824;2589
2804508;Nossa Senhora da Glória;SE;28;Nordeste;SERTAO SERGIPANO;SERGIPANA DO SERTAO DO SAO FRANCISCO;-10.218;-37.42;True;29546;14762;14728;18914;9273;9629;10632;5489;5099
2804607;Nossa Senhora das Dores;SE;28;Nordeste;AGRESTE SERGIPANO;NOSSA SENHORA DAS DORES;-10.492;-37.193;True;23800;11794;12006;15287;7396;7891;8513;4398;4115
2804706;Nossa Senhora de Lourdes;SE;28;Nordeste;LESTE SERGIPANO;PROPRIA;-10.079;-37.058;True;6280;3138;3038;3265;1574;1603;3015;1564;1435
2804805;Nossa Senhora do Socorro;SE;28;Nordeste;LESTE SERGIPANO;ARACAJU;-10.855;-37.126;True;148546;72147;75936;145001;70369;74252;3545;1778;1684
2804904;Pacatuba;SE;28;Nordeste;LESTE SERGIPANO;JAPARATUBA;-10.453;-36.651;True;12377;6301;6040;2634;1272;1362;9743;5029;4678
2805000;Pedra Mole;SE;28;Nordeste;SERTAO SERGIPANO;CARIRA;-10.617;-37.687;True;2774;1393;1369;1153;573;580;1621;820;789
2805109;Pedrinhas;SE;28;Nordeste;LESTE SERGIPANO;BOQUIM;-11.192;-37.674;True;8389;4153;4222;6157;3028;3115;2232;1125;1107
2805208;Pinhão;SE;28;Nordeste;SERTAO SERGIPANO;CARIRA;-10.567;-37.723;True;5590;2772;2805;3195;1526;1669;2395;1246;1136
2805307;Pirambu;SE;28;Nordeste;LESTE SERGIPANO;JAPARATUBA;-10.738;-36.856;True;8227;4123;4037;4642;2296;2346;3585;1827;1691
2805406;Poço Redondo;SE;28;Nordeste;SERTAO SERGIPANO;SERGIPANA DO SERTAO DO SAO FRANCISCO;-9.806;-37.685;True;28969;14825;14041;7255;3519;3736;21714;11306;10305
2805505;Poço Verde;SE;28;Nordeste;AGRESTE SERGIPANO;TOBIAS BARRETO;-10.708;-38.183;True;21083;10422;10616;11518;5493;5999;9565;4929;4617
2805604;Porto da Folha;SE;28;Nordeste;SERTAO SERGIPANO;SERGIPANA DO SERTAO DO SAO FRANCISCO;-9.917;-37.278;True;26520;13395;12792;9493;4717;4770;17027;8678;8022
2805703;Propriá;SE;28;Nordeste;LESTE SERGIPANO;PROPRIA;-10.211;-36.84;True;27629;13325;14214;23559;11275;12242;4070;2050;1972
2805802;Riachão do Dantas;SE;28;Nordeste;AGRESTE SERGIPANO;AGRESTE DE LAGARTO;-11.069;-37.725;True;19019;9619;9337;4406;2168;2224;14613;7451;7113
2805901;Riachuelo;SE;28;Nordeste;LESTE SERGIPANO;BAIXO COTINGUIBA;-10.728;-37.187;True;9087;4441;4580;7703;3729;3918;1384;712;662
2806008;Ribeirópolis;SE;28;Nordeste;SERTAO SERGIPANO;CARIRA;-10.539;-37.417;True;15676;7727;7906;10650;5100;5531;5026;2627;2375
2806107;Rosário do Catete;SE;28;Nordeste;LESTE SERGIPANO;BAIXO COTINGUIBA;-10.696;-37.031;True;8518;4018;4302;6652;3106;3413;1866;912;889
2806206;Salgado;SE;28;Nordeste;LESTE SERGIPANO;BOQUIM;-11.032;-37.475;True;18563;9294;9224;5565;2625;2932;12998;6669;6292
2806305;Santa Luzia do Itanhy;SE;28;Nordeste;LESTE SERGIPANO;ESTANCIA;-11.351;-37.448;True;13041;6682;6333;2846;1432;1414;10195;5250;4919
2806404;Santana do São Francisco;SE;28;Nordeste;LESTE SERGIPANO;PROPRIA;-10.291;-36.608;True;6596;3331;3265;4293;2140;2153;2303;1191;1112
2806503;Santa Rosa de Lima;SE;28;Nordeste;LESTE SERGIPANO;COTINGUIBA;-10.646;-37.194;True;3844;1904;1897;2155;1068;1076;1689;836;821
2806602;Santo Amaro das Brotas;SE;28;Nordeste;LESTE SERGIPANO;BAIXO COTINGUIBA;-10.789;-37.054;True;11652;5779;5850;8699;4217;4472;2953;1562;1378
2806701;São Cristóvão;SE;28;Nordeste;LESTE SERGIPANO;ARACAJU;-11.015;-37.206;True;71931;35078;36830;65348;31660;33665;6583;3418;3165
2806800;São Domingos;SE;28;Nordeste;AGRESTE SERGIPANO;AGRESTE DE ITABAIANA;-10.791;-37.568;True;10128;5037;5026;4815;2339;2473;5313;2698;2553
2806909;São Francisco;SE;28;Nordeste;LESTE SERGIPANO;JAPARATUBA;-10.333;-36.888;True;2874;1411;1342;2360;1160;1111;514;251;231
2807006;São Miguel do Aleixo;SE;28;Nordeste;AGRESTE SERGIPANO;NOSSA SENHORA DAS DORES;-10.388;-37.381;True;3670;1815;1855;1693;818;875;1977;997;980
2807105;Simão Dias;SE;28;Nordeste;AGRESTE SERGIPANO;TOBIAS BARRETO;-10.738;-37.811;True;37145;18092;18944;18817;8866;9893;18328;9226;9051
2807204;Siriri;SE;28;Nordeste;LESTE SERGIPANO;COTINGUIBA;-10.604;-37.113;True;7618;3807;3807;3226;1558;1668;4392;2249;2139
2807303;Telha;SE;28;Nordeste;LESTE SERGIPANO;PROPRIA;-10.208;-36.884;True;2852;1455;1397;1087;549;538;1765;906;859
2807402;Tobias Barreto;SE;28;Nordeste;AGRESTE SERGIPANO;TOBIAS BARRETO;-11.184;-37.998;True;47265;23221;23973;30871;14662;16154;16394;8559;7819
2807501;Tomar do Geru;SE;28;Nordeste;LESTE SERGIPANO;BOQUIM;-11.373;-37.841;True;12877;6577;6264;4547;2207;2325;8330;4370;3939
2807600;Umbaúba;SE;28;Nordeste;LESTE SERGIPANO;BOQUIM;-11.383;-37.658;True;20562;10167;10387;12104;5797;6304;8458;4370;4083
2900108;Abaíra;BA;29;Nordeste;CENTRO SUL BAIANO;SEABRA;-13.25;-41.664;True;8638;4240;4370;3360;1609;1751;5278;2631;2619
2900207;Abaré;BA;29;Nordeste;VALE SAO-FRANCISCANO DA BAHIA;PAULO AFONSO;-8.721;-39.115;True;17342;8576;8465;8306;3992;4240;9036;4584;4225
2900306;Acajutiba;BA;29;Nordeste;NORDESTE BAIANO;ALAGOINHAS;-11.662;-38.017;True;14628;7280;7348;12335;6106;6229;2293;1174;1119
2900355;Adustina;BA;29;Nordeste;NORDESTE BAIANO;RIBEIRA DO POMBAL;-10.533;-38.1;True;14824;7450;7354;4992;2375;2597;9832;5075;4757
2900405;Água Fria;BA;29;Nordeste;CENTRO NORTE BAIANO;FEIRA DE SANTANA;-11.867;-38.767;True;14810;7473;7337;5219;2491;2728;9591;4982;4609
2900504;Érico Cardoso;BA;29;Nordeste;CENTRO SUL BAIANO;LIVRAMENTO DO BRUMADO;-13.418;-42.14;True;10609;5299;5310;1552;725;827;9057;4574;4483
2900603;Aiquara;BA;29;Nordeste;CENTRO SUL BAIANO;JEQUIE;-14.129;-39.888;True;5212;2698;2502;2837;1427;1398;2375;1271;1104
2900702;Alagoinhas;BA;29;Nordeste;NORDESTE BAIANO;ALAGOINHAS;-12.136;-38.419;True;132725;62691;68928;115832;54101;60760;16893;8590;8168
2900801;Alcobaça;BA;29;Nordeste;SUL BAIANO;PORTO SEGURO;-17.519;-39.196;True;19840;9616;9344;10506;4950;5096;9334;4666;4248
2900900;Almadina;BA;29;Nordeste;SUL BAIANO;ILHEUS-ITABUNA;-14.705;-39.637;True;6687;3399;3280;5385;2657;2728;1302;742;552
2901007;Amargosa;BA;29;Nordeste;CENTRO SUL BAIANO;JEQUIE;-13.03;-39.605;True;33554;16406;17133;23505;11123;12373;10049;5283;4760
2901106;Amélia Rodrigues;BA;29;Nordeste;CENTRO NORTE BAIANO;FEIRA DE SANTANA;-12.409;-38.759;True;22096;10786;11300;18822;9120;9692;3274;1666;1608
2901155;América Dourada;BA;29;Nordeste;CENTRO NORTE BAIANO;IRECE;-11.455;-41.436;True;16189;8285;7892;10530;5312;5209;5659;2973;2683
2901205;Anagé;BA;29;Nordeste;CENTRO SUL BAIANO;VITORIA DA CONQUISTA;-14.612;-41.136;True;25716;13068;12498;4725;2350;2375;20991;10718;10123
2901304;Andaraí;BA;29;Nordeste;CENTRO SUL BAIANO;SEABRA;-12.807;-41.331;True;14088;7353;6735;7670;3835;3835;6418;3518;2900
2901353;Andorinha;BA;29;Nordeste;CENTRO NORTE BAIANO;SENHOR DO BONFIM;-10.345;-39.833;True;14132;7219;6829;5611;2760;2812;8521;4459;4017
2901403;Angical;BA;29;Nordeste;EXTREMO OESTE BAIANO;COTEGIPE;-12.007;-44.694;True;14700;7725;6927;6909;3458;3444;7791;4267;3483
2901502;Anguera;BA;29;Nordeste;CENTRO NORTE BAIANO;FEIRA DE SANTANA;-12.151;-39.246;True;9523;4721;4796;4104;1993;2109;5419;2728;2687
2901601;Antas;BA;29;Nordeste;NORDESTE BAIANO;RIBEIRA DO POMBAL;-10.4;-38.333;True;16446;8300;8129;6682;3274;3408;9764;5026;4721
2901700;Antônio Cardoso;BA;29;Nordeste;CENTRO NORTE BAIANO;FEIRA DE SANTANA;-12.435;-39.12;True;12074;5985;6086;2584;1271;1313;9490;4714;4773
2901809;Antônio Gonçalves;BA;29;Nordeste;CENTRO NORTE BAIANO;SENHOR DO BONFIM;-10.573;-40.274;True;10653;5405;5216;5283;2585;2689;5370;2820;2527
2901908;Aporá;BA;29;Nordeste;NORDESTE BAIANO;ALAGOINHAS;-11.66;-38.081;True;17870;9108;8723;8045;3973;4065;9825;5135;4658
2901957;Apuarema;BA;29;Nordeste;CENTRO SUL BAIANO;JEQUIE;-13.856;-39.744;True;7379;3709;3390;5116;2571;2523;2263;1138;867
2902005;Aracatu;BA;29;Nordeste;CENTRO SUL BAIANO;BRUMADO;-14.428;-41.462;True;14168;7258;6787;3626;1757;1858;10542;5501;4929
2902054;Araças;BA;29;Nordeste;NORDESTE BAIANO;ALAGOINHAS;-12.22;-38.203;True;11662;5842;5791;5902;2844;3058;5760;2998;2733
2902104;Araci;BA;29;Nordeste;NORDESTE BAIANO;SERRINHA;-11.333;-38.967;True;51912;26316;25535;18258;8877;9381;33654;17439;16154
2902203;Aramari;BA;29;Nordeste;NORDESTE BAIANO;ALAGOINHAS;-12.082;-38.499;True;9527;4764;4740;4466;2178;2288;5061;2586;2452
2902252;Arataca;BA;29;Nordeste;SUL BAIANO;ILHEUS-ITABUNA;-15.263;-39.414;True;10717;5711;4946;4990;2492;2475;5727;3219;2471
2902302;Aratuípe;BA;29;Nordeste;METROPOLITANA DE SALVADOR;SANTO ANTONIO DE JESUS;-13.079;-39.002;True;8507;4313;4170;5460;2683;2777;3047;1630;1393
2902401;Aurelino Leal;BA;29;Nordeste;SUL BAIANO;ILHEUS-ITABUNA;-14.317;-39.327;True;14458;7303;7018;12016;5997;5995;2442;1306;1023
2902500;Baianópolis;BA;29;Nordeste;EXTREMO OESTE BAIANO;BARREIRAS;-12.306;-44.535;True;13437;6985;6446;3024;1507;1517;10413;5478;4929
2902609;Baixa Grande;BA;29;Nordeste;CENTRO NORTE BAIANO;ITABERABA;-11.96;-40.168;True;20980;10283;10306;8176;3877;4290;12804;6406;6016
2902658;Banzaê;BA;29;Nordeste;NORDESTE BAIANO;RIBEIRA DO POMBAL;-10.577;-38.615;True;10865;5482;5229;3628;1803;1825;7237;3679;3404
2902708;Barra;BA;29;Nordeste;VALE SAO-FRANCISCANO DA BAHIA;BARRA;-11.089;-43.142;True;47755;24311;22992;21026;10332;10629;26729;13979;12363
2902807;Barra da Estiva;BA;29;Nordeste;CENTRO SUL BAIANO;SEABRA;-13.626;-41.327;True;20750;10277;10121;9130;4389;4626;11620;5888;5495
2902906;Barra do Choça;BA;29;Nordeste;CENTRO SUL BAIANO;VITORIA DA CONQUISTA;-14.881;-40.579;True;32489;16447;16021;21233;10540;10690;11256;5907;5331
2903003;Barra do Mendes;BA;29;Nordeste;CENTRO NORTE BAIANO;IRECE;-11.81;-42.059;True;14054;7064;6978;6299;3048;3251;7755;4016;3727
2903102;Barra do Rocha;BA;29;Nordeste;SUL BAIANO;ILHEUS-ITABUNA;-14.211;-39.602;True;6133;3168;2915;3847;1912;1923;2286;1256;992
2903201;Barreiras;BA;29;Nordeste;EXTREMO OESTE BAIANO;BARREIRAS;-12.153;-44.99;True;129501;64166;64735;115913;56920;58426;13588;7246;6309
2903235;Barro Alto;BA;29;Nordeste;CENTRO NORTE BAIANO;IRECE;-11.761;-41.912;True;13403;6813;6589;6196;3060;3135;7207;3753;3454
2903276;Barrocas;BA;29;Nordeste;NORDESTE BAIANO;ALAGOINHAS;-11.5287;-39.0779;True;13182;6713;6467;4204;2106;2096;8978;4607;4371
2903300;Governador Lomanto Júnior;BA;29;Nordeste;SUL BAIANO;ILHEUS-ITABUNA;-14.81;-39.471;True;6669;3397;3205;4768;2371;2363;1901;1026;842
2903409;Belmonte;BA;29;Nordeste;SUL BAIANO;ILHEUS-ITABUNA;-15.863;-38.883;True;21479;11018;10252;11539;5766;5709;9940;5252;4543
2903508;Belo Campo;BA;29;Nordeste;CENTRO SUL BAIANO;VITORIA DA CONQUISTA;-15.038;-41.26;True;15262;7715;7517;8371;4079;4289;6891;3636;3228
2903607;Biritinga;BA;29;Nordeste;NORDESTE BAIANO;SERRINHA;-11.617;-38.8;True;13961;7153;6808;3087;1475;1612;10874;5678;5196
2903706;Boa Nova;BA;29;Nordeste;CENTRO SUL BAIANO;VITORIA DA CONQUISTA;-14.363;-40.208;True;16007;8142;7823;5681;2778;2903;10326;5364;4920
2903805;Boa Vista do Tupim;BA;29;Nordeste;CENTRO NORTE BAIANO;ITABERABA;-12.66;-40.609;True;17841;9128;8631;6079;2931;3148;11762;6197;5483
2903904;Bom Jesus da Lapa;BA;29;Nordeste;VALE SAO-FRANCISCANO DA BAHIA;BOM JESUS DA LAPA;-13.255;-43.418;True;62199;31174;31008;41705;20226;21471;20494;10948;9537
2903953;Bom Jesus da Serra;BA;29;Nordeste;CENTRO SUL BAIANO;VITORIA DA CONQUISTA;-14.372;-40.504;True;10295;5264;4948;2425;1199;1219;7870;4065;3729
2904001;Boninal;BA;29;Nordeste;CENTRO SUL BAIANO;SEABRA;-12.702;-41.828;True;13227;6480;6747;4205;2037;2168;9022;4443;4579
2904050;Bonito;BA;29;Nordeste;CENTRO SUL BAIANO;SEABRA;-11.966;-41.267;True;13678;6950;6715;5920;2921;2999;7758;4029;3716
2904100;Boquira;BA;29;Nordeste;CENTRO SUL BAIANO;BOQUIRA;-12.823;-42.731;True;21856;10852;11004;7246;3446;3800;14610;7406;7204
2904209;Botuporã;BA;29;Nordeste;CENTRO SUL BAIANO;BOQUIRA;-13.382;-42.523;True;11026;5527;5489;3716;1812;1904;7310;3715;3585
2904308;BrejõEs;BA;29;Nordeste;CENTRO SUL BAIANO;JEQUIE;-13.104;-39.796;True;12677;6248;6389;4427;2099;2328;8250;4149;4061
2904407;Brejolândia;BA;29;Nordeste;EXTREMO OESTE BAIANO;COTEGIPE;-12.483;-43.966;True;9337;4889;4448;2123;1034;1089;7214;3855;3359
2904506;Brotas de Macaúbas;BA;29;Nordeste;CENTRO SUL BAIANO;BOQUIRA;-11.999;-42.626;True;10922;5569;5329;3122;1535;1587;7800;4034;3742
2904605;Brumado;BA;29;Nordeste;CENTRO SUL BAIANO;BRUMADO;-14.204;-41.665;True;62381;30587;31355;43259;20747;22250;19122;9840;9105
2904704;Buerarema;BA;29;Nordeste;SUL BAIANO;ILHEUS-ITABUNA;-14.959;-39.3;True;19956;10068;9870;16992;8375;8609;2964;1693;1261
2904753;Buritirama;BA;29;Nordeste;VALE SAO-FRANCISCANO DA BAHIA;BARRA;-10.708;-43.631;True;18656;9731;8925;7180;3564;3616;11476;6167;5309
2904803;Caatiba;BA;29;Nordeste;CENTRO SUL BAIANO;VITORIA DA CONQUISTA;-14.977;-40.408;True;10367;5388;4935;5609;2803;2801;4758;2585;2134
2904852;Cabaceiras do Paraguaçu;BA;29;Nordeste;METROPOLITANA DE SALVADOR;SANTO ANTONIO DE JESUS;-12.536;-39.191;True;17502;8624;8766;4072;1994;2078;13430;6630;6688
2904902;Cachoeira;BA;29;Nordeste;METROPOLITANA DE SALVADOR;SANTO ANTONIO DE JESUS;-12.618;-38.956;True;32252;15724;16480;16426;7731;8695;15826;7993;7785
2905008;Caculé;BA;29;Nordeste;CENTRO SUL BAIANO;GUANAMBI;-14.503;-42.222;True;21847;10988;10858;12336;5957;6378;9511;5031;4480
2905107;Caém;BA;29;Nordeste;CENTRO NORTE BAIANO;JACOBINA;-11.091;-40.435;True;10377;5208;5129;3565;1713;1834;6812;3495;3295
2905156;Caetanos;BA;29;Nordeste;CENTRO SUL BAIANO;VITORIA DA CONQUISTA;-14.338;-40.91;True;12133;6284;5838;2711;1371;1332;9422;4913;4506
2905206;Caetité;BA;29;Nordeste;CENTRO SUL BAIANO;GUANAMBI;-14.069;-42.475;True;46192;22668;23198;25907;12212;13498;20285;10456;9700
2905305;Cafarnaum;BA;29;Nordeste;CENTRO NORTE BAIANO;IRECE;-11.694;-41.468;True;17402;8893;8477;9801;4865;4929;7601;4028;3548
2905404;Cairu;BA;29;Nordeste;SUL BAIANO;VALENCA;-13.487;-39.044;True;13712;6968;6691;7680;3859;3806;6032;3109;2885
2905503;Caldeirão Grande;BA;29;Nordeste;CENTRO NORTE BAIANO;JACOBINA;-11.02;-40.303;True;13072;6446;6451;4343;2071;2264;8729;4375;4187
2905602;Camacan;BA;29;Nordeste;SUL BAIANO;ILHEUS-ITABUNA;-15.419;-39.496;True;30289;15301;14947;23816;11783;12030;6473;3518;2917
2905701;Camaçari;BA;29;Nordeste;METROPOLITANA DE SALVADOR;SALVADOR;-12.698;-38.324;True;220495;;;;;;;;
2905800;Camamu;BA;29;Nordeste;SUL BAIANO;VALENCA;-13.945;-39.104;True;32172;16478;15584;13393;6557;6813;18779;9921;8771
2905909;Campo Alegre de Lourdes;BA;29;Nordeste;VALE SAO-FRANCISCANO DA BAHIA;JUAZEIRO;-9.516;-43.011;True;26935;13622;13313;5844;2814;3030;21091;10808;10283
2906006;Campo Formoso;BA;29;Nordeste;CENTRO NORTE BAIANO;SENHOR DO BONFIM;-10.509;-40.321;True;65137;32837;32085;24065;11530;12529;41072;21307;19556
2906105;Canápolis;BA;29;Nordeste;EXTREMO OESTE BAIANO;SANTA MARIA DA VITORIA;-13.07;-44.202;True;10577;5457;5120;3058;1523;1535;7519;3934;3585
2906204;Canarana;BA;29;Nordeste;CENTRO NORTE BAIANO;IRECE;-11.685;-41.769;True;24436;12415;11967;11418;5562;5839;13018;6853;6128
2906303;Canavieiras;BA;29;Nordeste;SUL BAIANO;ILHEUS-ITABUNA;-15.675;-38.947;True;35743;18073;17235;28267;13786;14106;7476;4287;3129
2906402;Candeal;BA;29;Nordeste;NORDESTE BAIANO;SERRINHA;-11.808;-39.119;True;9019;4615;4396;3560;1761;1799;5459;2854;2597
2906501;Candeias;BA;29;Nordeste;METROPOLITANA DE SALVADOR;SALVADOR;-12.668;-38.551;True;78618;38337;40022;71665;34705;36713;6953;3632;3309
2906600;Candiba;BA;29;Nordeste;CENTRO SUL BAIANO;GUANAMBI;-14.411;-42.867;True;12352;6298;6052;6821;3361;3460;5531;2937;2592
2906709;Cândido Sales;BA;29;Nordeste;CENTRO SUL BAIANO;VITORIA DA CONQUISTA;-15.505;-41.239;True;26727;13206;12968;19208;9428;9473;7519;3778;3495
2906808;Cansanção;BA;29;Nordeste;NORDESTE BAIANO;EUCLIDES DA CUNHA;-10.671;-39.498;True;32789;16549;16149;10643;5161;5482;22146;11388;10667
2906824;Canudos;BA;29;Nordeste;NORDESTE BAIANO;EUCLIDES DA CUNHA;-9.964;-39.164;True;14656;7472;7156;7640;3787;3847;7016;3685;3309
2906857;Capela do Alto Alegre;BA;29;Nordeste;NORDESTE BAIANO;SERRINHA;-11.668;-39.838;True;12311;6162;6146;5901;2830;3071;6410;3332;3075
2906873;Capim Grosso;BA;29;Nordeste;CENTRO NORTE BAIANO;JACOBINA;-11.381;-40.013;True;25823;12641;13040;19861;9583;10178;5962;3058;2862
2906899;Caraíbas;BA;29;Nordeste;CENTRO SUL BAIANO;BRUMADO;-14.6;-41.335;True;10541;5376;5063;1942;951;991;8599;4425;4072
2906907;Caravelas;BA;29;Nordeste;SUL BAIANO;PORTO SEGURO;-17.732;-39.266;True;21150;10385;10147;11583;5621;5698;9567;4764;4449
2907004;Cardeal da Silva;BA;29;Nordeste;NORDESTE BAIANO;ENTRE RIOS;-11.942;-37.949;True;8280;4240;4040;2845;1421;1424;5435;2819;2616
2907103;Carinhanha;BA;29;Nordeste;VALE SAO-FRANCISCANO DA BAHIA;BOM JESUS DA LAPA;-14.305;-43.765;True;28879;14910;13965;12363;6028;6335;16516;8882;7630
2907202;Casa Nova;BA;29;Nordeste;VALE SAO-FRANCISCANO DA BAHIA;JUAZEIRO;-9.162;-40.971;True;62862;32205;30517;32745;16170;16464;30117;16035;14053
2907301;Castro Alves;BA;29;Nordeste;METROPOLITANA DE SALVADOR;SANTO ANTONIO DE JESUS;-12.766;-39.428;True;24437;11752;12511;14024;6552;7461;10413;5200;5050
2907400;Catolândia;BA;29;Nordeste;EXTREMO OESTE BAIANO;BARREIRAS;-12.318;-44.861;True;3767;1951;1766;969;485;484;2798;1466;1282
2907509;Catu;BA;29;Nordeste;METROPOLITANA DE SALVADOR;CATU;-12.353;-38.379;True;48697;23749;24929;40275;19379;20887;8422;4370;4042
2907558;Caturama;BA;29;Nordeste;CENTRO SUL BAIANO;BOQUIRA;-13.329;-42.291;True;8545;4401;4144;1698;844;854;6847;3557;3290
2907608;Central;BA;29;Nordeste;CENTRO NORTE BAIANO;IRECE;-11.136;-42.113;True;17320;8781;8478;7988;3897;4045;9332;4884;4433
2907707;Chorrochó;BA;29;Nordeste;VALE SAO-FRANCISCANO DA BAHIA;PAULO AFONSO;-8.98;-39.094;True;10571;5382;5180;2446;1158;1288;8125;4224;3892
2907806;Cícero Dantas;BA;29;Nordeste;NORDESTE BAIANO;RIBEIRA DO POMBAL;-10.6;-38.383;True;30827;15160;15650;16889;7983;8895;13938;7177;6755
2907905;Cipó;BA;29;Nordeste;NORDESTE BAIANO;RIBEIRA DO POMBAL;-11.1;-38.517;True;15063;7296;7767;10205;4826;5379;4858;2470;2388
2908002;Coaraci;BA;29;Nordeste;SUL BAIANO;ILHEUS-ITABUNA;-14.641;-39.551;True;22764;11273;11423;20596;10031;10526;2168;1242;897
2908101;Cocos;BA;29;Nordeste;EXTREMO OESTE BAIANO;SANTA MARIA DA VITORIA;-14.184;-44.534;True;17394;8695;8305;7649;3752;3864;9745;4943;4441
2908200;Conceição da Feira;BA;29;Nordeste;CENTRO NORTE BAIANO;FEIRA DE SANTANA;-12.506;-38.999;True;19091;9278;9774;12109;5769;6324;6982;3509;3450
2908309;Conceição do Almeida;BA;29;Nordeste;METROPOLITANA DE SALVADOR;SANTO ANTONIO DE JESUS;-12.809;-39.164;True;17684;8661;8991;8305;3987;4318;9379;4674;4673
2908408;Conceição do Coité;BA;29;Nordeste;NORDESTE BAIANO;SERRINHA;-11.564;-39.283;True;60835;30251;30518;33671;16180;17449;27164;14071;13069
2908507;Conceição do Jacuípe;BA;29;Nordeste;METROPOLITANA DE SALVADOR;CATU;-12.327;-38.765;True;27522;13389;14108;20867;10020;10847;6655;3369;3261
2908606;Conde;BA;29;Nordeste;NORDESTE BAIANO;ENTRE RIOS;-11.814;-37.611;True;22034;11128;10885;11445;5555;5890;10589;5573;4995
2908705;Condeúba;BA;29;Nordeste;CENTRO SUL BAIANO;BRUMADO;-14.895;-41.969;True;17004;8466;8520;7286;3436;3850;9718;5030;4670
2908804;Contendas do Sincorá;BA;29;Nordeste;CENTRO SUL BAIANO;SEABRA;-13.763;-41.041;True;3857;1940;1909;2287;1127;1160;1570;813;749
2908903;Coração de Maria;BA;29;Nordeste;CENTRO NORTE BAIANO;FEIRA DE SANTANA;-12.233;-38.75;True;23161;11349;11747;8543;3998;4533;14618;7351;7214
2909000;Cordeiros;BA;29;Nordeste;CENTRO SUL BAIANO;BRUMADO;-15.039;-41.935;True;8518;4250;4244;2543;1239;1304;5975;3011;2940
2909109;Coribe;BA;29;Nordeste;EXTREMO OESTE BAIANO;SANTA MARIA DA VITORIA;-13.829;-44.454;True;14555;7340;7052;5611;2667;2820;8944;4673;4232
2909208;Coronel João Sá;BA;29;Nordeste;NORDESTE BAIANO;JEREMOABO;-10.284;-37.926;True;18168;9308;8853;6650;3270;3380;11518;6038;5473
2909307;Correntina;BA;29;Nordeste;EXTREMO OESTE BAIANO;SANTA MARIA DA VITORIA;-13.343;-44.637;True;31658;16077;15535;12370;6037;6333;19288;10040;9202
2909406;Cotegipe;BA;29;Nordeste;EXTREMO OESTE BAIANO;COTEGIPE;-12.028;-44.258;True;13663;7095;6558;6406;3123;3283;7257;3972;3275
2909505;Cravolândia;BA;29;Nordeste;CENTRO SUL BAIANO;JEQUIE;-13.359;-39.815;True;5427;2762;2665;3574;1777;1797;1853;985;868
2909604;Crisópolis;BA;29;Nordeste;NORDESTE BAIANO;ALAGOINHAS;-11.511;-38.15;True;19510;9941;9461;7721;3790;3913;11789;6151;5548
2909703;Cristópolis;BA;29;Nordeste;EXTREMO OESTE BAIANO;COTEGIPE;-12.234;-44.421;True;13595;7038;6552;3057;1524;1533;10538;5514;5019
2909802;Cruz das Almas;BA;29;Nordeste;METROPOLITANA DE SALVADOR;SANTO ANTONIO DE JESUS;-12.67;-39.102;True;54827;25868;28851;46121;21513;24549;8706;4355;4302
2909901;Curaçá;BA;29;Nordeste;VALE SAO-FRANCISCANO DA BAHIA;JUAZEIRO;-8.992;-39.908;True;32449;16460;15528;13047;6095;6698;19402;10365;8830
2910008;Dário Meira;BA;29;Nordeste;CENTRO SUL BAIANO;VITORIA DA CONQUISTA;-14.436;-39.908;True;12565;6582;5979;5009;2525;2480;7556;4057;3499
2910057;Dias D'Ávila;BA;29;Nordeste;METROPOLITANA DE SALVADOR;SALVADOR;-12.613;-38.297;True;53821;26577;27236;50758;24938;25812;3063;1639;1424
2910107;Dom Basílio;BA;29;Nordeste;CENTRO SUL BAIANO;LIVRAMENTO DO BRUMADO;-13.76;-41.771;True;11087;5746;5337;1719;855;864;9368;4891;4473
2910206;Dom Macedo Costa;BA;29;Nordeste;METROPOLITANA DE SALVADOR;SANTO ANTONIO DE JESUS;-12.905;-39.193;True;3809;1881;1927;1542;731;811;2267;1150;1116
2910305;Elísio Medrado;BA;29;Nordeste;CENTRO NORTE BAIANO;FEIRA DE SANTANA;-12.946;-39.522;True;7907;3986;3921;2797;1326;1471;5110;2660;2450
2910404;Encruzilhada;BA;29;Nordeste;CENTRO SUL BAIANO;ITAPETINGA;-15.531;-40.909;True;22525;11726;10779;4868;2413;2455;17657;9313;8324
2910503;Entre Rios;BA;29;Nordeste;NORDESTE BAIANO;ENTRE RIOS;-11.942;-38.084;True;38886;19219;19563;24069;11614;12408;14817;7605;7155
2910602;Esplanada;BA;29;Nordeste;NORDESTE BAIANO;ENTRE RIOS;-11.796;-37.945;True;31118;15505;15385;19828;9684;10024;11290;5821;5361
2910701;Euclides da Cunha;BA;29;Nordeste;NORDESTE BAIANO;EUCLIDES DA CUNHA;-10.508;-39.014;True;56625;28646;27728;26028;12663;13311;30597;15983;14417
2910727;Eunápolis;BA;29;Nordeste;SUL BAIANO;PORTO SEGURO;-16.378;-39.58;True;93984;46357;47473;87875;43110;44627;6109;3247;2846
2910750;Fátima;BA;29;Nordeste;NORDESTE BAIANO;RIBEIRA DO POMBAL;-10.6;-38.217;True;18918;9589;9269;6782;3274;3508;12136;6315;5761
2910776;Feira da Mata;BA;29;Nordeste;VALE SAO-FRANCISCANO DA BAHIA;BOM JESUS DA LAPA;-14.207;-44.281;True;6328;3276;3015;3220;1611;1603;3108;1665;1412
2910800;Feira de Santana;BA;29;Nordeste;CENTRO NORTE BAIANO;FEIRA DE SANTANA;-12.267;-38.967;True;571997;;;;;;;;
2910859;Filadélfia;BA;29;Nordeste;CENTRO NORTE BAIANO;SENHOR DO BONFIM;-10.741;-40.133;True;15979;8111;7856;8431;4089;4342;7548;4022;3514
2910909;Firmino Alves;BA;29;Nordeste;SUL BAIANO;ILHEUS-ITABUNA;-14.985;-39.924;True;5577;2849;2705;4389;2217;2169;1188;632;536
2911006;Floresta Azul;BA;29;Nordeste;SUL BAIANO;ILHEUS-ITABUNA;-14.86;-39.66;True;10333;5300;5030;7348;3663;3685;2985;1637;1345
2911105;Formosa do Rio Preto;BA;29;Nordeste;EXTREMO OESTE BAIANO;BARREIRAS;-11.048;-45.193;True;20845;10804;9875;11445;5652;5772;9400;5152;4103
2911204;Gandu;BA;29;Nordeste;SUL BAIANO;ILHEUS-ITABUNA;-13.744;-39.487;True;30091;14980;14970;24473;11936;12472;5618;3044;2498
2911253;Gavião;BA;29;Nordeste;NORDESTE BAIANO;SERRINHA;-11.471;-39.784;True;4444;2326;2117;2337;1197;1140;2107;1129;977
2911303;Gentio do Ouro;BA;29;Nordeste;CENTRO NORTE BAIANO;IRECE;-11.429;-42.506;True;11326;5849;5473;5617;2780;2837;5709;3069;2636
2911402;Glória;BA;29;Nordeste;VALE SAO-FRANCISCANO DA BAHIA;PAULO AFONSO;-9.339;-38.257;True;13879;6787;6831;2691;1307;1374;11188;5480;5457
2911501;Gongogi;BA;29;Nordeste;SUL BAIANO;ILHEUS-ITABUNA;-14.322;-39.465;True;6845;3524;3310;4772;2364;2405;2073;1160;905
2911600;Governador Mangabeira;BA;29;Nordeste;METROPOLITANA DE SALVADOR;SANTO ANTONIO DE JESUS;-12.602;-39.043;True;19828;9598;10191;7324;3439;3879;12504;6159;6312
2911659;Guajeru;BA;29;Nordeste;CENTRO SUL BAIANO;BRUMADO;-14.547;-41.94;True;7062;3482;3580;1684;774;910;5378;2708;2670
2911709;Guanambi;BA;29;Nordeste;CENTRO SUL BAIANO;GUANAMBI;-14.223;-42.781;True;76230;37274;38890;59310;28480;30801;16920;8794;8089
2911808;Guaratinga;BA;29;Nordeste;SUL BAIANO;PORTO SEGURO;-16.584;-39.783;True;22621;11890;10699;10239;5132;5093;12382;6758;5606
2911857;Heliópolis;BA;29;Nordeste;NORDESTE BAIANO;RIBEIRA DO POMBAL;-10.683;-38.286;True;14020;7118;6902;5766;2813;2953;8254;4305;3949
2911907;Iaçu;BA;29;Nordeste;CENTRO NORTE BAIANO;ITABERABA;-12.767;-40.212;True;27835;13921;13880;21205;10317;10888;6630;3604;2992
2912004;Ibiassucê;BA;29;Nordeste;CENTRO SUL BAIANO;GUANAMBI;-14.259;-42.257;True;9507;4829;4617;4487;2247;2240;5020;2582;2377
2912103;Ibicaraí;BA;29;Nordeste;SUL BAIANO;ILHEUS-ITABUNA;-14.865;-39.588;True;24752;12106;12611;18461;8848;9597;6291;3258;3014
2912202;Ibicoara;BA;29;Nordeste;CENTRO SUL BAIANO;SEABRA;-13.411;-41.285;True;15856;8053;7666;5854;2921;2907;10002;5132;4759
2912301;Ibicuí;BA;29;Nordeste;CENTRO SUL BAIANO;VITORIA DA CONQUISTA;-14.842;-39.987;True;15777;8023;7708;11712;5782;5924;4065;2241;1784
2912400;Ibipeba;BA;29;Nordeste;CENTRO NORTE BAIANO;IRECE;-11.641;-42.011;True;16762;8614;8016;9911;5001;4910;6851;3613;3106
2912509;Ibipitanga;BA;29;Nordeste;CENTRO SUL BAIANO;BOQUIRA;-12.882;-42.486;True;13841;6873;6968;4283;1997;2286;9558;4876;4682
2912608;Ibiquera;BA;29;Nordeste;CENTRO NORTE BAIANO;ITABERABA;-12.651;-40.934;True;5007;2626;2381;2558;1272;1286;2449;1354;1095
2912707;Ibirapitanga;BA;29;Nordeste;SUL BAIANO;ILHEUS-ITABUNA;-14.164;-39.374;True;23197;11545;10901;6065;2908;3100;17132;8637;7801
2912806;Ibirapuã;BA;29;Nordeste;SUL BAIANO;PORTO SEGURO;-17.688;-40.109;True;7534;3770;3512;3988;1996;1897;3546;1774;1615
2912905;Ibirataia;BA;29;Nordeste;SUL BAIANO;ILHEUS-ITABUNA;-14.067;-39.641;True;23940;11900;11441;18063;8929;8964;5877;2971;2477
2913002;Ibitiara;BA;29;Nordeste;CENTRO SUL BAIANO;BOQUIRA;-12.652;-42.218;True;15802;7903;7899;3189;1526;1663;12613;6377;6236
2913101;Ibititá;BA;29;Nordeste;CENTRO NORTE BAIANO;IRECE;-11.547;-41.978;True;18614;9426;8897;8474;4201;4218;10140;5225;4679
2913200;Ibotirama;BA;29;Nordeste;VALE SAO-FRANCISCANO DA BAHIA;BARRA;-12.185;-43.221;True;25292;12727;12565;18710;9166;9544;6582;3561;3021
2913309;Ichu;BA;29;Nordeste;NORDESTE BAIANO;SERRINHA;-11.749;-39.192;True;5881;2938;2919;3111;1538;1565;2770;1400;1354
2913408;Igaporã;BA;29;Nordeste;CENTRO SUL BAIANO;GUANAMBI;-13.773;-42.714;True;14499;7164;7136;7394;3537;3842;7105;3627;3294
2913457;Igrapiúna;BA;29;Nordeste;SUL BAIANO;VALENCA;-13.826;-39.142;True;13246;6996;6148;3910;1919;1991;9336;5077;4157
2913507;Iguaí;BA;29;Nordeste;CENTRO SUL BAIANO;VITORIA DA CONQUISTA;-14.756;-40.089;True;27849;14196;13401;14091;6938;7067;13758;7258;6334
2913606;Ilhéus;BA;29;Nordeste;SUL BAIANO;ILHEUS-ITABUNA;-14.789;-39.049;True;220144;;;;;;;;
2913705;Inhambupe;BA;29;Nordeste;NORDESTE BAIANO;ALAGOINHAS;-11.784;-38.353;True;34388;17066;17020;14142;6749;7236;20246;10317;9784
2913804;Ipecaetá;BA;29;Nordeste;CENTRO NORTE BAIANO;FEIRA DE SANTANA;-12.3;-39.308;True;16055;7974;8073;2381;1150;1231;13674;6824;6842
2913903;Ipiaú;BA;29;Nordeste;SUL BAIANO;ILHEUS-ITABUNA;-14.137;-39.734;True;42561;20971;21523;37970;18524;19379;4591;2447;2144
2914000;Ipirá;BA;29;Nordeste;CENTRO NORTE BAIANO;FEIRA DE SANTANA;-12.158;-39.737;True;60043;29403;30188;27442;12845;14499;32601;16558;15689
2914109;Ipupiara;BA;29;Nordeste;CENTRO SUL BAIANO;BOQUIRA;-11.82;-42.614;True;8931;4551;4380;5565;2776;2789;3366;1775;1591
2914208;Irajuba;BA;29;Nordeste;CENTRO SUL BAIANO;JEQUIE;-13.251;-40.084;True;7215;3692;3522;3394;1688;1706;3821;2004;1816
2914307;Iramaia;BA;29;Nordeste;CENTRO SUL BAIANO;JEQUIE;-13.286;-40.951;True;15134;7727;7370;7570;3759;3811;7564;3968;3559
2914406;Iraquara;BA;29;Nordeste;CENTRO NORTE BAIANO;IRECE;-12.249;-41.619;True;22607;11300;11307;5632;2676;2956;16975;8624;8351
2914505;Irará;BA;29;Nordeste;CENTRO NORTE BAIANO;FEIRA DE SANTANA;-12.05;-38.767;True;25012;12172;12673;9053;4208;4834;15959;7964;7839
2914604;Irecê;BA;29;Nordeste;CENTRO NORTE BAIANO;IRECE;-11.304;-41.856;True;62676;30273;32064;58036;27853;29857;4640;2420;2207
2914653;Itabela;BA;29;Nordeste;SUL BAIANO;PORTO SEGURO;-16.575;-39.553;True;25821;13201;12595;19742;9971;9771;6079;3230;2824
2914703;Itaberaba;BA;29;Nordeste;CENTRO NORTE BAIANO;ITABERABA;-12.528;-40.307;True;59393;28913;30399;45845;21732;24035;13548;7181;6364
2914802;Itabuna;BA;29;Nordeste;SUL BAIANO;ILHEUS-ITABUNA;-14.786;-39.28;True;210604;;;;;;;;
2914901;Itacaré;BA;29;Nordeste;SUL BAIANO;ILHEUS-ITABUNA;-14.278;-38.997;True;24720;12809;11406;14350;7188;7156;10370;5621;4250
2915007;Itaeté;BA;29;Nordeste;CENTRO SUL BAIANO;SEABRA;-12.986;-40.973;True;14154;7164;6949;5611;2734;2858;8543;4430;4091
2915106;Itagi;BA;29;Nordeste;CENTRO SUL BAIANO;JEQUIE;-14.163;-40.006;True;13882;7055;6817;10137;4975;5158;3745;2080;1659
2915205;Itagibá;BA;29;Nordeste;SUL BAIANO;ILHEUS-ITABUNA;-14.284;-39.843;True;16272;8377;7803;9519;4752;4764;6753;3625;3039
2915304;Itagimirim;BA;29;Nordeste;SUL BAIANO;PORTO SEGURO;-16.087;-39.614;True;7049;3519;3516;5680;2777;2900;1369;742;616
2915353;Itaguaçu da Bahia;BA;29;Nordeste;VALE SAO-FRANCISCANO DA BAHIA;BARRA;-11.012;-42.399;True;12545;6576;5968;2373;1183;1190;10172;5393;4778
2915403;Itaju do Colônia;BA;29;Nordeste;SUL BAIANO;ILHEUS-ITABUNA;-15.143;-39.724;True;7673;3924;3744;5998;2987;3011;1675;937;733
2915502;Itajuípe;BA;29;Nordeste;SUL BAIANO;ILHEUS-ITABUNA;-14.678;-39.375;True;20343;10072;9972;15731;7653;7959;4612;2419;2013
2915601;Itamaraju;BA;29;Nordeste;SUL BAIANO;PORTO SEGURO;-17.039;-39.531;True;65327;32490;32059;50021;24299;25226;15306;8191;6833
2915700;Itamari;BA;29;Nordeste;SUL BAIANO;ILHEUS-ITABUNA;-13.778;-39.684;True;8468;4394;4074;5851;2948;2903;2617;1446;1171
2915809;Itambé;BA;29;Nordeste;CENTRO SUL BAIANO;ITAPETINGA;-15.245;-40.624;True;33687;16913;16243;22224;10714;10982;11463;6199;5261
2915908;Itanagra;BA;29;Nordeste;METROPOLITANA DE SALVADOR;CATU;-12.263;-38.042;True;6605;3358;3247;2213;1117;1096;4392;2241;2151
2916005;Itanhém;BA;29;Nordeste;SUL BAIANO;PORTO SEGURO;-17.166;-40.33;True;20636;10320;9984;14088;6890;7121;6548;3430;2863
2916104;Itaparica;BA;29;Nordeste;METROPOLITANA DE SALVADOR;SALVADOR;-12.888;-38.679;True;19897;9682;10062;19897;9682;10062;;;
2916203;Itapé;BA;29;Nordeste;SUL BAIANO;ILHEUS-ITABUNA;-14.898;-39.421;True;11123;5651;5393;6701;3325;3367;4422;2326;2026
2916302;Itapebi;BA;29;Nordeste;SUL BAIANO;ILHEUS-ITABUNA;-15.951;-39.534;True;11520;5891;5622;9551;4792;4752;1969;1099;870
2916401;Itapetinga;BA;29;Nordeste;CENTRO SUL BAIANO;ITAPETINGA;-15.249;-40.248;True;63243;30927;32201;60723;29544;31073;2520;1383;1128
2916500;Itapicuru;BA;29;Nordeste;NORDESTE BAIANO;RIBEIRA DO POMBAL;-11.317;-38.233;True;30703;15835;14832;6027;2940;3087;24676;12895;11745
2916609;Itapitanga;BA;29;Nordeste;SUL BAIANO;ILHEUS-ITABUNA;-14.423;-39.565;True;10106;5144;4903;7423;3662;3758;2683;1482;1145
2916708;Itaquara;BA;29;Nordeste;CENTRO SUL BAIANO;JEQUIE;-13.451;-39.941;True;7564;3859;3698;4563;2238;2325;3001;1621;1373
2916807;Itarantim;BA;29;Nordeste;CENTRO SUL BAIANO;ITAPETINGA;-15.66;-40.066;True;17615;9006;8498;14378;7164;7154;3237;1842;1344
2916856;Itatim;BA;29;Nordeste;CENTRO NORTE BAIANO;FEIRA DE SANTANA;-12.712;-39.698;True;14569;7328;7215;9640;4719;4912;4929;2609;2303
2916906;Itiruçu;BA;29;Nordeste;CENTRO SUL BAIANO;JEQUIE;-13.532;-40.15;True;15764;7722;7880;11602;5570;5921;4162;2152;1959
2917003;Itiúba;BA;29;Nordeste;CENTRO NORTE BAIANO;SENHOR DO BONFIM;-10.691;-39.853;True;35749;17996;17573;9470;4528;4864;26279;13468;12709
2917102;Itororó;BA;29;Nordeste;CENTRO SUL BAIANO;ITAPETINGA;-15.117;-40.07;True;20165;10167;9963;17927;8926;8989;2238;1241;974
2917201;Ituaçu;BA;29;Nordeste;CENTRO SUL BAIANO;BRUMADO;-13.813;-41.297;True;17939;8919;9020;5832;2731;3101;12107;6188;5919
2917300;Ituberá;BA;29;Nordeste;SUL BAIANO;VALENCA;-13.732;-39.149;True;23530;11832;11656;16837;8132;8684;6693;3700;2972
2917334;Iuiú;BA;29;Nordeste;CENTRO SUL BAIANO;GUANAMBI;-14.414;-43.554;True;11469;5985;5477;5126;2586;2540;6343;3399;2937
2917359;Jaborandi;BA;29;Nordeste;EXTREMO OESTE BAIANO;SANTA MARIA DA VITORIA;-13.619;-44.433;True;8931;4615;4186;2392;1172;1220;6539;3443;2966
2917409;Jacaraci;BA;29;Nordeste;CENTRO SUL BAIANO;GUANAMBI;-14.85;-42.433;True;14346;7309;7032;4691;2294;2394;9655;5015;4638
2917508;Jacobina;BA;29;Nordeste;CENTRO NORTE BAIANO;JACOBINA;-11.181;-40.518;True;76463;36736;38810;52939;24931;27430;23524;11805;11380
2917607;Jaguaquara;BA;29;Nordeste;CENTRO SUL BAIANO;JEQUIE;-13.531;-39.971;True;46641;22736;23410;36585;17446;18851;10056;5290;4559
2917706;Jaguarari;BA;29;Nordeste;CENTRO NORTE BAIANO;SENHOR DO BONFIM;-10.26;-40.196;True;29097;14848;14220;14930;7363;7567;14167;7485;6653
2917805;Jaguaripe;BA;29;Nordeste;METROPOLITANA DE SALVADOR;SANTO ANTONIO DE JESUS;-13.113;-38.896;True;16207;8290;7846;5396;2677;2716;10811;5613;5130
2917904;Jandaíra;BA;29;Nordeste;NORDESTE BAIANO;ENTRE RIOS;-11.564;-37.784;True;9758;5153;4557;6156;3229;2927;3602;1924;1630
2918001;Jequié;BA;29;Nordeste;CENTRO SUL BAIANO;JEQUIE;-13.858;-40.084;True;145964;71036;74850;133884;64485;69338;12080;6551;5512
2918100;Jeremoabo;BA;29;Nordeste;NORDESTE BAIANO;JEREMOABO;-10.067;-38.35;True;37431;18977;18450;16810;8127;8679;20621;10850;9771
2918209;Jiquiriçá;BA;29;Nordeste;CENTRO SUL BAIANO;JEQUIE;-13.257;-39.572;True;13386;6770;6414;5204;2519;2671;8182;4251;3743
2918308;Jitaúna;BA;29;Nordeste;CENTRO SUL BAIANO;JEQUIE;-14.019;-39.889;True;16839;8733;8098;9150;4499;4651;7689;4234;3447
2918357;João Dourado;BA;29;Nordeste;CENTRO NORTE BAIANO;IRECE;-11.35;-41.664;True;20834;10483;10209;12942;6410;6474;7892;4073;3735
2918407;Juazeiro;BA;29;Nordeste;VALE SAO-FRANCISCANO DA BAHIA;JUAZEIRO;-9.414;-40.503;True;230538;;;;;;;;
2918456;Jucuruçu;BA;29;Nordeste;SUL BAIANO;PORTO SEGURO;-16.843;-40.159;True;10599;5599;4915;1879;981;898;8720;4618;4017
2918506;Jussara;BA;29;Nordeste;CENTRO NORTE BAIANO;IRECE;-11.047;-41.969;True;14833;7736;7043;9445;4868;4571;5388;2868;2472
2918555;Jussari;BA;29;Nordeste;SUL BAIANO;ILHEUS-ITABUNA;-15.191;-39.495;True;6857;3568;3285;4997;2548;2449;1860;1020;836
2918605;Jussiape;BA;29;Nordeste;CENTRO SUL BAIANO;SEABRA;-13.517;-41.593;True;8465;4084;4359;3074;1424;1650;5391;2660;2709
2918704;Lafaiete Coutinho;BA;29;Nordeste;CENTRO SUL BAIANO;JEQUIE;-13.656;-40.213;True;3526;1843;1683;1967;982;985;1559;861;698
2918753;Lagoa Real;BA;29;Nordeste;CENTRO SUL BAIANO;GUANAMBI;-14.035;-42.142;True;13795;7288;6493;2745;1323;1422;11050;5965;5071
2918803;Laje;BA;29;Nordeste;CENTRO SUL BAIANO;JEQUIE;-13.182;-39.425;True;21104;10686;10294;5712;2730;2946;15392;7956;7348
2918902;Lajedão;BA;29;Nordeste;SUL BAIANO;PORTO SEGURO;-17.614;-40.345;True;3469;1698;1663;2052;963;1010;1417;735;653
2919009;Lajedinho;BA;29;Nordeste;CENTRO NORTE BAIANO;ITABERABA;-12.356;-40.906;True;4329;2243;2086;1239;604;635;3090;1639;1451
2919058;Lajedo do Tabocal;BA;29;Nordeste;CENTRO SUL BAIANO;JEQUIE;-13.475;-40.224;True;8591;4306;4144;5075;2457;2536;3516;1849;1608
2919108;Lamarão;BA;29;Nordeste;NORDESTE BAIANO;SERRINHA;-11.783;-38.9;True;11988;6083;5905;1940;959;981;10048;5124;4924
2919157;Lapão;BA;29;Nordeste;CENTRO NORTE BAIANO;IRECE;-11.383;-41.832;True;25557;12947;12448;9852;4896;4932;15705;8051;7516
2919207;Lauro de Freitas;BA;29;Nordeste;METROPOLITANA DE SALVADOR;SALVADOR;-12.894;-38.327;True;144492;69323;74304;144492;69323;74304;;;
2919306;Lençóis;BA;29;Nordeste;CENTRO SUL BAIANO;SEABRA;-12.563;-41.39;True;9617;4824;4793;7324;3568;3756;2293;1256;1037
2919405;Licínio de Almeida;BA;29;Nordeste;CENTRO SUL BAIANO;GUANAMBI;-14.682;-42.508;True;12695;6452;6162;6182;3029;3122;6513;3423;3040
2919504;Livramento de Nossa Senhora;BA;29;Nordeste;CENTRO SUL BAIANO;LIVRAMENTO DO BRUMADO;-13.643;-41.841;True;42146;20991;20575;19031;9131;9716;23115;11860;10859
2919553;Luis Eduardo Magalhães;BA;29;Nordeste;EXTREMO OESTE BAIANO;BARREIRAS;-12.0923;-45.8054;True;44265;22725;21227;40502;20611;19602;3763;2114;1625
2919603;Macajuba;BA;29;Nordeste;CENTRO NORTE BAIANO;ITABERABA;-12.136;-40.36;True;11207;5537;5616;6939;3283;3622;4268;2254;1994
2919702;Macarani;BA;29;Nordeste;CENTRO SUL BAIANO;ITAPETINGA;-15.568;-40.423;True;16046;8053;7822;12063;5853;6136;3983;2200;1686
2919801;Macaúbas;BA;29;Nordeste;CENTRO SUL BAIANO;BOQUIRA;-13.019;-42.699;True;45958;23035;22831;14641;6991;7641;31317;16044;15190
2919900;Macururé;BA;29;Nordeste;VALE SAO-FRANCISCANO DA BAHIA;PAULO AFONSO;-9.168;-39.058;True;7779;3793;3903;2540;1179;1361;5239;2614;2542
2919926;Madre de Deus;BA;29;Nordeste;METROPOLITANA DE SALVADOR;SALVADOR;-12.741;-38.621;True;15432;7306;7818;14937;7048;7581;495;258;237
2919959;Maetinga;BA;29;Nordeste;CENTRO SUL BAIANO;BRUMADO;-14.663;-41.492;True;8793;4488;4297;2576;1267;1309;6217;3221;2988
2920007;Maiquinique;BA;29;Nordeste;CENTRO SUL BAIANO;ITAPETINGA;-15.621;-40.266;True;8324;4205;4020;6566;3244;3243;1758;961;777
2920106;Mairi;BA;29;Nordeste;CENTRO NORTE BAIANO;ITABERABA;-11.711;-40.149;True;19259;9438;9699;10614;4954;5562;8645;4484;4137
2920205;Malhada;BA;29;Nordeste;CENTRO SUL BAIANO;GUANAMBI;-14.336;-43.774;True;16085;8334;7743;6860;3445;3413;9225;4889;4330
2920304;Malhada de Pedras;BA;29;Nordeste;CENTRO SUL BAIANO;BRUMADO;-14.388;-41.879;True;7620;3888;3717;2700;1339;1361;4920;2549;2356
2920403;Manoel Vitorino;BA;29;Nordeste;CENTRO SUL BAIANO;VITORIA DA CONQUISTA;-14.145;-40.243;True;14262;7278;6919;6596;3218;3329;7666;4060;3590
2920452;Mansidão;BA;29;Nordeste;EXTREMO OESTE BAIANO;COTEGIPE;-10.716;-44.034;True;11694;6107;5481;3901;1956;1945;7793;4151;3536
2920502;Maracás;BA;29;Nordeste;CENTRO SUL BAIANO;JEQUIE;-13.441;-40.431;True;34221;17176;17005;22581;10926;11650;11640;6250;5355
2920601;Maragogipe;BA;29;Nordeste;METROPOLITANA DE SALVADOR;SANTO ANTONIO DE JESUS;-12.778;-38.919;True;42079;21198;20726;22516;10945;11546;19563;10253;9180
2920700;Maraú;BA;29;Nordeste;SUL BAIANO;VALENCA;-14.103;-39.015;True;17029;9018;7917;3466;1695;1771;13563;7323;6146
2920809;Marcionílio Souza;BA;29;Nordeste;CENTRO SUL BAIANO;JEQUIE;-13.003;-40.531;True;10716;5459;5255;5365;2616;2749;5351;2843;2506
2920908;Mascote;BA;29;Nordeste;SUL BAIANO;ILHEUS-ITABUNA;-15.563;-39.303;True;16061;8498;7548;12421;6351;6065;3640;2147;1483
2921005;Mata de São João;BA;29;Nordeste;METROPOLITANA DE SALVADOR;CATU;-12.53;-38.299;True;37201;18558;18506;26996;13155;13716;10205;5403;4790
2921054;Matina;BA;29;Nordeste;CENTRO SUL BAIANO;GUANAMBI;-13.909;-42.849;True;12322;6309;6006;4099;2052;2047;8223;4257;3959
2921104;Medeiros Neto;BA;29;Nordeste;SUL BAIANO;PORTO SEGURO;-17.374;-40.221;True;21866;11196;10618;16589;8337;8208;5277;2859;2410
2921203;Miguel Calmon;BA;29;Nordeste;CENTRO NORTE BAIANO;JACOBINA;-11.429;-40.595;True;27213;13659;13529;15920;7652;8265;11293;6007;5264
2921302;Milagres;BA;29;Nordeste;CENTRO SUL BAIANO;JEQUIE;-12.87;-39.859;True;11771;5692;6079;9573;4570;5003;2198;1122;1076
2921401;Mirangaba;BA;29;Nordeste;CENTRO NORTE BAIANO;JACOBINA;-10.954;-40.576;True;17474;8604;8461;7539;3618;3807;9935;4986;4654
2921450;Mirante;BA;29;Nordeste;CENTRO SUL BAIANO;VITORIA DA CONQUISTA;-14.242;-40.773;True;9174;4711;4459;1595;799;796;7579;3912;3663
2921500;Monte Santo;BA;29;Nordeste;NORDESTE BAIANO;EUCLIDES DA CUNHA;-10.438;-39.333;True;52249;26791;25458;8218;3999;4219;44031;22792;21239
2921609;Morpará;BA;29;Nordeste;VALE SAO-FRANCISCANO DA BAHIA;BARRA;-11.559;-43.281;True;8586;4436;4137;5653;2800;2853;2933;1636;1284
2921708;Morro do Chapéu;BA;29;Nordeste;CENTRO NORTE BAIANO;JACOBINA;-11.55;-41.156;True;34012;17142;16868;19248;9257;9991;14764;7885;6877
2921807;Mortugaba;BA;29;Nordeste;CENTRO SUL BAIANO;GUANAMBI;-15.023;-42.368;True;13905;6945;6960;5964;2895;3069;7941;4050;3891
2921906;Mucugê;BA;29;Nordeste;CENTRO SUL BAIANO;SEABRA;-13.005;-41.371;True;14131;7176;6955;4119;1985;2134;10012;5191;4821
2922003;Mucuri;BA;29;Nordeste;SUL BAIANO;PORTO SEGURO;-18.086;-39.551;True;33143;16776;15956;24256;12029;11977;8887;4747;3979
2922052;Mulungu do Morro;BA;29;Nordeste;CENTRO NORTE BAIANO;IRECE;-11.966;-41.639;True;13755;6949;6806;6537;3251;3286;7218;3698;3520
2922102;Mundo Novo;BA;29;Nordeste;CENTRO NORTE BAIANO;ITABERABA;-11.859;-40.472;True;23822;12139;11621;12734;6301;6430;11088;5838;5191
2922201;Muniz Ferreira;BA;29;Nordeste;METROPOLITANA DE SALVADOR;SANTO ANTONIO DE JESUS;-13.003;-39.11;True;6990;3569;3416;3224;1591;1633;3766;1978;1783
2922250;Muquém de São Francisco;BA;29;Nordeste;VALE SAO-FRANCISCANO DA BAHIA;BARRA;-12.065;-43.549;True;10096;5348;4748;1075;575;500;9021;4773;4248
2922300;Muritiba;BA;29;Nordeste;METROPOLITANA DE SALVADOR;SANTO ANTONIO DE JESUS;-12.626;-38.99;True;27212;12958;14214;17174;7991;9183;10038;4967;5031
2922409;Mutuípe;BA;29;Nordeste;CENTRO SUL BAIANO;JEQUIE;-13.229;-39.505;True;21181;10572;10564;9252;4273;4965;11929;6299;5599
2922508;Nazaré;BA;29;Nordeste;METROPOLITANA DE SALVADOR;SANTO ANTONIO DE JESUS;-13.035;-39.014;True;26506;12618;13426;23224;10890;11942;3282;1728;1484
2922607;Nilo Peçanha;BA;29;Nordeste;SUL BAIANO;VALENCA;-13.599;-39.107;True;12531;6486;5931;3012;1507;1490;9519;4979;4441
2922656;Nordestina;BA;29;Nordeste;NORDESTE BAIANO;EUCLIDES DA CUNHA;-10.823;-39.428;True;12172;6311;5837;3632;1777;1855;8540;4534;3982
2922706;Nova Canaã;BA;29;Nordeste;CENTRO SUL BAIANO;VITORIA DA CONQUISTA;-14.794;-40.142;True;18829;9628;9151;8533;4158;4350;10296;5470;4801
2922730;Nova Fátima;BA;29;Nordeste;NORDESTE BAIANO;SERRINHA;-11.606;-39.631;True;7674;3839;3835;4828;2323;2505;2846;1516;1330
2922755;Nova Ibiá;BA;29;Nordeste;SUL BAIANO;ILHEUS-ITABUNA;-13.81;-39.626;True;6871;3574;3274;2953;1457;1496;3918;2117;1778
2922805;Nova Itarana;BA;29;Nordeste;CENTRO SUL BAIANO;JEQUIE;-13.027;-40.069;True;7423;3799;3618;2653;1306;1347;4770;2493;2271
2922854;Nova Redenção;BA;29;Nordeste;CENTRO SUL BAIANO;SEABRA;-12.819;-41.071;True;8943;4538;4405;5130;2497;2633;3813;2041;1772
2922904;Nova Soure;BA;29;Nordeste;NORDESTE BAIANO;RIBEIRA DO POMBAL;-11.233;-38.483;True;25697;12906;12537;11015;5300;5711;14682;7606;6826
2923001;Nova Viçosa;BA;29;Nordeste;SUL BAIANO;PORTO SEGURO;-17.892;-39.372;True;34623;17516;17024;27108;13595;13469;7515;3921;3555
2923035;Novo Horizonte;BA;29;Nordeste;CENTRO SUL BAIANO;BOQUIRA;-12.808;-42.168;True;10304;5358;4937;3161;1614;1538;7143;3744;3399
2923050;Novo Triunfo;BA;29;Nordeste;NORDESTE BAIANO;RIBEIRA DO POMBAL;-10.317;-38.406;True;14153;6980;7166;6119;2955;3164;8034;4025;4002
2923100;Olindina;BA;29;Nordeste;NORDESTE BAIANO;RIBEIRA DO POMBAL;-11.367;-38.333;True;23791;11854;11921;12376;6034;6334;11415;5820;5587
2923209;Oliveira dos Brejinhos;BA;29;Nordeste;CENTRO SUL BAIANO;BOQUIRA;-12.317;-42.896;True;22609;11570;10856;6575;3250;3322;16034;8320;7534
2923308;Ouriçangas;BA;29;Nordeste;CENTRO NORTE BAIANO;FEIRA DE SANTANA;-12.017;-38.617;True;7802;3900;3895;2865;1381;1477;4937;2519;2418
2923357;Ourolândia;BA;29;Nordeste;CENTRO NORTE BAIANO;JACOBINA;-10.97;-41.083;True;16302;8216;7866;5402;2660;2742;10900;5556;5124
2923407;Palmas de Monte Alto;BA;29;Nordeste;CENTRO SUL BAIANO;GUANAMBI;-14.267;-43.162;True;21107;10765;10338;8389;4049;4336;12718;6716;6002
2923506;Palmeiras;BA;29;Nordeste;CENTRO SUL BAIANO;SEABRA;-12.529;-41.559;True;8040;3956;4063;4122;1959;2163;3918;1997;1900
2923605;Paramirim;BA;29;Nordeste;CENTRO SUL BAIANO;LIVRAMENTO DO BRUMADO;-13.443;-42.239;True;20055;10095;9901;9036;4379;4657;11019;5716;5244
2923704;Paratinga;BA;29;Nordeste;VALE SAO-FRANCISCANO DA BAHIA;BOM JESUS DA LAPA;-12.691;-43.184;True;28671;14530;13943;9582;4641;4882;19089;9889;9061
2923803;Paripiranga;BA;29;Nordeste;NORDESTE BAIANO;RIBEIRA DO POMBAL;-10.688;-37.862;True;28347;13963;14361;9003;4167;4836;19344;9796;9525
2923902;Pau Brasil;BA;29;Nordeste;SUL BAIANO;ILHEUS-ITABUNA;-15.464;-39.651;True;12155;6235;5883;8056;3979;4077;4099;2256;1806
2924009;Paulo Afonso;BA;29;Nordeste;VALE SAO-FRANCISCANO DA BAHIA;PAULO AFONSO;-9.408;-38.222;True;101952;48720;53025;87411;41285;45958;14541;7435;7067
2924058;Pé de Serra;BA;29;Nordeste;NORDESTE BAIANO;SERRINHA;-11.834;-39.613;True;14160;7149;7008;4994;2375;2616;9166;4774;4392
2924108;Pedrão;BA;29;Nordeste;CENTRO NORTE BAIANO;FEIRA DE SANTANA;-12.15;-38.65;True;7238;3649;3586;1554;748;806;5684;2901;2780
2924207;Pedro Alexandre;BA;29;Nordeste;NORDESTE BAIANO;JEREMOABO;-10.014;-37.894;True;17092;8755;8337;2617;1247;1370;14475;7508;6967
2924306;Piatã;BA;29;Nordeste;CENTRO SUL BAIANO;SEABRA;-13.152;-41.773;True;18085;8771;9148;7217;3445;3766;10868;5326;5382
2924405;Pilão Arcado;BA;29;Nordeste;VALE SAO-FRANCISCANO DA BAHIA;JUAZEIRO;-10.003;-42.504;True;32844;16693;16078;9824;4776;5032;23020;11917;11046
2924504;Pindaí;BA;29;Nordeste;CENTRO SUL BAIANO;GUANAMBI;-14.493;-42.687;True;15306;7823;7480;3946;1928;2018;11360;5895;5462
2924603;Pindobaçu;BA;29;Nordeste;CENTRO NORTE BAIANO;SENHOR DO BONFIM;-10.743;-40.363;True;20312;10410;9843;10827;5387;5429;9485;5023;4414
2924652;Pintadas;BA;29;Nordeste;CENTRO NORTE BAIANO;FEIRA DE SANTANA;-11.813;-39.909;True;10551;5264;5272;5099;2438;2655;5452;2826;2617
2924678;Piraí do Norte;BA;29;Nordeste;SUL BAIANO;VALENCA;-13.762;-39.379;True;8897;4558;4042;3246;1636;1604;5651;2922;2438
2924702;Piripá;BA;29;Nordeste;CENTRO SUL BAIANO;BRUMADO;-14.94;-41.72;True;13515;6800;6715;6583;3201;3382;6932;3599;3333
2924801;Piritiba;BA;29;Nordeste;CENTRO NORTE BAIANO;JACOBINA;-11.73;-40.555;True;24189;12142;11907;15136;7441;7642;9053;4701;4265
2924900;Planaltino;BA;29;Nordeste;CENTRO SUL BAIANO;JEQUIE;-13.259;-40.369;True;8472;4361;4016;3468;1719;1749;5004;2642;2267
2925006;Planalto;BA;29;Nordeste;CENTRO SUL BAIANO;VITORIA DA CONQUISTA;-14.67;-40.471;True;21486;10611;10835;13776;6691;7070;7710;3920;3765
2925105;PoçõEs;BA;29;Nordeste;CENTRO SUL BAIANO;VITORIA DA CONQUISTA;-14.53;-40.365;True;44759;21924;22748;32623;15693;16930;12136;6231;5818
2925204;Pojuca;BA;29;Nordeste;METROPOLITANA DE SALVADOR;CATU;-12.431;-38.328;True;30221;14554;15455;26218;12490;13561;4003;2064;1894
2925253;Ponto Novo;BA;29;Nordeste;CENTRO NORTE BAIANO;JACOBINA;-10.862;-40.134;True;14820;7525;7237;7903;3873;4007;6917;3652;3230
2925303;Porto Seguro;BA;29;Nordeste;SUL BAIANO;PORTO SEGURO;-16.45;-39.065;True;114459;57268;56441;95814;47546;47749;18645;9722;8692
2925402;Potiraguá;BA;29;Nordeste;CENTRO SUL BAIANO;ITAPETINGA;-15.595;-39.877;True;10350;5358;4967;6570;3345;3217;3780;2013;1750
2925501;Prado;BA;29;Nordeste;SUL BAIANO;PORTO SEGURO;-17.341;-39.221;True;25429;12483;11952;14758;6888;7083;10671;5595;4869
2925600;Presidente Dutra;BA;29;Nordeste;CENTRO NORTE BAIANO;IRECE;-11.296;-41.987;True;13822;7107;6713;8263;4153;4110;5559;2954;2603
2925709;Presidente Jânio Quadros;BA;29;Nordeste;CENTRO SUL BAIANO;BRUMADO;-14.689;-41.678;True;14803;7531;7267;3864;1910;1954;10939;5621;5313
2925758;Presidente Tancredo Neves;BA;29;Nordeste;SUL BAIANO;VALENCA;-13.449;-39.42;True;22684;11746;10760;8198;4028;4079;14486;7718;6681
2925808;Queimadas;BA;29;Nordeste;NORDESTE BAIANO;EUCLIDES DA CUNHA;-10.978;-39.624;True;27186;13419;13322;13078;6306;6737;14108;7113;6585
2925907;Quijingue;BA;29;Nordeste;NORDESTE BAIANO;EUCLIDES DA CUNHA;-10.753;-39.21;True;27068;13976;13014;6206;2999;3204;20862;10977;9810
2925931;Quixabeira;BA;29;Nordeste;CENTRO NORTE BAIANO;JACOBINA;-11.412;-40.128;True;9348;4754;4522;3420;1681;1700;5928;3073;2822
2925956;Rafael Jambeiro;BA;29;Nordeste;CENTRO NORTE BAIANO;FEIRA DE SANTANA;-12.408;-39.501;True;23107;11142;11791;5961;2816;3139;17146;8326;8652
2926004;Remanso;BA;29;Nordeste;VALE SAO-FRANCISCANO DA BAHIA;JUAZEIRO;-9.622;-42.081;True;38004;19120;18799;21535;10416;11111;16469;8704;7688
2926103;Retirolândia;BA;29;Nordeste;NORDESTE BAIANO;SERRINHA;-11.495;-39.426;True;11938;5963;5975;6379;3113;3266;5559;2850;2709
2926202;Riachão das Neves;BA;29;Nordeste;EXTREMO OESTE BAIANO;BARREIRAS;-11.746;-44.91;True;22528;11928;10441;10674;5537;5111;11854;6391;5330
2926301;Riachão do Jacuípe;BA;29;Nordeste;NORDESTE BAIANO;SERRINHA;-11.81;-39.382;True;32522;15994;16508;16640;7798;8838;15882;8196;7670
2926400;Riacho de Santana;BA;29;Nordeste;CENTRO SUL BAIANO;GUANAMBI;-13.609;-42.939;True;29425;14851;14533;12287;5963;6324;17138;8888;8209
2926509;Ribeira do Amparo;BA;29;Nordeste;NORDESTE BAIANO;RIBEIRA DO POMBAL;-11.047;-38.433;True;14101;7285;6800;1925;967;958;12176;6318;5842
2926608;Ribeira do Pombal;BA;29;Nordeste;NORDESTE BAIANO;RIBEIRA DO POMBAL;-10.834;-38.536;True;47400;23434;23959;28012;13446;14561;19388;9988;9398
2926657;Ribeirão do Largo;BA;29;Nordeste;CENTRO SUL BAIANO;ITAPETINGA;-15.459;-40.739;True;14297;7331;6789;6089;3049;3018;8208;4282;3771
2926707;Rio de Contas;BA;29;Nordeste;CENTRO SUL BAIANO;SEABRA;-13.579;-41.811;True;13447;6372;6843;6003;2774;3104;7444;3598;3739
2926806;Rio do Antônio;BA;29;Nordeste;CENTRO SUL BAIANO;BRUMADO;-14.411;-42.076;True;15096;7618;7478;5623;2744;2879;9473;4874;4599
2926905;Rio do Pires;BA;29;Nordeste;CENTRO SUL BAIANO;LIVRAMENTO DO BRUMADO;-13.128;-42.292;True;11385;5603;5761;4753;2282;2471;6632;3321;3290
2927002;Rio Real;BA;29;Nordeste;NORDESTE BAIANO;ALAGOINHAS;-11.485;-37.933;True;36169;18333;17813;22491;11157;11319;13678;7176;6494
2927101;Rodelas;BA;29;Nordeste;VALE SAO-FRANCISCANO DA BAHIA;PAULO AFONSO;-8.851;-38.756;True;7023;3468;3476;5479;2709;2738;1544;759;738
2927200;Ruy Barbosa;BA;29;Nordeste;CENTRO NORTE BAIANO;ITABERABA;-12.284;-40.494;True;29358;14223;14930;21102;9833;11114;8256;4390;3816
2927309;Salinas da Margarida;BA;29;Nordeste;METROPOLITANA DE SALVADOR;SANTO ANTONIO DE JESUS;-12.871;-38.764;True;13090;6390;6547;5741;2778;2879;7349;3612;3668
2927408;Salvador;BA;29;Nordeste;METROPOLITANA DE SALVADOR;SALVADOR;-12.971;-38.511;True;2892625;;;;;;;;
2927507;Santa Bárbara;BA;29;Nordeste;CENTRO NORTE BAIANO;FEIRA DE SANTANA;-11.958;-38.975;True;19440;9542;9830;8025;3755;4242;11415;5787;5588
2927606;Santa Brígida;BA;29;Nordeste;NORDESTE BAIANO;JEREMOABO;-9.736;-38.126;True;15483;7903;7539;4940;2368;2572;10543;5535;4967
2927705;Santa Cruz Cabrália;BA;29;Nordeste;SUL BAIANO;PORTO SEGURO;-16.278;-39.025;True;25110;12803;12195;17768;8879;8799;7342;3924;3396
2927804;Santa Cruz da Vitória;BA;29;Nordeste;SUL BAIANO;ILHEUS-ITABUNA;-14.961;-39.812;True;6386;3321;3062;5088;2562;2523;1298;759;539
2927903;Santa Inês;BA;29;Nordeste;CENTRO SUL BAIANO;JEQUIE;-13.292;-39.819;True;10564;5276;5285;9484;4656;4828;1080;620;457
2928000;Santaluz;BA;29;Nordeste;NORDESTE BAIANO;SERRINHA;-11.256;-39.375;True;33633;16693;16792;20364;9806;10525;13269;6887;6267
2928059;Santa Luzia;BA;29;Nordeste;SUL BAIANO;ILHEUS-ITABUNA;-15.429;-39.334;True;15184;7951;7052;8394;4249;4145;6790;3702;2907
2928109;Santa Maria da Vitória;BA;29;Nordeste;EXTREMO OESTE BAIANO;SANTA MARIA DA VITORIA;-13.398;-44.198;True;40571;20408;19984;23154;11343;11744;17417;9065;8240
2928208;Santana;BA;29;Nordeste;EXTREMO OESTE BAIANO;SANTA MARIA DA VITORIA;-12.983;-44.051;True;25947;13307;12640;13346;6631;6715;12601;6676;5925
2928307;Santanópolis;BA;29;Nordeste;CENTRO NORTE BAIANO;FEIRA DE SANTANA;-12.017;-38.867;True;9199;4523;4668;1544;739;801;7655;3784;3867
2928406;Santa Rita de Cássia;BA;29;Nordeste;EXTREMO OESTE BAIANO;COTEGIPE;-11.009;-44.519;True;26135;13355;12315;13510;6576;6753;12625;6779;5562
2928505;Santa Teresinha;BA;29;Nordeste;CENTRO NORTE BAIANO;FEIRA DE SANTANA;-12.772;-39.523;True;9914;4869;4634;2281;1087;1171;7633;3782;3463
2928604;Santo Amaro;BA;29;Nordeste;METROPOLITANA DE SALVADOR;SANTO ANTONIO DE JESUS;-12.547;-38.712;True;58028;27984;30037;43461;20555;22899;14567;7429;7138
2928703;Santo Antônio de Jesus;BA;29;Nordeste;METROPOLITANA DE SALVADOR;SANTO ANTONIO DE JESUS;-12.969;-39.261;True;84256;40023;44230;73312;34389;38923;10944;5634;5307
2928802;Santo Estêvão;BA;29;Nordeste;CENTRO NORTE BAIANO;FEIRA DE SANTANA;-12.43;-39.251;True;44532;21319;23179;23558;11097;12436;20974;10222;10743
2928901;São Desidério;BA;29;Nordeste;EXTREMO OESTE BAIANO;BARREIRAS;-12.363;-44.973;True;25158;13043;12093;8236;4079;4157;16922;8964;7936
2928950;São Domingos;BA;29;Nordeste;NORDESTE BAIANO;SERRINHA;-11.503;-39.542;True;8818;4407;4411;4498;2172;2326;4320;2235;2085
2929008;São Félix;BA;29;Nordeste;METROPOLITANA DE SALVADOR;SANTO ANTONIO DE JESUS;-12.605;-38.972;True;15302;7500;7792;10113;4849;5262;5189;2651;2530
2929057;São Félix do Coribe;BA;29;Nordeste;EXTREMO OESTE BAIANO;SANTA MARIA DA VITORIA;-13.402;-44.195;True;12815;6457;6350;9758;4785;4965;3057;1672;1385
2929107;São Felipe;BA;29;Nordeste;METROPOLITANA DE SALVADOR;SANTO ANTONIO DE JESUS;-12.847;-39.089;True;20265;10173;10086;8971;4270;4699;11294;5903;5387
2929206;São Francisco do Conde;BA;29;Nordeste;METROPOLITANA DE SALVADOR;SALVADOR;-12.628;-38.68;True;29829;14507;14836;23930;11587;11994;5899;2920;2842
2929255;São Gabriel;BA;29;Nordeste;CENTRO NORTE BAIANO;IRECE;-11.229;-41.912;True;18468;9526;8935;10176;5130;5046;8292;4396;3889
2929305;São Gonçalo dos Campos;BA;29;Nordeste;CENTRO NORTE BAIANO;FEIRA DE SANTANA;-12.433;-38.967;True;29205;14101;15066;14343;6733;7581;14862;7368;7485
2929354;São José da Vitória;BA;29;Nordeste;SUL BAIANO;ILHEUS-ITABUNA;-15.084;-39.339;True;6095;3120;2961;5411;2732;2665;684;388;296
2929370;São José do Jacuípe;BA;29;Nordeste;CENTRO NORTE BAIANO;JACOBINA;-11.412;-39.867;True;10477;5216;5083;6723;3290;3409;3754;1926;1674
2929404;São Miguel das Matas;BA;29;Nordeste;CENTRO SUL BAIANO;JEQUIE;-13.048;-39.456;True;10270;5230;5025;3225;1566;1655;7045;3664;3370
2929503;São Sebastião do Passé;BA;29;Nordeste;METROPOLITANA DE SALVADOR;CATU;-12.513;-38.495;True;40321;19946;20318;31500;15298;16189;8821;4648;4129
2929602;Sapeaçu;BA;29;Nordeste;METROPOLITANA DE SALVADOR;SANTO ANTONIO DE JESUS;-12.728;-39.182;True;16518;7923;8445;8100;3754;4308;8418;4169;4137
2929701;Sátiro Dias;BA;29;Nordeste;NORDESTE BAIANO;ALAGOINHAS;-11.6;-38.6;True;18104;9154;8888;3913;1877;2036;14191;7277;6852
2929750;Saubara;BA;29;Nordeste;METROPOLITANA DE SALVADOR;SANTO ANTONIO DE JESUS;-12.738;-38.769;True;11051;5489;5551;10705;5301;5404;346;188;147
2929800;Saúde;BA;29;Nordeste;CENTRO NORTE BAIANO;JACOBINA;-10.941;-40.418;True;11866;5879;5829;6456;3126;3292;5410;2753;2537
2929909;Seabra;BA;29;Nordeste;CENTRO SUL BAIANO;SEABRA;-12.419;-41.77;True;40543;20180;20363;18642;8982;9660;21901;11198;10703
2930006;Sebastião Laranjeiras;BA;29;Nordeste;CENTRO SUL BAIANO;GUANAMBI;-14.573;-42.94;True;10712;5470;5208;4041;2038;2003;6671;3432;3205
2930105;Senhor do Bonfim;BA;29;Nordeste;CENTRO NORTE BAIANO;SENHOR DO BONFIM;-10.463;-40.191;True;72511;35297;37161;55293;26419;28852;17218;8878;8309
2930154;Serra do Ramalho;BA;29;Nordeste;VALE SAO-FRANCISCANO DA BAHIA;BOM JESUS DA LAPA;-13.572;-43.598;True;31130;16096;14966;5423;2722;2701;25707;13374;12265
2930204;Sento Sé;BA;29;Nordeste;VALE SAO-FRANCISCANO DA BAHIA;JUAZEIRO;-9.746;-41.885;True;36517;18772;17420;21064;10668;10393;15453;8104;7027
2930303;Serra Dourada;BA;29;Nordeste;EXTREMO OESTE BAIANO;SANTA MARIA DA VITORIA;-12.761;-43.95;True;17422;9029;8393;5777;2840;2937;11645;6189;5456
2930402;Serra Preta;BA;29;Nordeste;CENTRO NORTE BAIANO;FEIRA DE SANTANA;-12.16;-39.332;True;15149;7500;7637;6302;3026;3264;8847;4474;4373
2930501;Serrinha;BA;29;Nordeste;NORDESTE BAIANO;SERRINHA;-11.664;-39.008;True;71383;34914;36412;44166;20936;23230;27217;13978;13182
2930600;Serrolândia;BA;29;Nordeste;CENTRO NORTE BAIANO;JACOBINA;-11.416;-40.302;True;12120;6073;6028;6979;3402;3577;5141;2671;2451
2930709;SimõEs Filho;BA;29;Nordeste;METROPOLITANA DE SALVADOR;SALVADOR;-12.784;-38.404;True;109269;53712;54968;97624;47737;49368;11645;5975;5600
2930758;Sítio do Mato;BA;29;Nordeste;VALE SAO-FRANCISCANO DA BAHIA;BOM JESUS DA LAPA;-13.085;-43.465;True;12567;6561;5994;6429;3263;3163;6138;3298;2831
2930766;Sítio do Quinto;BA;29;Nordeste;NORDESTE BAIANO;JEREMOABO;-10.35;-38.217;True;14069;7132;6937;4607;2260;2347;9462;4872;4590
2930774;Sobradinho;BA;29;Nordeste;VALE SAO-FRANCISCANO DA BAHIA;JUAZEIRO;-9.455;-40.823;True;21315;10369;10704;19144;9252;9786;2171;1117;918
2930808;Souto Soares;BA;29;Nordeste;CENTRO NORTE BAIANO;IRECE;-12.089;-41.638;True;18013;9256;8748;6152;3094;3058;11861;6162;5690
2930907;Tabocas do Brejo Velho;BA;29;Nordeste;EXTREMO OESTE BAIANO;COTEGIPE;-12.706;-44.007;True;12281;6411;5857;3708;1857;1851;8573;4554;4006
2931004;Tanhaçu;BA;29;Nordeste;CENTRO SUL BAIANO;BRUMADO;-14.021;-41.248;True;19591;9763;9600;7955;3818;4115;11636;5945;5485
2931053;Tanque Novo;BA;29;Nordeste;CENTRO SUL BAIANO;BOQUIRA;-13.546;-42.491;True;15745;7984;7723;6369;3185;3184;9376;4799;4539
2931103;Tanquinho;BA;29;Nordeste;CENTRO NORTE BAIANO;FEIRA DE SANTANA;-11.979;-39.104;True;7589;3757;3832;5410;2592;2818;2179;1165;1014
2931202;Taperoá;BA;29;Nordeste;SUL BAIANO;VALENCA;-13.538;-39.099;True;18217;9230;8574;8344;3844;4193;9873;5386;4381
2931301;Tapiramutá;BA;29;Nordeste;CENTRO NORTE BAIANO;ITABERABA;-11.847;-40.791;True;17254;8720;8530;12533;6223;6306;4721;2497;2224
2931350;Teixeira de Freitas;BA;29;Nordeste;SUL BAIANO;PORTO SEGURO;-17.535;-39.742;True;118702;57876;59529;110084;53402;55455;8618;4474;4074
2931400;Teodoro Sampaio;BA;29;Nordeste;CENTRO NORTE BAIANO;FEIRA DE SANTANA;-12.303;-38.643;True;8306;4103;4203;6549;3150;3399;1757;953;804
2931509;Teofilândia;BA;29;Nordeste;NORDESTE BAIANO;SERRINHA;-11.489;-38.998;True;20702;10367;10319;6094;2894;3197;14608;7473;7122
2931608;Teolândia;BA;29;Nordeste;SUL BAIANO;ILHEUS-ITABUNA;-13.602;-39.491;True;12429;6522;5882;4125;1970;2155;8304;4552;3727
2931707;Terra Nova;BA;29;Nordeste;METROPOLITANA DE SALVADOR;CATU;-12.392;-38.625;True;12310;5961;6345;10863;5210;5649;1447;751;696
2931806;Tremedal;BA;29;Nordeste;CENTRO SUL BAIANO;BRUMADO;-14.976;-41.411;True;18483;9386;9095;3890;1925;1963;14593;7461;7132
2931905;Tucano;BA;29;Nordeste;NORDESTE BAIANO;EUCLIDES DA CUNHA;-10.963;-38.787;True;48740;24614;24003;19774;9489;10256;28966;15125;13747
2932002;Uauá;BA;29;Nordeste;NORDESTE BAIANO;EUCLIDES DA CUNHA;-9.842;-39.482;True;24662;12497;12124;10074;4817;5251;14588;7680;6873
2932101;Ubaíra;BA;29;Nordeste;CENTRO SUL BAIANO;JEQUIE;-13.268;-39.663;True;20708;10615;10057;8516;4104;4407;12192;6511;5650
2932200;Ubaitaba;BA;29;Nordeste;SUL BAIANO;ILHEUS-ITABUNA;-14.313;-39.323;True;20478;10085;10390;17967;8690;9274;2511;1395;1116
2932309;Ubatã;BA;29;Nordeste;SUL BAIANO;ILHEUS-ITABUNA;-14.214;-39.523;True;24791;12559;12114;17467;8468;8898;7324;4091;3216
2932408;Uibaí;BA;29;Nordeste;CENTRO NORTE BAIANO;IRECE;-11.337;-42.133;True;13719;6978;6730;8068;3981;4087;5651;2997;2643
2932457;Umburanas;BA;29;Nordeste;CENTRO NORTE BAIANO;SENHOR DO BONFIM;-10.733;-41.326;True;16081;8429;7624;7399;3826;3569;8682;4603;4055
2932507;Una;BA;29;Nordeste;SUL BAIANO;ILHEUS-ITABUNA;-15.293;-39.075;True;25277;12574;11582;14431;7001;7177;10846;5573;4405
2932606;Urandi;BA;29;Nordeste;CENTRO SUL BAIANO;GUANAMBI;-14.771;-42.655;True;15822;7992;7785;5473;2709;2761;10349;5283;5024
2932705;Uruçuca;BA;29;Nordeste;SUL BAIANO;ILHEUS-ITABUNA;-14.593;-39.284;True;22070;11045;11020;17636;8604;9029;4434;2441;1991
2932804;Utinga;BA;29;Nordeste;CENTRO SUL BAIANO;SEABRA;-12.082;-41.094;True;19229;9616;9586;13021;6342;6659;6208;3274;2927
2932903;Valença;BA;29;Nordeste;SUL BAIANO;VALENCA;-13.37;-39.073;True;84931;41698;42029;60241;28549;30818;24690;13149;11211
2933000;Valente;BA;29;Nordeste;NORDESTE BAIANO;SERRINHA;-11.412;-39.462;True;21512;10604;10908;11502;5426;6076;10010;5178;4832
2933059;Várzea da Roça;BA;29;Nordeste;CENTRO NORTE BAIANO;ITABERABA;-11.607;-40.137;True;14479;7215;6911;6356;3128;3228;8123;4087;3683
2933109;Várzea do Poço;BA;29;Nordeste;CENTRO NORTE BAIANO;JACOBINA;-11.529;-40.32;True;8569;4331;4225;5589;2767;2822;2980;1564;1403
2933158;Várzea Nova;BA;29;Nordeste;CENTRO NORTE BAIANO;JACOBINA;-11.259;-40.942;True;13949;7092;6823;8851;4337;4496;5098;2755;2327
2933174;Varzedo;BA;29;Nordeste;METROPOLITANA DE SALVADOR;SANTO ANTONIO DE JESUS;-12.971;-39.394;True;9054;4569;4482;3073;1497;1576;5981;3072;2906
2933208;Vera Cruz;BA;29;Nordeste;METROPOLITANA DE SALVADOR;SALVADOR;-12.96;-38.609;True;35060;17553;17363;33034;16464;16426;2026;1089;937
2933257;Vereda;BA;29;Nordeste;SUL BAIANO;PORTO SEGURO;-17.223;-40.09;True;7174;3739;3299;1585;825;760;5589;2914;2539
2933307;Vitória da Conquista;BA;29;Nordeste;CENTRO SUL BAIANO;VITORIA DA CONQUISTA;-14.866;-40.839;True;308204;;;;;;;;
2933406;Wagner;BA;29;Nordeste;CENTRO SUL BAIANO;SEABRA;-12.287;-41.168;True;8610;4283;4260;5951;2887;3064;2659;1396;1196
2933455;Wanderley;BA;29;Nordeste;EXTREMO OESTE BAIANO;COTEGIPE;-12.12;-43.888;True;12982;6772;6188;6000;2966;3034;6982;3806;3154
2933505;Wenceslau Guimarães;BA;29;Nordeste;SUL BAIANO;ILHEUS-ITABUNA;-13.687;-39.479;True;23985;12490;11464;7048;3459;3579;16937;9031;7885
2933604;Xique-Xique;BA;29;Nordeste;VALE SAO-FRANCISCANO DA BAHIA;BARRA;-10.822;-42.731;True;45700;22609;23042;31853;15233;16620;13847;7376;6422
3100104;Abadia dos Dourados;MG;31;Sudeste;TRIANGULO MINEIRO/ALTO PARANAIBA;PATROCINIO;-18.486;-47.403;True;6556;3381;3174;4098;2029;2069;2458;1352;1105
3100203;Abaeté;MG;31;Sudeste;CENTRAL MINEIRA;TRES MARIAS;-19.16;-45.446;True;22474;11089;11355;19504;9433;10069;2970;1656;1286
3100302;Abre Campo;MG;31;Sudeste;ZONA DA MATA;MANHUACU;-20.301;-42.478;True;12867;6386;6380;6645;3185;3437;6222;3201;2943
3100401;Acaiaca;MG;31;Sudeste;ZONA DA MATA;PONTE NOVA;-20.363;-43.145;True;4056;1999;2016;2508;1223;1258;1548;776;758
3100500;Açucena;MG;31;Sudeste;VALE DO RIO DOCE;IPATINGA;-19.073;-42.546;True;11127;5495;5237;4515;2222;2225;6612;3273;3012
3100609;Água Boa;MG;31;Sudeste;VALE DO RIO DOCE;PECANHA;-17.996;-42.389;True;16435;8394;8000;6988;3373;3595;9447;5021;4405
3100708;Água Comprida;MG;31;Sudeste;TRIANGULO MINEIRO/ALTO PARANAIBA;UBERABA;-20.056;-48.109;True;2093;1044;976;1546;751;756;547;293;220
3100807;Aguanil;MG;31;Sudeste;OESTE DE MINAS;CAMPO BELO;-20.943;-45.393;True;4054;2078;1941;2241;1107;1134;1813;971;807
3100906;Águas Formosas;MG;31;Sudeste;VALE DO MUCURI;NANUQUE;-17.082;-40.936;True;18518;9483;8992;14073;7085;6967;4445;2398;2025
3101003;Águas Vermelhas;MG;31;Sudeste;NORTE DE MINAS;SALINAS;-15.747;-41.46;True;12674;6507;6159;8838;4484;4354;3836;2023;1805
3101102;Aimorés;MG;31;Sudeste;VALE DO RIO DOCE;AIMORES;-19.496;-41.064;True;24232;11789;12430;19051;9060;9983;5181;2729;2447
3101201;Aiuruoca;MG;31;Sudeste;SUL/SUDOESTE DE MINAS;ANDRELANDIA;-21.976;-44.603;True;6099;3173;2926;3132;1564;1568;2967;1609;1358
3101300;Alagoa;MG;31;Sudeste;SUL/SUDOESTE DE MINAS;SAO LOURENCO;-22.171;-44.642;True;2825;1478;1347;1083;518;565;1742;960;782
3101409;Albertina;MG;31;Sudeste;SUL/SUDOESTE DE MINAS;POCOS DE CALDAS;-22.201;-46.616;True;2872;1461;1371;1963;978;947;909;483;424
3101508;Além Paraíba;MG;31;Sudeste;ZONA DA MATA;CATAGUASES;-21.888;-42.704;True;33495;16067;17404;30866;14705;16155;2629;1362;1249
3101607;Alfenas;MG;31;Sudeste;SUL/SUDOESTE DE MINAS;ALFENAS;-21.429;-45.947;True;71628;35168;36460;67162;32780;34382;4466;2388;2078
3101631;Alfredo Vasconcelos;MG;31;Sudeste;CAMPO DAS VERTENTES;BARBACENA;-21.145;-43.777;True;5900;3028;2872;3831;1932;1899;2069;1096;973
3101706;Almenara;MG;31;Sudeste;JEQUITINHONHA;ALMENARA;-16.184;-40.694;True;36907;18335;18290;29981;14523;15290;6926;3812;3000
3101805;Alpercata;MG;31;Sudeste;VALE DO RIO DOCE;GOVERNADOR VALADARES;-18.974;-41.97;True;7007;3471;3524;5331;2627;2704;1676;844;820
3101904;Alpinópolis;MG;31;Sudeste;SUL/SUDOESTE DE MINAS;PASSOS;-20.864;-46.388;True;17821;9192;8627;14319;7264;7055;3502;1928;1572
3102001;Alterosa;MG;31;Sudeste;SUL/SUDOESTE DE MINAS;ALFENAS;-21.249;-46.143;True;13286;6785;6477;9831;4954;4858;3455;1831;1619
3102050;Alto Caparaó;MG;31;Sudeste;ZONA DA MATA;MANHUACU;-20.434;-41.868;True;5048;2541;2409;3709;1880;1826;1339;661;583
3102100;Alto Rio Doce;MG;31;Sudeste;ZONA DA MATA;VICOSA;-21.026;-43.411;True;12657;6321;6336;4825;2288;2537;7832;4033;3799
3102209;Alvarenga;MG;31;Sudeste;VALE DO RIO DOCE;AIMORES;-19.417;-41.729;True;4558;2206;2160;2240;999;1062;2318;1207;1098
3102308;Alvinópolis;MG;31;Sudeste;METROPOLITANA DE BELO HORIZONTE;ITABIRA;-20.107;-43.049;True;15251;7502;7740;11063;5277;5780;4188;2225;1960
3102407;Alvorada de Minas;MG;31;Sudeste;METROPOLITANA DE BELO HORIZONTE;CONCEICAO DO MATO DENTRO;-18.736;-43.365;True;3482;1741;1738;1269;607;659;2213;1134;1079
3102506;Amparo do Serra;MG;31;Sudeste;ZONA DA MATA;VICOSA;-20.507;-42.803;True;5245;2605;2640;2591;1246;1345;2654;1359;1295
3102605;Andradas;MG;31;Sudeste;SUL/SUDOESTE DE MINAS;POCOS DE CALDAS;-22.068;-46.569;True;34956;17546;17402;26450;12941;13509;8506;4605;3893
3102704;Cachoeira de Pajeú;MG;31;Sudeste;JEQUITINHONHA;PEDRA AZUL;-15.966;-41.498;True;9089;4626;4423;4686;2352;2332;4403;2274;2091
3102803;Andrelândia;MG;31;Sudeste;SUL/SUDOESTE DE MINAS;ANDRELANDIA;-21.74;-44.309;True;12035;6063;5957;9391;4579;4807;2644;1484;1150
3102852;Angelândia;MG;31;Sudeste;JEQUITINHONHA;CAPELINHA;-17.73;-42.265;True;8130;4028;4075;3953;1924;2014;4177;2104;2061
3102902;Antônio Carlos;MG;31;Sudeste;CAMPO DAS VERTENTES;BARBACENA;-21.318;-43.747;True;11172;5520;5603;6808;3262;3516;4364;2258;2087
3103009;Antônio Dias;MG;31;Sudeste;VALE DO RIO DOCE;IPATINGA;-19.653;-42.872;True;9435;4746;4572;4308;2089;2184;5127;2657;2388
3103108;Antônio Prado de Minas;MG;31;Sudeste;ZONA DA MATA;MURIAE;-21.016;-42.109;True;1962;1019;935;1233;629;600;729;390;335
3103207;Araçaí;MG;31;Sudeste;METROPOLITANA DE BELO HORIZONTE;SETE LAGOAS;-19.199;-44.248;True;2384;1148;1223;1817;834;970;567;314;253
3103306;Aracitaba;MG;31;Sudeste;ZONA DA MATA;JUIZ DE FORA;-21.343;-43.378;True;1875;949;909;1394;682;697;481;267;212
3103405;Araçuaí;MG;31;Sudeste;JEQUITINHONHA;ARACUAI;-16.85;-42.07;True;36083;17939;18121;22400;10738;11657;13683;7201;6464
3103504;Araguari;MG;31;Sudeste;TRIANGULO MINEIRO/ALTO PARANAIBA;UBERLANDIA;-18.649;-48.187;True;106403;52105;53777;99439;48239;50724;6964;3866;3053
3103603;Arantina;MG;31;Sudeste;SUL/SUDOESTE DE MINAS;ANDRELANDIA;-21.911;-44.256;True;2544;1280;1264;2344;1169;1175;200;111;89
3103702;Araponga;MG;31;Sudeste;ZONA DA MATA;VICOSA;-20.667;-42.521;True;8029;4116;3793;2784;1352;1372;5245;2764;2421
3103751;Araporã;MG;31;Sudeste;TRIANGULO MINEIRO/ALTO PARANAIBA;UBERLANDIA;-18.437;-49.187;True;6113;3159;2740;5703;2933;2559;410;226;181
3103801;Arapuá;MG;31;Sudeste;TRIANGULO MINEIRO/ALTO PARANAIBA;PATOS DE MINAS;-19.034;-46.156;True;2699;1376;1320;1946;974;972;753;402;348
3103900;Araújos;MG;31;Sudeste;CENTRAL MINEIRA;BOM DESPACHO;-19.948;-45.166;True;7201;3640;3473;6200;3100;3031;1001;540;442
3104007;Araxá;MG;31;Sudeste;TRIANGULO MINEIRO/ALTO PARANAIBA;ARAXA;-19.593;-46.941;True;87764;43121;44283;86320;42315;43659;1444;806;624
3104106;Arceburgo;MG;31;Sudeste;SUL/SUDOESTE DE MINAS;SAO SEBASTIAO DO PARAISO;-21.364;-46.94;True;7994;4020;3974;6814;3402;3412;1180;618;562
3104205;Arcos;MG;31;Sudeste;OESTE DE MINAS;FORMIGA;-20.282;-45.539;True;34763;16959;17059;31803;15450;15777;2960;1509;1282
3104304;Areado;MG;31;Sudeste;SUL/SUDOESTE DE MINAS;ALFENAS;-21.359;-46.146;True;13181;6685;6496;10944;5479;5465;2237;1206;1031
3104403;Argirita;MG;31;Sudeste;ZONA DA MATA;CATAGUASES;-21.61;-42.836;True;2995;1511;1479;2078;1026;1052;917;485;427
3104452;Aricanduva;MG;31;Sudeste;JEQUITINHONHA;CAPELINHA;-17.867;-42.557;True;4832;2483;2346;1510;715;795;3322;1768;1551
3104502;Arinos;MG;31;Sudeste;NOROESTE DE MINAS;UNAI;-15.917;-46.106;True;17592;9037;8279;10817;5282;5307;6775;3755;2972
3104601;Astolfo Dutra;MG;31;Sudeste;ZONA DA MATA;UBA;-21.315;-42.862;True;12510;6323;6173;11260;5648;5598;1250;675;575
3104700;Ataléia;MG;31;Sudeste;VALE DO MUCURI;TEOFILO OTONI;-18.044;-41.11;True;15078;7664;7360;7121;3446;3663;7957;4218;3697
3104809;Augusto de Lima;MG;31;Sudeste;CENTRAL MINEIRA;CURVELO;-18.109;-44.267;True;4589;2253;2142;2563;1207;1177;2026;1046;965
3104908;Baependi;MG;31;Sudeste;SUL/SUDOESTE DE MINAS;SAO LOURENCO;-21.959;-44.89;True;18016;9209;8802;12734;6340;6392;5282;2869;2410
3105004;Baldim;MG;31;Sudeste;METROPOLITANA DE BELO HORIZONTE;SETE LAGOAS;-19.288;-43.957;True;8274;4140;4117;5039;2426;2613;3235;1714;1504
3105103;Bambuí;MG;31;Sudeste;OESTE DE MINAS;PIUI;-20.006;-45.977;True;21850;10805;11028;18081;8632;9442;3769;2173;1586
3105202;Bandeira;MG;31;Sudeste;JEQUITINHONHA;ALMENARA;-15.885;-40.559;True;5337;2664;2478;2493;1239;1236;2844;1425;1242
3105301;Bandeira do Sul;MG;31;Sudeste;SUL/SUDOESTE DE MINAS;POCOS DE CALDAS;-21.728;-46.386;True;5106;2636;2464;4522;2319;2197;584;317;267
3105400;Barão de Cocais;MG;31;Sudeste;METROPOLITANA DE BELO HORIZONTE;ITABIRA;-19.946;-43.487;True;26421;12889;12960;23992;11656;11869;2429;1233;1091
3105509;Barão de Monte Alto;MG;31;Sudeste;ZONA DA MATA;MURIAE;-21.245;-42.238;True;5656;2815;2841;3823;1888;1935;1833;927;906
3105608;Barbacena;MG;31;Sudeste;CAMPO DAS VERTENTES;BARBACENA;-21.226;-43.774;True;122377;58208;63878;112563;53172;59166;9814;5036;4712
3105707;Barra Longa;MG;31;Sudeste;ZONA DA MATA;PONTE NOVA;-20.283;-43.041;True;6965;3425;3451;2391;1131;1240;4574;2294;2211
3105905;Barroso;MG;31;Sudeste;CAMPO DAS VERTENTES;BARBACENA;-21.187;-43.976;True;19352;9455;9813;18799;9172;9543;553;283;270
3106002;Bela Vista de Minas;MG;31;Sudeste;METROPOLITANA DE BELO HORIZONTE;ITABIRA;-19.83;-43.091;True;9968;4784;5152;9334;4467;4848;634;317;304
3106101;Belmiro Braga;MG;31;Sudeste;ZONA DA MATA;JUIZ DE FORA;-21.949;-43.415;True;3067;1530;1537;1068;505;563;1999;1025;974
3106200;Belo Horizonte;MG;31;Sudeste;METROPOLITANA DE BELO HORIZONTE;BELO HORIZONTE;-19.817;-43.956;True;2412937;;;;;;;;
3106309;Belo Oriente;MG;31;Sudeste;VALE DO RIO DOCE;IPATINGA;-19.22;-42.484;True;21369;10393;10480;17892;8678;8824;3477;1715;1656
3106408;Belo Vale;MG;31;Sudeste;METROPOLITANA DE BELO HORIZONTE;ITAGUARA;-20.408;-44.024;True;7267;3628;3637;3103;1491;1612;4164;2137;2025
3106507;Berilo;MG;31;Sudeste;JEQUITINHONHA;CAPELINHA;-16.952;-42.466;True;13214;6668;6368;3689;1766;1843;9525;4902;4525
3106606;Bertópolis;MG;31;Sudeste;VALE DO MUCURI;NANUQUE;-17.063;-40.574;True;4588;2422;2104;2521;1310;1211;2067;1112;893
3106655;Berizal;MG;31;Sudeste;NORTE DE MINAS;SALINAS;-15.613;-41.745;True;4399;2231;2141;2385;1177;1206;2014;1054;935
3106705;Betim;MG;31;Sudeste;METROPOLITANA DE BELO HORIZONTE;BELO HORIZONTE;-19.968;-44.198;True;415098;;;;;;;;
3106804;Bias Fortes;MG;31;Sudeste;ZONA DA MATA;JUIZ DE FORA;-21.606;-43.757;True;3880;1991;1888;1603;765;838;2277;1226;1050
3106903;Bicas;MG;31;Sudeste;ZONA DA MATA;JUIZ DE FORA;-21.725;-43.059;True;13638;6570;7060;12637;6046;6586;1001;524;474
3107000;Biquinhas;MG;31;Sudeste;CENTRAL MINEIRA;TRES MARIAS;-18.783;-45.502;True;2592;1311;1281;1572;762;810;1020;549;471
3107109;Boa Esperança;MG;31;Sudeste;SUL/SUDOESTE DE MINAS;VARGINHA;-21.09;-45.566;True;37801;18852;18813;31200;15313;15887;6601;3539;2926
3107208;Bocaina de Minas;MG;31;Sudeste;SUL/SUDOESTE DE MINAS;ANDRELANDIA;-22.168;-44.395;True;5034;2624;2408;2415;1222;1193;2619;1402;1215
3107307;Bocaiúva;MG;31;Sudeste;NORTE DE MINAS;BOCAIUVA;-17.108;-43.815;True;44657;22141;22038;34999;17166;17720;9658;4975;4318
3107406;Bom Despacho;MG;31;Sudeste;CENTRAL MINEIRA;BOM DESPACHO;-19.736;-45.252;True;42260;20863;21192;39494;19364;20031;2766;1499;1161
3107505;Bom Jardim de Minas;MG;31;Sudeste;SUL/SUDOESTE DE MINAS;ANDRELANDIA;-21.947;-44.191;True;6481;3227;3254;5637;2760;2877;844;467;377
3107604;Bom Jesus da Penha;MG;31;Sudeste;SUL/SUDOESTE DE MINAS;PASSOS;-21.017;-46.523;True;3787;1978;1809;2562;1316;1246;1225;662;563
3107703;Bom Jesus do Amparo;MG;31;Sudeste;METROPOLITANA DE BELO HORIZONTE;ITABIRA;-19.704;-43.474;True;5412;2706;2700;2555;1243;1312;2857;1463;1388
3107802;Bom Jesus do Galho;MG;31;Sudeste;VALE DO RIO DOCE;CARATINGA;-19.829;-42.316;True;15198;7712;7461;9652;4787;4843;5546;2925;2618
3107901;Bom Repouso;MG;31;Sudeste;SUL/SUDOESTE DE MINAS;POUSO ALEGRE;-22.471;-46.145;True;10482;5448;5034;5548;2823;2725;4934;2625;2309
3108008;Bom Sucesso;MG;31;Sudeste;OESTE DE MINAS;OLIVEIRA;-21.033;-44.758;True;17194;8493;8673;14024;6772;7248;3170;1721;1425
3108107;Bonfim;MG;31;Sudeste;METROPOLITANA DE BELO HORIZONTE;ITAGUARA;-20.327;-44.239;True;6715;3343;3364;2878;1402;1471;3837;1941;1893
3108206;Bonfinópolis de Minas;MG;31;Sudeste;NOROESTE DE MINAS;UNAI;-16.567;-45.99;True;5828;3037;2791;3963;1981;1982;1865;1056;809
3108255;Bonito de Minas;MG;31;Sudeste;NORTE DE MINAS;JANUARIA;-15.323;-44.754;True;8787;4402;4147;1834;839;912;6953;3563;3235
3108305;Borda da Mata;MG;31;Sudeste;SUL/SUDOESTE DE MINAS;POUSO ALEGRE;-22.274;-46.165;True;14892;7412;7249;12121;5989;6027;2771;1423;1222
3108404;Botelhos;MG;31;Sudeste;SUL/SUDOESTE DE MINAS;POCOS DE CALDAS;-21.633;-46.395;True;14853;7385;7404;10786;5267;5511;4067;2118;1893
3108503;Botumirim;MG;31;Sudeste;NORTE DE MINAS;GRAO MOGOL;-16.872;-43.011;True;6435;3313;3090;3377;1669;1708;3058;1644;1382
3108552;Brasilândia de Minas;MG;31;Sudeste;NOROESTE DE MINAS;PARACATU;-17.01;-46.009;True;12821;6550;6222;10912;5530;5379;1909;1020;843
3108602;Brasília de Minas;MG;31;Sudeste;NORTE DE MINAS;MONTES CLAROS;-16.208;-44.429;True;31165;15581;15374;18833;9077;9607;12332;6504;5767
3108701;Brás Pires;MG;31;Sudeste;ZONA DA MATA;VICOSA;-20.921;-43.242;True;4592;2334;2258;2065;1013;1052;2527;1321;1206
3108800;Braúnas;MG;31;Sudeste;VALE DO RIO DOCE;GUANHAES;-19.056;-42.716;True;5208;2524;2623;1484;709;765;3724;1815;1858
3108909;Brasópolis;MG;31;Sudeste;SUL/SUDOESTE DE MINAS;ITAJUBA;-22.474;-45.608;True;14452;7286;7144;7725;3715;4010;6727;3571;3134
3109006;Brumadinho;MG;31;Sudeste;METROPOLITANA DE BELO HORIZONTE;BELO HORIZONTE;-20.143;-44.2;True;31965;15561;15410;26617;12885;13025;5348;2676;2385
3109105;Bueno Brandão;MG;31;Sudeste;SUL/SUDOESTE DE MINAS;POUSO ALEGRE;-22.441;-46.351;True;10864;5648;5214;5488;2737;2749;5376;2911;2465
3109204;Buenópolis;MG;31;Sudeste;CENTRAL MINEIRA;CURVELO;-17.873;-44.18;True;9522;4726;4773;7061;3373;3665;2461;1353;1108
3109253;Bugre;MG;31;Sudeste;VALE DO RIO DOCE;CARATINGA;-19.407;-42.265;True;3960;1960;1875;1331;645;686;2629;1315;1189
3109303;Buritis;MG;31;Sudeste;NOROESTE DE MINAS;UNAI;-15.618;-46.423;True;21472;10689;10170;14994;7242;7387;6478;3447;2783
3109402;Buritizeiro;MG;31;Sudeste;NORTE DE MINAS;PIRAPORA;-17.351;-44.962;True;26133;13065;12862;22792;11221;11385;3341;1844;1477
3109451;Cabeceira Grande;MG;31;Sudeste;NOROESTE DE MINAS;UNAI;-16.03;-47.091;True;6294;3272;2992;5296;2720;2546;998;552;446
3109501;Cabo Verde;MG;31;Sudeste;SUL/SUDOESTE DE MINAS;SAO SEBASTIAO DO PARAISO;-21.472;-46.396;True;13614;7050;6564;7352;3697;3655;6262;3353;2909
3109600;Cachoeira da Prata;MG;31;Sudeste;METROPOLITANA DE BELO HORIZONTE;SETE LAGOAS;-19.525;-44.454;True;3802;1820;1982;3567;1697;1870;235;123;112
3109709;Cachoeira de Minas;MG;31;Sudeste;SUL/SUDOESTE DE MINAS;SANTA RITA DO SAPUCAI;-22.355;-45.779;True;10820;5645;5174;6638;3372;3266;4182;2273;1908
3109808;Cachoeira Dourada;MG;31;Sudeste;TRIANGULO MINEIRO/ALTO PARANAIBA;ITUIUTABA;-18.515;-49.501;True;2470;1272;1193;2139;1080;1059;331;192;134
3109907;Caetanópolis;MG;31;Sudeste;METROPOLITANA DE BELO HORIZONTE;SETE LAGOAS;-19.295;-44.419;True;9490;4704;4785;8064;3954;4109;1426;750;676
3110004;Caeté;MG;31;Sudeste;METROPOLITANA DE BELO HORIZONTE;BELO HORIZONTE;-19.88;-43.67;True;39039;18935;19962;33692;16151;17455;5347;2784;2507
3110103;Caiana;MG;31;Sudeste;ZONA DA MATA;MURIAE;-20.696;-41.925;True;4537;2356;2181;1766;862;904;2771;1494;1277
3110202;Cajuri;MG;31;Sudeste;ZONA DA MATA;VICOSA;-20.791;-42.797;True;4015;2090;1914;2256;1128;1117;1759;962;797
3110301;Caldas;MG;31;Sudeste;SUL/SUDOESTE DE MINAS;POCOS DE CALDAS;-21.924;-46.386;True;13901;7069;6761;7873;3875;3984;6028;3194;2777
3110400;Camacho;MG;31;Sudeste;OESTE DE MINAS;FORMIGA;-20.625;-45.157;True;3204;1692;1512;1411;712;699;1793;980;813
3110509;Camanducaia;MG;31;Sudeste;SUL/SUDOESTE DE MINAS;POUSO ALEGRE;-22.755;-46.145;True;19708;10132;9547;14333;7216;7117;5375;2916;2430
3110608;Cambuí;MG;31;Sudeste;SUL/SUDOESTE DE MINAS;POUSO ALEGRE;-22.612;-46.058;True;25010;12538;12469;20059;9836;10220;4951;2702;2249
3110707;Cambuquira;MG;31;Sudeste;SUL/SUDOESTE DE MINAS;SAO LOURENCO;-21.852;-45.296;True;12520;6211;6306;10192;4958;5231;2328;1253;1075
3110806;Campanário;MG;31;Sudeste;VALE DO RIO DOCE;GOVERNADOR VALADARES;-18.239;-41.748;True;3592;1762;1806;2723;1270;1429;869;492;377
3110905;Campanha;MG;31;Sudeste;SUL/SUDOESTE DE MINAS;VARGINHA;-21.836;-45.401;True;15169;7538;7617;13011;6372;6625;2158;1166;992
3111002;Campestre;MG;31;Sudeste;SUL/SUDOESTE DE MINAS;POCOS DE CALDAS;-21.711;-46.246;True;20251;10509;9711;10927;5501;5423;9324;5008;4288
3111101;Campina Verde;MG;31;Sudeste;TRIANGULO MINEIRO/ALTO PARANAIBA;FRUTAL;-19.536;-49.486;True;18680;9355;9056;13333;6511;6701;5347;2844;2355
3111150;Campo Azul;MG;31;Sudeste;NORTE DE MINAS;MONTES CLAROS;-16.504;-44.811;True;3828;2006;1799;1486;740;736;2342;1266;1063
3111200;Campo Belo;MG;31;Sudeste;OESTE DE MINAS;CAMPO BELO;-20.897;-45.277;True;51375;25186;26105;48103;23451;24631;3272;1735;1474
3111309;Campo do Meio;MG;31;Sudeste;SUL/SUDOESTE DE MINAS;VARGINHA;-21.107;-45.83;True;11476;5858;5618;10125;5111;5014;1351;747;604
3111408;Campo Florido;MG;31;Sudeste;TRIANGULO MINEIRO/ALTO PARANAIBA;UBERABA;-19.761;-48.572;True;6570;3714;2809;4552;2617;1894;2018;1097;915
3111507;Campos Altos;MG;31;Sudeste;TRIANGULO MINEIRO/ALTO PARANAIBA;ARAXA;-19.696;-46.171;True;13184;6575;6609;12401;6144;6257;783;431;352
3111606;Campos Gerais;MG;31;Sudeste;SUL/SUDOESTE DE MINAS;VARGINHA;-21.235;-45.759;True;26954;13803;13141;18863;9427;9436;8091;4376;3705
3111705;Canaã;MG;31;Sudeste;ZONA DA MATA;VICOSA;-20.686;-42.62;True;4668;2400;2268;1751;884;867;2917;1516;1401
3111804;Canápolis;MG;31;Sudeste;TRIANGULO MINEIRO/ALTO PARANAIBA;UBERLANDIA;-18.725;-49.204;True;11313;6010;5289;9998;5285;4706;1315;725;583
3111903;Cana Verde;MG;31;Sudeste;OESTE DE MINAS;CAMPO BELO;-21.021;-45.182;True;5712;2906;2806;3891;1951;1940;1821;955;866
3112000;Candeias;MG;31;Sudeste;OESTE DE MINAS;CAMPO BELO;-20.767;-45.276;True;15499;7845;7458;10304;5102;5136;5195;2743;2322
3112059;Cantagalo;MG;31;Sudeste;VALE DO RIO DOCE;PECANHA;-18.526;-42.627;True;3967;1977;1989;2252;1106;1146;1715;871;843
3112109;Caparaó;MG;31;Sudeste;ZONA DA MATA;MANHUACU;-20.521;-41.907;True;4863;2552;2311;1889;941;948;2974;1611;1363
3112208;Capela Nova;MG;31;Sudeste;CAMPO DAS VERTENTES;BARBACENA;-20.923;-43.618;True;4598;2267;2331;2057;989;1068;2541;1278;1263
3112307;Capelinha;MG;31;Sudeste;JEQUITINHONHA;CAPELINHA;-17.691;-42.516;True;33061;16191;16580;23005;11008;11788;10056;5183;4792
3112406;Capetinga;MG;31;Sudeste;SUL/SUDOESTE DE MINAS;PASSOS;-20.616;-47.054;True;7154;3653;3459;6018;3037;2981;1136;616;478
3112505;Capim Branco;MG;31;Sudeste;METROPOLITANA DE BELO HORIZONTE;SETE LAGOAS;-19.549;-44.117;True;8763;4376;4300;7985;3957;3955;778;419;345
3112604;Capinópolis;MG;31;Sudeste;TRIANGULO MINEIRO/ALTO PARANAIBA;ITUIUTABA;-18.682;-49.57;True;15302;7810;7492;14146;7176;6970;1156;634;522
3112653;Capitão Andrade;MG;31;Sudeste;VALE DO RIO DOCE;GOVERNADOR VALADARES;-19.067;-41.858;True;4801;2335;2461;3404;1618;1783;1397;717;678
3112703;Capitão Enéas;MG;31;Sudeste;NORTE DE MINAS;MONTES CLAROS;-16.324;-43.711;True;14106;7185;6837;11386;5726;5595;2720;1459;1242
3112802;Capitólio;MG;31;Sudeste;SUL/SUDOESTE DE MINAS;PASSOS;-20.615;-46.05;True;7634;3857;3672;6024;3015;2974;1610;842;698
3112901;Caputira;MG;31;Sudeste;ZONA DA MATA;MANHUACU;-20.172;-42.271;True;8855;4579;4276;3716;1840;1876;5139;2739;2400
3113008;Caraí;MG;31;Sudeste;JEQUITINHONHA;ARACUAI;-17.189;-41.695;True;21530;10797;10541;6866;3322;3527;14664;7475;7014
3113107;Caranaíba;MG;31;Sudeste;CAMPO DAS VERTENTES;BARBACENA;-20.876;-43.739;True;3445;1769;1676;1215;635;580;2230;1134;1096
3113206;Carandaí;MG;31;Sudeste;CAMPO DAS VERTENTES;BARBACENA;-20.954;-43.806;True;22240;11014;11131;16980;8323;8585;5260;2691;2546
3113305;Carangola;MG;31;Sudeste;ZONA DA MATA;MURIAE;-20.733;-42.029;True;32068;15621;16416;25413;12068;13323;6655;3553;3093
3113404;Caratinga;MG;31;Sudeste;VALE DO RIO DOCE;CARATINGA;-19.79;-42.139;True;81731;39781;41760;67934;32491;35310;13797;7290;6450
3113503;Carbonita;MG;31;Sudeste;JEQUITINHONHA;CAPELINHA;-17.527;-43.016;True;10145;5244;4901;7145;3567;3578;3000;1677;1323
3113602;Careaçu;MG;31;Sudeste;SUL/SUDOESTE DE MINAS;SANTA RITA DO SAPUCAI;-22.043;-45.699;True;6029;3053;2948;4533;2246;2278;1496;807;670
3113701;Carlos Chagas;MG;31;Sudeste;VALE DO MUCURI;NANUQUE;-17.703;-40.766;True;20812;10013;10004;13289;6307;6781;7523;3706;3223
3113800;Carmésia;MG;31;Sudeste;VALE DO RIO DOCE;GUANHAES;-19.089;-43.142;True;2550;1270;1270;1276;613;653;1274;657;617
3113909;Carmo da Cachoeira;MG;31;Sudeste;SUL/SUDOESTE DE MINAS;VARGINHA;-21.461;-45.224;True;11656;5897;5711;8476;4221;4248;3180;1676;1463
3114006;Carmo da Mata;MG;31;Sudeste;OESTE DE MINAS;OLIVEIRA;-20.558;-44.871;True;10942;5473;5469;8387;4105;4282;2555;1368;1187
3114105;Carmo de Minas;MG;31;Sudeste;SUL/SUDOESTE DE MINAS;SAO LOURENCO;-22.122;-45.129;True;13657;6882;6775;8835;4321;4514;4822;2561;2261
3114204;Carmo do Cajuru;MG;31;Sudeste;OESTE DE MINAS;DIVINOPOLIS;-20.184;-44.771;True;18943;9491;9442;16198;8006;8182;2745;1485;1260
3114303;Carmo do Paranaíba;MG;31;Sudeste;TRIANGULO MINEIRO/ALTO PARANAIBA;PATOS DE MINAS;-19.001;-46.316;True;30712;15403;14996;25658;12719;12838;5054;2684;2158
3114402;Carmo do Rio Claro;MG;31;Sudeste;SUL/SUDOESTE DE MINAS;ALFENAS;-20.972;-46.119;True;19480;9915;9545;13851;6838;6996;5629;3077;2549
3114501;Carmópolis de Minas;MG;31;Sudeste;OESTE DE MINAS;OLIVEIRA;-20.541;-44.635;True;15743;8058;7685;10593;5283;5310;5150;2775;2375
3114550;Carneirinho;MG;31;Sudeste;TRIANGULO MINEIRO/ALTO PARANAIBA;FRUTAL;-19.698;-50.688;True;8859;4451;4262;6200;3061;3062;2659;1390;1200
3114600;Carrancas;MG;31;Sudeste;CAMPO DAS VERTENTES;LAVRAS;-21.488;-44.643;True;4015;1950;1919;2517;1170;1265;1498;780;654
3114709;Carvalhópolis;MG;31;Sudeste;SUL/SUDOESTE DE MINAS;ALFENAS;-21.778;-45.841;True;3234;1667;1567;2311;1161;1150;923;506;417
3114808;Carvalhos;MG;31;Sudeste;SUL/SUDOESTE DE MINAS;ANDRELANDIA;-22.001;-44.461;True;4611;2398;2213;2409;1174;1235;2202;1224;978
3114907;Casa Grande;MG;31;Sudeste;METROPOLITANA DE BELO HORIZONTE;CONSELHEIRO LAFAIETE;-20.793;-43.93;True;2100;1089;1011;1048;520;528;1052;569;483
3115003;Cascalho Rico;MG;31;Sudeste;TRIANGULO MINEIRO/ALTO PARANAIBA;UBERLANDIA;-18.576;-47.877;True;2799;1424;1284;1050;507;509;1749;917;775
3115102;Cássia;MG;31;Sudeste;SUL/SUDOESTE DE MINAS;PASSOS;-20.583;-46.922;True;17067;8586;8473;14176;7014;7162;2891;1572;1311
3115201;Conceição da Barra de Minas;MG;31;Sudeste;CAMPO DAS VERTENTES;SAO JOAO DEL REI;-21.129;-44.472;True;3960;2056;1901;2716;1395;1321;1244;661;580
3115300;Cataguases;MG;31;Sudeste;ZONA DA MATA;CATAGUASES;-21.389;-42.697;True;67384;32997;34375;64080;31225;32843;3304;1772;1532
3115359;Catas Altas;MG;31;Sudeste;METROPOLITANA DE BELO HORIZONTE;ITABIRA;-20.075;-43.408;True;4561;2228;2231;3952;1912;1959;609;316;272
3115409;Catas Altas da Noruega;MG;31;Sudeste;METROPOLITANA DE BELO HORIZONTE;CONSELHEIRO LAFAIETE;-20.69;-43.498;True;3424;1769;1621;1306;646;643;2118;1123;978
3115458;Catuji;MG;31;Sudeste;VALE DO MUCURI;TEOFILO OTONI;-17.312;-41.517;True;6597;3202;3186;1546;719;827;5051;2483;2359
3115474;Catuti;MG;31;Sudeste;NORTE DE MINAS;JANAUBA;-15.358;-42.963;True;5303;2724;2578;3039;1533;1506;2264;1191;1072
3115508;Caxambu;MG;31;Sudeste;SUL/SUDOESTE DE MINAS;SAO LOURENCO;-21.977;-44.933;True;21009;10185;10823;20432;9882;10549;577;303;274
3115607;Cedro do Abaeté;MG;31;Sudeste;CENTRAL MINEIRA;TRES MARIAS;-19.148;-45.711;True;1203;629;574;1063;544;519;140;85;55
3115706;Central de Minas;MG;31;Sudeste;VALE DO RIO DOCE;MANTENA;-18.762;-41.306;True;6590;3164;3426;5596;2654;2942;994;510;484
3115805;Centralina;MG;31;Sudeste;TRIANGULO MINEIRO/ALTO PARANAIBA;UBERLANDIA;-18.584;-49.199;True;10219;5322;4891;9453;4902;4546;766;420;345
3115904;Chácara;MG;31;Sudeste;ZONA DA MATA;JUIZ DE FORA;-21.672;-43.222;True;2613;1307;1306;1742;842;900;871;465;406
3116001;Chalé;MG;31;Sudeste;ZONA DA MATA;MANHUACU;-20.044;-41.688;True;5465;2788;2677;2643;1306;1337;2822;1482;1340
3116100;Chapada do Norte;MG;31;Sudeste;JEQUITINHONHA;CAPELINHA;-17.087;-42.535;True;15449;7423;7660;5200;2469;2691;10249;4954;4969
3116159;Chapada Gaúcha;MG;31;Sudeste;NORTE DE MINAS;JANUARIA;-15.306;-45.618;True;10266;5333;4883;5334;2706;2603;4932;2627;2280
3116209;Chiador;MG;31;Sudeste;ZONA DA MATA;JUIZ DE FORA;-22.003;-43.058;True;2893;1443;1450;1449;698;751;1444;745;699
3116308;Cipotânea;MG;31;Sudeste;ZONA DA MATA;VICOSA;-20.905;-43.366;True;6539;3316;3222;2892;1423;1469;3647;1893;1753
3116407;Claraval;MG;31;Sudeste;SUL/SUDOESTE DE MINAS;PASSOS;-20.399;-47.267;True;4295;2222;2067;2342;1187;1155;1953;1035;912
3116506;Claro dos PoçõEs;MG;31;Sudeste;NORTE DE MINAS;MONTES CLAROS;-17.08;-44.209;True;8131;4128;3999;5406;2642;2764;2725;1486;1235
3116605;Cláudio;MG;31;Sudeste;OESTE DE MINAS;DIVINOPOLIS;-20.443;-44.766;True;24590;12214;11995;19254;9377;9512;5336;2837;2483
3116704;Coimbra;MG;31;Sudeste;ZONA DA MATA;VICOSA;-20.857;-42.803;True;6886;3438;3395;4824;2370;2429;2062;1068;966
3116803;Coluna;MG;31;Sudeste;VALE DO RIO DOCE;GUANHAES;-18.234;-42.84;True;9281;4606;4675;3671;1734;1937;5610;2872;2738
3116902;Comendador Gomes;MG;31;Sudeste;TRIANGULO MINEIRO/ALTO PARANAIBA;FRUTAL;-19.698;-49.081;True;3087;1596;1423;1389;703;670;1698;893;753
3117009;Comercinho;MG;31;Sudeste;JEQUITINHONHA;PEDRA AZUL;-16.296;-41.793;True;8720;4450;4265;3339;1606;1733;5381;2844;2532
3117108;Conceição da Aparecida;MG;31;Sudeste;SUL/SUDOESTE DE MINAS;ALFENAS;-21.094;-46.204;True;10215;5266;4942;5926;2949;2970;4289;2317;1972
3117207;Conceição das Pedras;MG;31;Sudeste;SUL/SUDOESTE DE MINAS;SANTA RITA DO SAPUCAI;-22.16;-45.455;True;2726;1449;1264;1392;707;672;1334;742;592
3117306;Conceição das Alagoas;MG;31;Sudeste;TRIANGULO MINEIRO/ALTO PARANAIBA;UBERABA;-19.915;-48.388;True;20426;10757;9373;19146;10069;8795;1280;688;578
3117405;Conceição de Ipanema;MG;31;Sudeste;VALE DO RIO DOCE;AIMORES;-19.928;-41.694;True;4396;2204;2188;1425;672;753;2971;1532;1435
3117504;Conceição do Mato Dentro;MG;31;Sudeste;METROPOLITANA DE BELO HORIZONTE;CONCEICAO DO MATO DENTRO;-19.037;-43.425;True;18070;9159;8911;11640;5654;5986;6430;3505;2925
3117603;Conceição do Pará;MG;31;Sudeste;OESTE DE MINAS;DIVINOPOLIS;-19.753;-44.897;True;4725;2448;2277;1828;926;902;2897;1522;1375
3117702;Conceição do Rio Verde;MG;31;Sudeste;SUL/SUDOESTE DE MINAS;SAO LOURENCO;-21.881;-45.085;True;12708;6368;6337;11009;5453;5553;1699;915;784
3117801;Conceição dos Ouros;MG;31;Sudeste;SUL/SUDOESTE DE MINAS;SANTA RITA DO SAPUCAI;-22.413;-45.798;True;10204;5234;4970;7658;3869;3789;2546;1365;1181
3117836;Cônego Marinho;MG;31;Sudeste;NORTE DE MINAS;JANUARIA;-15.294;-44.418;True;6279;3211;3047;1537;782;755;4742;2429;2292
3117876;Confins;MG;31;Sudeste;METROPOLITANA DE BELO HORIZONTE;BELO HORIZONTE;-19.633;-43.983;True;5680;2779;2858;3677;1791;1873;2003;988;985
3117900;Congonhal;MG;31;Sudeste;SUL/SUDOESTE DE MINAS;POUSO ALEGRE;-22.153;-46.039;True;9692;4966;4705;7115;3550;3544;2577;1416;1161
3118007;Congonhas;MG;31;Sudeste;METROPOLITANA DE BELO HORIZONTE;CONSELHEIRO LAFAIETE;-20.5;-43.858;True;45984;23673;22055;43486;21899;21418;2498;1774;637
3118106;Congonhas do Norte;MG;31;Sudeste;METROPOLITANA DE BELO HORIZONTE;CONCEICAO DO MATO DENTRO;-18.807;-43.681;True;5110;2540;2570;2481;1180;1301;2629;1360;1269
3118205;Conquista;MG;31;Sudeste;TRIANGULO MINEIRO/ALTO PARANAIBA;UBERABA;-19.937;-47.542;True;6580;3424;3101;5243;2661;2540;1337;763;561
3118304;Conselheiro Lafaiete;MG;31;Sudeste;METROPOLITANA DE BELO HORIZONTE;CONSELHEIRO LAFAIETE;-20.66;-43.786;True;109280;52814;56465;106324;51325;54998;2956;1489;1467
3118403;Conselheiro Pena;MG;31;Sudeste;VALE DO RIO DOCE;AIMORES;-19.172;-41.472;True;21793;10395;11301;17175;8006;9165;4618;2389;2136
3118502;Consolação;MG;31;Sudeste;SUL/SUDOESTE DE MINAS;ITAJUBA;-22.551;-45.921;True;1695;874;821;910;450;460;785;424;361
3118601;Contagem;MG;31;Sudeste;METROPOLITANA DE BELO HORIZONTE;BELO HORIZONTE;-19.932;-44.054;True;608650;;;;;;;;
3118700;Coqueiral;MG;31;Sudeste;SUL/SUDOESTE DE MINAS;VARGINHA;-21.189;-45.441;True;9466;4747;4694;6217;3056;3161;3249;1691;1533
3118809;Coração de Jesus;MG;31;Sudeste;NORTE DE MINAS;MONTES CLAROS;-16.685;-44.365;True;26131;13266;12801;14224;6973;7242;11907;6293;5559
3118908;Cordisburgo;MG;31;Sudeste;METROPOLITANA DE BELO HORIZONTE;SETE LAGOAS;-19.125;-44.321;True;9033;4593;4440;5944;2927;3017;3089;1666;1423
3119005;Cordislândia;MG;31;Sudeste;SUL/SUDOESTE DE MINAS;SANTA RITA DO SAPUCAI;-21.793;-45.701;True;3570;1865;1701;2837;1456;1377;733;409;324
3119104;Corinto;MG;31;Sudeste;CENTRAL MINEIRA;CURVELO;-18.381;-44.456;True;22741;11067;11552;20277;9768;10443;2464;1299;1109
3119203;Coroaci;MG;31;Sudeste;VALE DO RIO DOCE;GOVERNADOR VALADARES;-18.622;-42.286;True;10776;5533;5227;5172;2608;2564;5604;2925;2663
3119302;Coromandel;MG;31;Sudeste;TRIANGULO MINEIRO/ALTO PARANAIBA;PATROCINIO;-18.473;-47.2;True;27392;13912;13474;21331;10526;10805;6061;3386;2669
3119401;Coronel Fabriciano;MG;31;Sudeste;VALE DO RIO DOCE;IPATINGA;-19.519;-42.629;True;100805;48606;51812;99425;47942;51138;1380;664;674
3119500;Coronel Murta;MG;31;Sudeste;JEQUITINHONHA;ARACUAI;-16.619;-42.182;True;9120;4700;4408;6606;3325;3275;2514;1375;1133
3119609;Coronel Pacheco;MG;31;Sudeste;ZONA DA MATA;JUIZ DE FORA;-21.588;-43.266;True;2457;1259;1198;1669;823;846;788;436;352
3119708;Coronel Xavier Chaves;MG;31;Sudeste;CAMPO DAS VERTENTES;SAO JOAO DEL REI;-21.024;-44.223;True;3194;1624;1567;1777;882;895;1417;742;672
3119807;Córrego Danta;MG;31;Sudeste;OESTE DE MINAS;PIUI;-19.824;-45.904;True;3423;1764;1633;2068;1020;1048;1355;744;585
3119906;Córrego do Bom Jesus;MG;31;Sudeste;SUL/SUDOESTE DE MINAS;POUSO ALEGRE;-22.63;-46.02;True;3724;1971;1753;1388;698;690;2336;1273;1063
3119955;Córrego Fundo;MG;31;Sudeste;OESTE DE MINAS;FORMIGA;-20.449;-45.555;True;5635;2923;2700;4106;2116;1985;1529;807;715
3120003;Córrego Novo;MG;31;Sudeste;VALE DO RIO DOCE;CARATINGA;-19.832;-42.396;True;3155;1583;1558;2061;1009;1049;1094;574;509
3120102;Couto de Magalhães de Minas;MG;31;Sudeste;JEQUITINHONHA;DIAMANTINA;-18.071;-43.471;True;4332;2191;2141;3903;1954;1949;429;237;192
3120151;Crisólita;MG;31;Sudeste;VALE DO MUCURI;NANUQUE;-17.237;-40.912;True;5659;2832;2672;3512;1717;1732;2147;1115;940
3120201;Cristais;MG;31;Sudeste;OESTE DE MINAS;CAMPO BELO;-20.876;-45.519;True;10631;5476;5111;8199;4121;4075;2432;1355;1036
3120300;Cristália;MG;31;Sudeste;NORTE DE MINAS;GRAO MOGOL;-16.8;-42.862;True;5731;2876;2812;3072;1457;1580;2659;1419;1232
3120409;Cristiano Otoni;MG;31;Sudeste;METROPOLITANA DE BELO HORIZONTE;CONSELHEIRO LAFAIETE;-20.832;-43.806;True;4881;2465;2416;3996;2016;1980;885;449;436
3120508;Cristina;MG;31;Sudeste;SUL/SUDOESTE DE MINAS;ITAJUBA;-22.212;-45.264;True;10955;5596;5319;5978;2928;3050;4977;2668;2269
3120607;Crucilândia;MG;31;Sudeste;METROPOLITANA DE BELO HORIZONTE;ITAGUARA;-20.384;-44.337;True;4593;2344;2249;2631;1307;1324;1962;1037;925
3120706;Cruzeiro da Fortaleza;MG;31;Sudeste;TRIANGULO MINEIRO/ALTO PARANAIBA;PATROCINIO;-18.946;-46.674;True;3760;1908;1849;3255;1649;1606;505;259;243
3120805;Cruzília;MG;31;Sudeste;SUL/SUDOESTE DE MINAS;ANDRELANDIA;-21.839;-44.808;True;14656;7370;7284;13192;6555;6637;1464;815;647
3120839;Cuparaque;MG;31;Sudeste;VALE DO RIO DOCE;AIMORES;-18.969;-41.099;True;4404;2148;2249;3561;1713;1842;843;435;407
3120870;Curral de Dentro;MG;31;Sudeste;NORTE DE MINAS;SALINAS;-15.938;-41.844;True;6907;3538;3369;5794;2928;2866;1113;610;503
3120904;Curvelo;MG;31;Sudeste;CENTRAL MINEIRA;CURVELO;-18.756;-44.431;True;71611;34710;36427;64375;30808;33219;7236;3902;3208
3121001;Datas;MG;31;Sudeste;JEQUITINHONHA;DIAMANTINA;-18.446;-43.656;True;5418;2655;2714;3015;1472;1529;2403;1183;1185
3121100;Delfim Moreira;MG;31;Sudeste;SUL/SUDOESTE DE MINAS;ITAJUBA;-22.509;-45.28;True;7834;4057;3712;2713;1317;1396;5121;2740;2316
3121209;Delfinópolis;MG;31;Sudeste;SUL/SUDOESTE DE MINAS;PASSOS;-20.344;-46.854;True;6698;3471;3211;4820;2432;2378;1878;1039;833
3121258;Delta;MG;31;Sudeste;TRIANGULO MINEIRO/ALTO PARANAIBA;UBERABA;-19.977;-47.771;True;6600;3490;2924;6231;3285;2763;369;205;161
3121308;Descoberto;MG;31;Sudeste;ZONA DA MATA;JUIZ DE FORA;-21.46;-42.968;True;4876;2495;2363;3820;1902;1918;1056;593;445
3121407;Desterro de Entre Rios;MG;31;Sudeste;METROPOLITANA DE BELO HORIZONTE;CONSELHEIRO LAFAIETE;-20.66;-44.333;True;6914;3557;3357;3254;1573;1681;3660;1984;1676
3121506;Desterro do Melo;MG;31;Sudeste;CAMPO DAS VERTENTES;BARBACENA;-21.147;-43.518;True;3198;1604;1516;1327;635;692;1871;969;824
3121605;Diamantina;MG;31;Sudeste;JEQUITINHONHA;DIAMANTINA;-18.249;-43.6;True;44746;21632;22724;39288;18847;20270;5458;2785;2454
3121704;Diogo de Vasconcelos;MG;31;Sudeste;METROPOLITANA DE BELO HORIZONTE;OURO PRETO;-20.488;-43.198;True;3941;2016;1912;1033;500;520;2908;1516;1392
3121803;Dionísio;MG;31;Sudeste;METROPOLITANA DE BELO HORIZONTE;ITABIRA;-19.843;-42.777;True;10234;5023;5211;7783;3802;3981;2451;1221;1230
3121902;Divinésia;MG;31;Sudeste;ZONA DA MATA;UBA;-20.99;-43.004;True;3276;1650;1604;1535;746;776;1741;904;828
3122009;Divino;MG;31;Sudeste;ZONA DA MATA;MURIAE;-20.614;-42.149;True;19245;9739;9433;9838;4771;5062;9407;4968;4371
3122108;Divino das Laranjeiras;MG;31;Sudeste;VALE DO RIO DOCE;GOVERNADOR VALADARES;-18.778;-41.48;True;4934;2407;2518;4060;1953;2107;874;454;411
3122207;Divinolândia de Minas;MG;31;Sudeste;VALE DO RIO DOCE;GUANHAES;-18.804;-42.598;True;6724;3267;3457;5442;2596;2846;1282;671;611
3122306;Divinópolis;MG;31;Sudeste;OESTE DE MINAS;DIVINOPOLIS;-20.139;-44.884;True;209921;;;;;;;;
3122355;Divisa Alegre;MG;31;Sudeste;NORTE DE MINAS;SALINAS;-15.726;-41.345;True;5793;2836;2920;5594;2747;2837;199;89;83
3122405;Divisa Nova;MG;31;Sudeste;SUL/SUDOESTE DE MINAS;ALFENAS;-21.511;-46.196;True;5619;2923;2696;4508;2339;2169;1111;584;527
3122454;Divisópolis;MG;31;Sudeste;JEQUITINHONHA;ALMENARA;-15.726;-41;True;7852;4109;3733;6010;3040;2970;1842;1069;763
3122470;Dom Bosco;MG;31;Sudeste;NOROESTE DE MINAS;UNAI;-16.652;-46.271;True;3781;2021;1760;1949;999;950;1832;1022;810
3122504;Dom Cavati;MG;31;Sudeste;VALE DO RIO DOCE;CARATINGA;-19.374;-42.106;True;5593;2730;2853;4905;2374;2531;688;356;322
3122603;Dom Joaquim;MG;31;Sudeste;METROPOLITANA DE BELO HORIZONTE;CONCEICAO DO MATO DENTRO;-18.967;-43.256;True;4530;2244;2262;2851;1345;1482;1679;899;780
3122702;Dom Silvério;MG;31;Sudeste;ZONA DA MATA;PONTE NOVA;-20.16;-42.968;True;5284;2558;2724;4003;1891;2110;1281;667;614
3122801;Dom Viçoso;MG;31;Sudeste;SUL/SUDOESTE DE MINAS;ITAJUBA;-22.254;-45.161;True;3020;1579;1441;980;482;498;2040;1097;943
3122900;Dona Eusébia;MG;31;Sudeste;ZONA DA MATA;CATAGUASES;-21.316;-42.811;True;5569;2833;2736;4934;2491;2443;635;342;293
3123007;Dores de Campos;MG;31;Sudeste;CAMPO DAS VERTENTES;SAO JOAO DEL REI;-21.109;-44.023;True;9276;4614;4662;8032;3945;4087;1244;669;575
3123106;Dores de Guanhães;MG;31;Sudeste;VALE DO RIO DOCE;GUANHAES;-19.058;-42.929;True;5528;2814;2698;1742;882;860;3786;1932;1838
3123205;Dores do Indaiá;MG;31;Sudeste;CENTRAL MINEIRA;BOM DESPACHO;-19.463;-45.602;True;13996;6781;7193;12984;6218;6758;1012;563;435
3123304;Dores do Turvo;MG;31;Sudeste;ZONA DA MATA;UBA;-20.976;-43.189;True;4572;2375;2175;1951;978;973;2621;1397;1202
3123403;Doresópolis;MG;31;Sudeste;OESTE DE MINAS;PIUI;-20.287;-45.903;True;1492;780;709;1105;572;533;387;208;176
3123502;Douradoquara;MG;31;Sudeste;TRIANGULO MINEIRO/ALTO PARANAIBA;PATROCINIO;-18.431;-47.609;True;1846;972;874;1169;595;574;677;377;300
3123528;Durandé;MG;31;Sudeste;ZONA DA MATA;MANHUACU;-20.203;-41.798;True;6932;3538;3392;3287;1653;1634;3645;1885;1758
3123601;Elói Mendes;MG;31;Sudeste;SUL/SUDOESTE DE MINAS;VARGINHA;-21.61;-45.565;True;24161;11993;12145;19642;9598;10044;4519;2395;2101
3123700;Engenheiro Caldas;MG;31;Sudeste;VALE DO RIO DOCE;GOVERNADOR VALADARES;-19.219;-42.046;True;10317;5005;5273;8498;4101;4378;1819;904;895
3123809;Engenheiro Navarro;MG;31;Sudeste;NORTE DE MINAS;BOCAIUVA;-17.28;-43.95;True;7079;3623;3456;4819;2420;2399;2260;1203;1057
3123858;Entre Folhas;MG;31;Sudeste;VALE DO RIO DOCE;CARATINGA;-19.625;-42.231;True;4931;2448;2483;3719;1820;1899;1212;628;584
3123908;Entre Rios de Minas;MG;31;Sudeste;METROPOLITANA DE BELO HORIZONTE;CONSELHEIRO LAFAIETE;-20.671;-44.066;True;13887;6842;6953;9398;4491;4866;4489;2351;2087
3124005;Ervália;MG;31;Sudeste;ZONA DA MATA;VICOSA;-20.84;-42.657;True;18002;8977;8940;9072;4335;4699;8930;4642;4241
3124104;Esmeraldas;MG;31;Sudeste;METROPOLITANA DE BELO HORIZONTE;BELO HORIZONTE;-19.763;-44.314;True;55436;27626;27243;25112;12359;12516;30324;15267;14727
3124203;Espera Feliz;MG;31;Sudeste;ZONA DA MATA;MURIAE;-20.65;-41.907;True;20835;10436;10346;12530;6038;6465;8305;4398;3881
3124302;Espinosa;MG;31;Sudeste;NORTE DE MINAS;JANAUBA;-14.926;-42.819;True;31322;15515;15800;17330;8354;8969;13992;7161;6831
3124401;Espírito Santo do Dourado;MG;31;Sudeste;SUL/SUDOESTE DE MINAS;POUSO ALEGRE;-22.046;-45.951;True;4293;2301;1992;1657;858;799;2636;1443;1193
3124500;Estiva;MG;31;Sudeste;SUL/SUDOESTE DE MINAS;POUSO ALEGRE;-22.463;-46.017;True;10920;5637;5142;4723;2375;2314;6197;3262;2828
3124609;Estrela Dalva;MG;31;Sudeste;ZONA DA MATA;CATAGUASES;-21.742;-42.461;True;2497;1231;1258;1767;857;910;730;374;348
3124708;Estrela do Indaiá;MG;31;Sudeste;CENTRAL MINEIRA;BOM DESPACHO;-19.522;-45.788;True;3651;1859;1790;2940;1453;1487;711;406;303
3124807;Estrela do Sul;MG;31;Sudeste;TRIANGULO MINEIRO/ALTO PARANAIBA;PATROCINIO;-18.746;-47.693;True;7136;3782;3335;5367;2789;2570;1769;993;765
3124906;Eugenópolis;MG;31;Sudeste;ZONA DA MATA;MURIAE;-21.099;-42.187;True;10291;5210;5059;6714;3278;3424;3577;1932;1635
3125002;Ewbank da Câmara;MG;31;Sudeste;ZONA DA MATA;JUIZ DE FORA;-21.551;-43.51;True;3567;1771;1781;3307;1633;1659;260;138;122
3125101;Extrema;MG;31;Sudeste;SUL/SUDOESTE DE MINAS;POUSO ALEGRE;-22.855;-46.318;True;24886;12636;12208;22085;11133;10928;2801;1503;1280
3125200;Fama;MG;31;Sudeste;SUL/SUDOESTE DE MINAS;ALFENAS;-21.406;-45.829;True;2219;1121;1094;1457;701;752;762;420;342
3125309;Faria Lemos;MG;31;Sudeste;ZONA DA MATA;MURIAE;-20.808;-42.03;True;3612;1781;1709;2361;1156;1205;1251;625;504
3125408;Felício dos Santos;MG;31;Sudeste;JEQUITINHONHA;DIAMANTINA;-18.077;-43.247;True;5685;2852;2801;2278;1103;1169;3407;1749;1632
3125507;São Gonçalo do Rio Preto;MG;31;Sudeste;JEQUITINHONHA;DIAMANTINA;-18.004;-43.391;True;3124;1533;1540;1906;906;975;1218;627;565
3125606;Felisburgo;MG;31;Sudeste;JEQUITINHONHA;ALMENARA;-16.639;-40.761;True;6687;3426;3243;5013;2471;2527;1674;955;716
3125705;Felixlândia;MG;31;Sudeste;CENTRAL MINEIRA;CURVELO;-18.758;-44.899;True;13618;6789;6825;10662;5194;5468;2956;1595;1357
3125804;Fernandes Tourinho;MG;31;Sudeste;VALE DO RIO DOCE;GOVERNADOR VALADARES;-19.154;-42.082;True;2612;1281;1308;1870;907;953;742;374;355
3125903;Ferros;MG;31;Sudeste;METROPOLITANA DE BELO HORIZONTE;ITABIRA;-19.232;-43.023;True;11387;5697;5642;5048;2493;2530;6339;3204;3112
3125952;Fervedouro;MG;31;Sudeste;ZONA DA MATA;MURIAE;-20.726;-42.279;True;10261;5334;4917;4483;2259;2224;5778;3075;2693
3126000;Florestal;MG;31;Sudeste;METROPOLITANA DE BELO HORIZONTE;PARA DE MINAS;-19.889;-44.433;True;5928;2926;2949;4546;2200;2321;1382;726;628
3126109;Formiga;MG;31;Sudeste;OESTE DE MINAS;FORMIGA;-20.464;-45.426;True;64585;31726;32839;58365;28275;30072;6220;3451;2767
3126208;Formoso;MG;31;Sudeste;NOROESTE DE MINAS;UNAI;-14.947;-46.232;True;6612;3393;3118;4056;2019;2031;2556;1374;1087
3126307;Fortaleza de Minas;MG;31;Sudeste;SUL/SUDOESTE DE MINAS;PASSOS;-20.849;-46.718;True;3837;1989;1848;2828;1431;1397;1009;558;451
3126406;Fortuna de Minas;MG;31;Sudeste;METROPOLITANA DE BELO HORIZONTE;SETE LAGOAS;-19.561;-44.447;True;2454;1297;1157;1642;837;805;812;460;352
3126505;Francisco Badaró;MG;31;Sudeste;JEQUITINHONHA;CAPELINHA;-16.993;-42.352;True;10269;5245;5016;3042;1454;1583;7227;3791;3433
3126604;Francisco Dumont;MG;31;Sudeste;NORTE DE MINAS;BOCAIUVA;-17.315;-44.234;True;4759;2459;2260;2928;1419;1482;1831;1040;778
3126703;Francisco Sá;MG;31;Sudeste;NORTE DE MINAS;MONTES CLAROS;-16.476;-43.488;True;24838;12834;11887;14530;7167;7349;10308;5667;4538
3126752;Franciscópolis;MG;31;Sudeste;VALE DO MUCURI;TEOFILO OTONI;-17.96;-42.009;True;5664;2912;2752;2213;1056;1157;3451;1856;1595
3126802;Frei Gaspar;MG;31;Sudeste;VALE DO MUCURI;TEOFILO OTONI;-18.066;-41.429;True;6343;3198;3041;1867;903;961;4476;2295;2080
3126901;Frei Inocêncio;MG;31;Sudeste;VALE DO RIO DOCE;GOVERNADOR VALADARES;-18.545;-41.922;True;8873;4341;4528;6685;3165;3520;2188;1176;1008
3126950;Frei Lagonegro;MG;31;Sudeste;VALE DO RIO DOCE;PECANHA;-18.168;-42.766;True;3342;1732;1610;496;236;260;2846;1496;1350
3127008;Fronteira;MG;31;Sudeste;TRIANGULO MINEIRO/ALTO PARANAIBA;FRUTAL;-20.268;-49.199;True;13983;7411;6375;12593;6669;5791;1390;742;584
3127057;Fronteira dos Vales;MG;31;Sudeste;VALE DO MUCURI;NANUQUE;-16.891;-40.925;True;4835;2422;2339;2953;1445;1477;1882;977;862
3127073;Fruta de Leite;MG;31;Sudeste;NORTE DE MINAS;SALINAS;-16.131;-42.533;True;6327;3233;3094;2008;961;1047;4319;2272;2047
3127107;Frutal;MG;31;Sudeste;TRIANGULO MINEIRO/ALTO PARANAIBA;FRUTAL;-20.025;-48.941;True;51766;26238;25274;46045;23168;22723;5721;3070;2551
3127206;Funilândia;MG;31;Sudeste;METROPOLITANA DE BELO HORIZONTE;SETE LAGOAS;-19.368;-44.056;True;3639;1880;1759;1844;924;920;1795;956;839
3127305;Galiléia;MG;31;Sudeste;VALE DO RIO DOCE;GOVERNADOR VALADARES;-18.999;-41.538;True;7302;3577;3696;5465;2579;2857;1837;998;839
3127339;Gameleiras;MG;31;Sudeste;NORTE DE MINAS;JANAUBA;-15.082;-43.124;True;5226;2650;2560;1283;641;642;3943;2009;1918
3127354;Glaucilândia;MG;31;Sudeste;NORTE DE MINAS;MONTES CLAROS;-16.85;-43.697;True;2932;1396;1331;1052;486;519;1880;910;812
3127370;Goiabeira;MG;31;Sudeste;VALE DO RIO DOCE;AIMORES;-18.982;-41.223;True;3052;1541;1511;2497;1240;1257;555;301;254
3127388;Goianá;MG;31;Sudeste;ZONA DA MATA;JUIZ DE FORA;-21.537;-43.202;True;3643;1848;1795;2899;1444;1455;744;404;340
3127404;Gonçalves;MG;31;Sudeste;SUL/SUDOESTE DE MINAS;POUSO ALEGRE;-22.659;-45.856;True;4270;2283;1987;1084;541;543;3186;1742;1444
3127503;Gonzaga;MG;31;Sudeste;VALE DO RIO DOCE;GUANHAES;-18.822;-42.479;True;5620;2693;2927;2897;1362;1535;2723;1331;1392
3127602;Gouveia;MG;31;Sudeste;JEQUITINHONHA;DIAMANTINA;-18.454;-43.741;True;11569;5595;5928;7967;3777;4170;3602;1818;1758
3127701;Governador Valadares;MG;31;Sudeste;VALE DO RIO DOCE;GOVERNADOR VALADARES;-18.851;-41.949;True;260396;;;;;;;;
3127800;Grão Mogol;MG;31;Sudeste;NORTE DE MINAS;GRAO MOGOL;-16.559;-42.89;True;14594;7416;7082;5173;2525;2648;9421;4891;4434
3127909;Grupiara;MG;31;Sudeste;TRIANGULO MINEIRO/ALTO PARANAIBA;PATROCINIO;-18.494;-47.722;True;1412;749;663;1182;620;562;230;129;101
3128006;Guanhães;MG;31;Sudeste;VALE DO RIO DOCE;GUANHAES;-18.775;-42.933;True;29286;13975;14997;23199;10826;12098;6087;3149;2899
3128105;Guapé;MG;31;Sudeste;SUL/SUDOESTE DE MINAS;VARGINHA;-20.762;-45.918;True;13152;6912;6071;6431;3260;3122;6721;3652;2949
3128204;Guaraciaba;MG;31;Sudeste;ZONA DA MATA;PONTE NOVA;-20.571;-43.008;True;10428;5248;5173;3200;1497;1698;7228;3751;3475
3128253;Guaraciama;MG;31;Sudeste;NORTE DE MINAS;BOCAIUVA;-17.014;-43.673;True;4554;2335;2193;2590;1277;1313;1964;1058;880
3128303;Guaranésia;MG;31;Sudeste;SUL/SUDOESTE DE MINAS;SAO SEBASTIAO DO PARAISO;-21.299;-46.803;True;18147;9141;8999;16356;8172;8184;1791;969;815
3128402;Guarani;MG;31;Sudeste;ZONA DA MATA;UBA;-21.352;-43.047;True;9487;4818;4651;7154;3555;3599;2333;1263;1052
3128501;Guarará;MG;31;Sudeste;ZONA DA MATA;JUIZ DE FORA;-21.732;-43.038;True;4017;2005;2012;3573;1749;1824;444;256;188
3128600;Guarda-Mor;MG;31;Sudeste;NOROESTE DE MINAS;PARACATU;-17.771;-47.098;True;6577;3426;3085;3474;1707;1734;3103;1719;1351
3128709;Guaxupé;MG;31;Sudeste;SUL/SUDOESTE DE MINAS;SAO SEBASTIAO DO PARAISO;-21.305;-46.713;True;47894;23786;24104;44743;22105;22634;3151;1681;1470
3128808;Guidoval;MG;31;Sudeste;ZONA DA MATA;UBA;-21.152;-42.797;True;7321;3699;3561;5011;2471;2521;2310;1228;1040
3128907;Guimarânia;MG;31;Sudeste;TRIANGULO MINEIRO/ALTO PARANAIBA;PATOS DE MINAS;-18.844;-46.793;True;6946;3581;3361;5673;2875;2798;1273;706;563
3129004;Guiricema;MG;31;Sudeste;ZONA DA MATA;UBA;-21.008;-42.718;True;8906;4550;4353;4087;2019;2065;4819;2531;2288
3129103;Gurinhatã;MG;31;Sudeste;TRIANGULO MINEIRO/ALTO PARANAIBA;ITUIUTABA;-19.213;-49.786;True;6194;3293;2887;2639;1304;1335;3555;1989;1552
3129202;Heliodora;MG;31;Sudeste;SUL/SUDOESTE DE MINAS;SANTA RITA DO SAPUCAI;-22.067;-45.542;True;6005;3073;2901;4414;2221;2162;1591;852;739
3129301;Iapu;MG;31;Sudeste;VALE DO RIO DOCE;CARATINGA;-19.437;-42.218;True;10851;5276;5230;7372;3476;3596;3479;1800;1634
3129400;Ibertioga;MG;31;Sudeste;CAMPO DAS VERTENTES;BARBACENA;-21.43;-43.963;True;5057;2579;2472;3381;1671;1707;1676;908;765
3129509;Ibiá;MG;31;Sudeste;TRIANGULO MINEIRO/ALTO PARANAIBA;ARAXA;-19.478;-46.539;True;22069;11177;10650;18952;9476;9364;3117;1701;1286
3129608;Ibiaí;MG;31;Sudeste;NORTE DE MINAS;PIRAPORA;-16.861;-44.914;True;7571;3811;3594;5685;2818;2790;1886;993;804
3129657;Ibiracatu;MG;31;Sudeste;NORTE DE MINAS;MONTES CLAROS;-15.664;-44.164;True;5898;3054;2844;2902;1472;1430;2996;1582;1414
3129707;Ibiraci;MG;31;Sudeste;SUL/SUDOESTE DE MINAS;PASSOS;-20.462;-47.122;True;11023;5874;5149;7115;3609;3506;3908;2265;1643
3129806;Ibirité;MG;31;Sudeste;METROPOLITANA DE BELO HORIZONTE;BELO HORIZONTE;-20.022;-44.059;True;148535;72587;75063;148024;72315;74836;511;272;227
3129905;Ibitiúra de Minas;MG;31;Sudeste;SUL/SUDOESTE DE MINAS;POCOS DE CALDAS;-22.061;-46.44;True;3382;1769;1611;2286;1168;1116;1096;601;495
3130002;Ibituruna;MG;31;Sudeste;OESTE DE MINAS;OLIVEIRA;-21.153;-44.748;True;2825;1424;1395;2203;1100;1097;622;324;298
3130051;Icaraí de Minas;MG;31;Sudeste;NORTE DE MINAS;JANUARIA;-16.217;-44.906;True;10331;5382;4943;2511;1290;1221;7820;4092;3722
3130101;Igarapé;MG;31;Sudeste;METROPOLITANA DE BELO HORIZONTE;BELO HORIZONTE;-20.07;-44.302;True;31135;15520;15204;28411;14062;13961;2724;1458;1243
3130200;Igaratinga;MG;31;Sudeste;OESTE DE MINAS;DIVINOPOLIS;-19.955;-44.709;True;8477;4288;4096;6578;3285;3200;1899;1003;896
3130309;Iguatama;MG;31;Sudeste;OESTE DE MINAS;PIUI;-20.174;-45.711;True;7632;3813;3799;6348;3137;3205;1284;676;594
3130408;Ijaci;MG;31;Sudeste;CAMPO DAS VERTENTES;LAVRAS;-21.17;-44.925;True;5687;2884;2792;5342;2703;2628;345;181;164
3130507;Ilicínea;MG;31;Sudeste;SUL/SUDOESTE DE MINAS;VARGINHA;-20.936;-45.833;True;11265;5672;5391;8458;4147;4223;2807;1525;1168
3130556;Imbé de Minas;MG;31;Sudeste;VALE DO RIO DOCE;CARATINGA;-19.597;-41.971;True;6324;3253;3065;2041;998;1040;4283;2255;2025
3130606;Inconfidentes;MG;31;Sudeste;SUL/SUDOESTE DE MINAS;POCOS DE CALDAS;-22.317;-46.328;True;7253;3628;3410;3670;1726;1759;3583;1902;1651
3130655;Indaiabira;MG;31;Sudeste;NORTE DE MINAS;SALINAS;-15.492;-42.197;True;7482;3855;3582;2831;1421;1392;4651;2434;2190
3130705;Indianópolis;MG;31;Sudeste;TRIANGULO MINEIRO/ALTO PARANAIBA;UBERLANDIA;-19.039;-47.917;True;6244;3275;2966;3926;2003;1923;2318;1272;1043
3130804;Ingaí;MG;31;Sudeste;CAMPO DAS VERTENTES;LAVRAS;-21.401;-44.917;True;2496;1299;1179;1594;792;802;902;507;377
3130903;Inhapim;MG;31;Sudeste;VALE DO RIO DOCE;CARATINGA;-19.549;-42.12;True;24289;12088;12151;13981;6769;7200;10308;5319;4951
3131000;Inhaúma;MG;31;Sudeste;METROPOLITANA DE BELO HORIZONTE;SETE LAGOAS;-19.491;-44.39;True;5347;2737;2610;3378;1683;1695;1969;1054;915
3131109;Inimutaba;MG;31;Sudeste;CENTRAL MINEIRA;CURVELO;-18.729;-44.361;True;6420;3174;3234;4318;2060;2258;2102;1114;976
3131158;Ipaba;MG;31;Sudeste;VALE DO RIO DOCE;CARATINGA;-19.414;-42.419;True;14844;7369;7327;13605;6719;6738;1239;650;589
3131208;Ipanema;MG;31;Sudeste;VALE DO RIO DOCE;AIMORES;-19.801;-41.713;True;17128;8260;8812;13201;6172;6988;3927;2088;1824
3131307;Ipatinga;MG;31;Sudeste;VALE DO RIO DOCE;IPATINGA;-19.468;-42.537;True;238397;;;;;;;;
3131406;Ipiaçu;MG;31;Sudeste;TRIANGULO MINEIRO/ALTO PARANAIBA;ITUIUTABA;-18.692;-49.943;True;4191;2143;2048;3702;1878;1824;489;265;224
3131505;Ipuiúna;MG;31;Sudeste;SUL/SUDOESTE DE MINAS;POUSO ALEGRE;-22.099;-46.19;True;9183;4779;4404;7179;3691;3488;2004;1088;916
3131604;Iraí de Minas;MG;31;Sudeste;TRIANGULO MINEIRO/ALTO PARANAIBA;PATROCINIO;-18.984;-47.461;True;6295;3286;3009;4900;2538;2362;1395;748;647
3131703;Itabira;MG;31;Sudeste;METROPOLITANA DE BELO HORIZONTE;ITABIRA;-19.619;-43.227;True;105159;50545;54477;97564;46742;50701;7595;3803;3776
3131802;Itabirinha de Mantena;MG;31;Sudeste;VALE DO RIO DOCE;MANTENA;-18.566;-41.233;True;10338;5170;5167;7954;3893;4061;2384;1277;1106
3131901;Itabirito;MG;31;Sudeste;METROPOLITANA DE BELO HORIZONTE;OURO PRETO;-20.253;-43.801;True;41522;20388;21106;39860;19515;20325;1662;873;781
3132008;Itacambira;MG;31;Sudeste;NORTE DE MINAS;GRAO MOGOL;-17.065;-43.309;True;5018;2633;2308;876;461;415;4142;2172;1893
3132107;Itacarambi;MG;31;Sudeste;NORTE DE MINAS;JANUARIA;-15.102;-44.092;True;17626;8863;8725;13653;6789;6855;3973;2074;1870
3132206;Itaguara;MG;31;Sudeste;METROPOLITANA DE BELO HORIZONTE;ITAGUARA;-20.392;-44.488;True;12292;6237;6049;9100;4492;4602;3192;1745;1447
3132305;Itaipé;MG;31;Sudeste;VALE DO MUCURI;TEOFILO OTONI;-17.402;-41.669;True;11497;5855;5638;4846;2315;2531;6651;3540;3107
3132404;Itajubá;MG;31;Sudeste;SUL/SUDOESTE DE MINAS;ITAJUBA;-22.426;-45.453;True;86673;42296;44269;79461;38587;40782;7212;3709;3487
3132503;Itamarandiba;MG;31;Sudeste;JEQUITINHONHA;CAPELINHA;-17.857;-42.859;True;31883;16022;15702;20824;10099;10692;11059;5923;5010
3132602;Itamarati de Minas;MG;31;Sudeste;ZONA DA MATA;CATAGUASES;-21.416;-42.818;True;4035;2089;1943;3021;1537;1484;1014;552;459
3132701;Itambacuri;MG;31;Sudeste;VALE DO RIO DOCE;GOVERNADOR VALADARES;-18.031;-41.685;True;22635;10940;11386;14617;6780;7708;8018;4160;3678
3132800;Itambé do Mato Dentro;MG;31;Sudeste;METROPOLITANA DE BELO HORIZONTE;CONCEICAO DO MATO DENTRO;-19.414;-43.321;True;2434;1197;1224;1002;470;525;1432;727;699
3132909;Itamogi;MG;31;Sudeste;SUL/SUDOESTE DE MINAS;SAO SEBASTIAO DO PARAISO;-21.078;-47.048;True;10828;5592;5236;8137;4114;4023;2691;1478;1213
3133006;Itamonte;MG;31;Sudeste;SUL/SUDOESTE DE MINAS;SAO LOURENCO;-22.284;-44.87;True;13756;6942;6807;7799;3869;3930;5957;3073;2877
3133105;Itanhandu;MG;31;Sudeste;SUL/SUDOESTE DE MINAS;SAO LOURENCO;-22.296;-44.935;True;14395;7104;7267;11682;5689;5993;2713;1415;1274
3133204;Itanhomi;MG;31;Sudeste;VALE DO RIO DOCE;GOVERNADOR VALADARES;-19.172;-41.865;True;11880;5589;6071;8217;3797;4359;3663;1792;1712
3133303;Itaobim;MG;31;Sudeste;JEQUITINHONHA;PEDRA AZUL;-16.562;-41.503;True;20986;10457;10494;15780;7755;8025;5206;2702;2469
3133402;Itapagipe;MG;31;Sudeste;TRIANGULO MINEIRO/ALTO PARANAIBA;FRUTAL;-19.909;-49.381;True;14019;7328;6531;9468;4825;4629;4551;2503;1902
3133501;Itapecerica;MG;31;Sudeste;OESTE DE MINAS;FORMIGA;-20.473;-45.126;True;20653;10313;10328;15875;7709;8163;4778;2604;2165
3133600;Itapeva;MG;31;Sudeste;SUL/SUDOESTE DE MINAS;POUSO ALEGRE;-22.768;-46.221;True;7722;3960;3671;4101;2053;2045;3621;1907;1626
3133709;Itatiaiuçu;MG;31;Sudeste;METROPOLITANA DE BELO HORIZONTE;ITAGUARA;-20.197;-44.421;True;8953;4481;4443;5594;2742;2852;3359;1739;1591
3133758;Itaú de Minas;MG;31;Sudeste;SUL/SUDOESTE DE MINAS;PASSOS;-20.739;-46.752;True;14551;7229;7322;14223;7048;7175;328;181;147
3133808;Itaúna;MG;31;Sudeste;OESTE DE MINAS;DIVINOPOLIS;-20.075;-44.576;True;81833;40243;41449;77100;37708;39282;4733;2535;2167
3133907;Itaverava;MG;31;Sudeste;METROPOLITANA DE BELO HORIZONTE;CONSELHEIRO LAFAIETE;-20.678;-43.61;True;5724;2989;2735;2376;1184;1192;3348;1805;1543
3134004;Itinga;MG;31;Sudeste;JEQUITINHONHA;ARACUAI;-16.613;-41.765;True;14587;7484;7100;6369;3118;3251;8218;4366;3849
3134103;Itueta;MG;31;Sudeste;VALE DO RIO DOCE;AIMORES;-19.394;-41.17;True;5830;2892;2865;3051;1493;1529;2779;1399;1336
3134202;Ituiutaba;MG;31;Sudeste;TRIANGULO MINEIRO/ALTO PARANAIBA;ITUIUTABA;-18.969;-49.465;True;92727;45618;47014;88132;43057;44999;4595;2561;2015
3134301;Itumirim;MG;31;Sudeste;CAMPO DAS VERTENTES;LAVRAS;-21.317;-44.871;True;6439;3235;3204;4799;2392;2407;1640;843;797
3134400;Iturama;MG;31;Sudeste;TRIANGULO MINEIRO/ALTO PARANAIBA;FRUTAL;-19.728;-50.196;True;31495;15557;15458;29592;14522;14590;1903;1035;868
3134509;Itutinga;MG;31;Sudeste;CAMPO DAS VERTENTES;LAVRAS;-21.298;-44.658;True;4051;2030;1870;2822;1355;1316;1229;675;554
3134608;Jaboticatubas;MG;31;Sudeste;METROPOLITANA DE BELO HORIZONTE;SETE LAGOAS;-19.514;-43.745;True;15496;7904;7586;9313;4594;4719;6183;3310;2867
3134707;Jacinto;MG;31;Sudeste;JEQUITINHONHA;ALMENARA;-16.144;-40.293;True;12422;6382;5829;9005;4459;4419;3417;1923;1410
3134806;Jacuí;MG;31;Sudeste;SUL/SUDOESTE DE MINAS;SAO SEBASTIAO DO PARAISO;-21.017;-46.741;True;7225;3710;3462;4162;2094;2068;3063;1616;1394
3134905;Jacutinga;MG;31;Sudeste;SUL/SUDOESTE DE MINAS;POCOS DE CALDAS;-22.286;-46.612;True;20389;10071;10063;16683;8064;8370;3706;2007;1693
3135001;Jaguaraçu;MG;31;Sudeste;VALE DO RIO DOCE;IPATINGA;-19.649;-42.75;True;2782;1368;1384;2070;1002;1068;712;366;316
3135050;Jaíba;MG;31;Sudeste;NORTE DE MINAS;JANAUBA;-15.338;-43.674;True;30386;15751;14580;15571;7819;7742;14815;7932;6838
3135076;Jampruca;MG;31;Sudeste;VALE DO RIO DOCE;GOVERNADOR VALADARES;-18.463;-41.804;True;4926;2524;2396;3317;1645;1672;1609;879;724
3135100;Janaúba;MG;31;Sudeste;NORTE DE MINAS;JANAUBA;-15.803;-43.309;True;65387;32221;33011;58738;28717;29968;6649;3504;3043
3135209;Januária;MG;31;Sudeste;NORTE DE MINAS;JANUARIA;-15.488;-44.362;True;64985;32196;32749;39673;19018;20652;25312;13178;12097
3135308;Japaraíba;MG;31;Sudeste;CENTRAL MINEIRA;BOM DESPACHO;-20.141;-45.503;True;3688;1859;1792;2255;1105;1150;1433;754;642
3135357;Japonvar;MG;31;Sudeste;NORTE DE MINAS;MONTES CLAROS;-15.995;-44.27;True;8232;4221;4011;2929;1459;1470;5303;2762;2541
3135407;Jeceaba;MG;31;Sudeste;METROPOLITANA DE BELO HORIZONTE;ITAGUARA;-20.535;-43.983;True;5892;2969;2878;3146;1546;1555;2746;1423;1323
3135456;Jenipapo de Minas;MG;31;Sudeste;JEQUITINHONHA;CAPELINHA;-17.083;-42.258;True;6905;3449;3340;2749;1298;1384;4156;2151;1956
3135506;Jequeri;MG;31;Sudeste;ZONA DA MATA;PONTE NOVA;-20.456;-42.666;True;12965;6602;6335;6937;3383;3552;6028;3219;2783
3135605;Jequitaí;MG;31;Sudeste;NORTE DE MINAS;PIRAPORA;-17.236;-44.446;True;8029;4049;3971;5498;2649;2849;2531;1400;1122
3135704;Jequitibá;MG;31;Sudeste;METROPOLITANA DE BELO HORIZONTE;SETE LAGOAS;-19.236;-44.028;True;5491;2923;2564;1882;954;924;3609;1969;1640
3135803;Jequitinhonha;MG;31;Sudeste;JEQUITINHONHA;ALMENARA;-16.434;-41.003;True;23982;12136;11778;16893;8243;8633;7089;3893;3145
3135902;Jesuânia;MG;31;Sudeste;SUL/SUDOESTE DE MINAS;SAO LOURENCO;-21.998;-45.291;True;4821;2489;2292;3099;1530;1529;1722;959;763
3136009;Joaíma;MG;31;Sudeste;JEQUITINHONHA;ALMENARA;-16.654;-41.031;True;14881;7437;7430;10358;5003;5355;4523;2434;2075
3136108;Joanésia;MG;31;Sudeste;VALE DO RIO DOCE;IPATINGA;-19.172;-42.679;True;5628;2810;2808;1983;972;1011;3645;1838;1797
3136207;João Monlevade;MG;31;Sudeste;METROPOLITANA DE BELO HORIZONTE;ITABIRA;-19.81;-43.174;True;71658;34298;37238;71295;34129;37044;363;169;194
3136306;João Pinheiro;MG;31;Sudeste;NOROESTE DE MINAS;PARACATU;-17.743;-46.173;True;43229;21603;20852;34209;16682;16950;9020;4921;3902
3136405;Joaquim Felício;MG;31;Sudeste;CENTRAL MINEIRA;CURVELO;-17.758;-44.172;True;3937;1982;1881;2413;1153;1256;1524;829;625
3136504;Jordânia;MG;31;Sudeste;JEQUITINHONHA;ALMENARA;-15.9;-40.178;True;10751;5635;5114;7846;3990;3856;2905;1645;1258
3136520;José Gonçalves de Minas;MG;31;Sudeste;JEQUITINHONHA;CAPELINHA;-16.907;-42.604;True;4547;2217;2136;1030;499;513;3517;1718;1623
3136553;José Raydan;MG;31;Sudeste;VALE DO RIO DOCE;PECANHA;-18.219;-42.499;True;4146;2125;2021;1127;558;569;3019;1567;1452
3136579;Josenópolis;MG;31;Sudeste;NORTE DE MINAS;GRAO MOGOL;-16.547;-42.515;True;4440;2293;2147;2278;1124;1154;2162;1169;993
3136603;Nova União;MG;31;Sudeste;METROPOLITANA DE BELO HORIZONTE;ITABIRA;-19.69;-43.58;True;5461;2756;2703;2901;1431;1470;2560;1325;1233
3136652;Juatuba;MG;31;Sudeste;METROPOLITANA DE BELO HORIZONTE;BELO HORIZONTE;-19.952;-44.343;True;19528;9766;9616;18916;9432;9346;612;334;270
3136702;Juiz de Fora;MG;31;Sudeste;ZONA DA MATA;JUIZ DE FORA;-21.764;-43.35;True;513348;;;;;;;;
3136801;Juramento;MG;31;Sudeste;NORTE DE MINAS;MONTES CLAROS;-16.848;-43.587;True;3960;1989;1967;2079;1023;1054;1881;966;913
3136900;Juruaia;MG;31;Sudeste;SUL/SUDOESTE DE MINAS;SAO SEBASTIAO DO PARAISO;-21.253;-46.577;True;8260;4210;4050;3843;1865;1978;4417;2345;2072
3136959;Juvenília;MG;31;Sudeste;NORTE DE MINAS;JANUARIA;-14.263;-44.16;True;6050;3099;2914;4289;2138;2131;1761;961;783
3137007;Ladainha;MG;31;Sudeste;VALE DO MUCURI;TEOFILO OTONI;-17.632;-41.738;True;16479;8023;8189;4206;1896;2172;12273;6127;6017
3137106;Lagamar;MG;31;Sudeste;NOROESTE DE MINAS;PARACATU;-18.178;-46.808;True;7636;3991;3638;5006;2531;2468;2630;1460;1170
3137205;Lagoa da Prata;MG;31;Sudeste;CENTRAL MINEIRA;BOM DESPACHO;-20.023;-45.544;True;44159;22006;22153;43177;21468;21709;982;538;444
3137304;Lagoa dos Patos;MG;31;Sudeste;NORTE DE MINAS;PIRAPORA;-16.983;-44.582;True;4448;2327;2121;3166;1610;1556;1282;717;565
3137403;Lagoa Dourada;MG;31;Sudeste;CAMPO DAS VERTENTES;SAO JOAO DEL REI;-20.914;-44.078;True;11792;6154;5636;6448;3259;3189;5344;2895;2447
3137502;Lagoa Formosa;MG;31;Sudeste;TRIANGULO MINEIRO/ALTO PARANAIBA;PATOS DE MINAS;-18.779;-46.408;True;16521;8333;8175;11972;5880;6079;4549;2453;2096
3137536;Lagoa Grande;MG;31;Sudeste;NOROESTE DE MINAS;PARACATU;-17.835;-46.514;True;8660;4546;4108;6420;3307;3110;2240;1239;998
3137601;Lagoa Santa;MG;31;Sudeste;METROPOLITANA DE BELO HORIZONTE;BELO HORIZONTE;-19.627;-43.89;True;44922;21799;22654;42386;20487;21430;2536;1312;1224
3137700;Lajinha;MG;31;Sudeste;ZONA DA MATA;MANHUACU;-20.151;-41.623;True;17580;8744;8761;10721;5152;5536;6859;3592;3225
3137809;Lambari;MG;31;Sudeste;SUL/SUDOESTE DE MINAS;SAO LOURENCO;-21.976;-45.35;True;18547;9276;9267;13595;6642;6949;4952;2634;2318
3137908;Lamim;MG;31;Sudeste;ZONA DA MATA;VICOSA;-20.79;-43.474;True;3546;1788;1758;1474;732;742;2072;1056;1016
3138005;Laranjal;MG;31;Sudeste;ZONA DA MATA;CATAGUASES;-21.374;-42.477;True;6310;3157;3148;4435;2156;2274;1875;1001;874
3138104;Lassance;MG;31;Sudeste;NORTE DE MINAS;PIRAPORA;-17.887;-44.578;True;6458;3307;3038;3739;1878;1856;2719;1429;1182
3138203;Lavras;MG;31;Sudeste;CAMPO DAS VERTENTES;LAVRAS;-21.245;-45;True;87421;42223;44582;82133;39602;42300;5288;2621;2282
3138302;Leandro Ferreira;MG;31;Sudeste;CENTRAL MINEIRA;BOM DESPACHO;-19.718;-45.025;True;2955;1503;1452;2019;999;1020;936;504;432
3138351;Leme do Prado;MG;31;Sudeste;JEQUITINHONHA;CAPELINHA;-17.083;-42.693;True;4930;2482;2448;1682;821;861;3248;1661;1587
3138401;Leopoldina;MG;31;Sudeste;ZONA DA MATA;CATAGUASES;-21.532;-42.643;True;49915;24008;25884;44333;21018;23298;5582;2990;2586
3138500;Liberdade;MG;31;Sudeste;SUL/SUDOESTE DE MINAS;ANDRELANDIA;-22.029;-44.32;True;5333;2702;2625;3702;1851;1845;1631;851;780
3138609;Lima Duarte;MG;31;Sudeste;ZONA DA MATA;JUIZ DE FORA;-21.843;-43.793;True;15909;7986;7860;11601;5677;5888;4308;2309;1972
3138625;Limeira do Oeste;MG;31;Sudeste;TRIANGULO MINEIRO/ALTO PARANAIBA;FRUTAL;-19.551;-50.581;True;6492;3268;3131;3867;1930;1934;2625;1338;1197
3138658;Lontra;MG;31;Sudeste;NORTE DE MINAS;MONTES CLAROS;-15.903;-44.305;True;7979;4137;3813;5026;2577;2449;2953;1560;1364
3138674;Luisburgo;MG;31;Sudeste;ZONA DA MATA;MANHUACU;-20.44;-42.103;True;6276;3247;3015;1645;837;803;4631;2410;2212
3138682;Luislândia;MG;31;Sudeste;NORTE DE MINAS;MONTES CLAROS;-16.118;-44.589;True;6432;3292;3140;2429;1192;1237;4003;2100;1903
3138708;Luminárias;MG;31;Sudeste;CAMPO DAS VERTENTES;LAVRAS;-21.511;-44.903;True;5374;2795;2579;4155;2115;2040;1219;680;539
3138807;Luz;MG;31;Sudeste;CENTRAL MINEIRA;BOM DESPACHO;-19.801;-45.686;True;17173;8614;8534;15159;7480;7658;2014;1134;876
3138906;Machacalis;MG;31;Sudeste;VALE DO MUCURI;NANUQUE;-17.077;-40.716;True;6855;3544;3279;5714;2894;2788;1141;650;491
3139003;Machado;MG;31;Sudeste;SUL/SUDOESTE DE MINAS;ALFENAS;-21.675;-45.92;True;37567;18773;18746;30429;14956;15435;7138;3817;3311
3139102;Madre de Deus de Minas;MG;31;Sudeste;CAMPO DAS VERTENTES;SAO JOAO DEL REI;-21.483;-44.33;True;4951;2504;2440;3709;1838;1868;1242;666;572
3139201;Malacacheta;MG;31;Sudeste;VALE DO MUCURI;TEOFILO OTONI;-17.842;-42.077;True;17917;8635;9214;10912;4985;5922;7005;3650;3292
3139250;Mamonas;MG;31;Sudeste;NORTE DE MINAS;JANAUBA;-15.05;-42.949;True;6247;3158;3089;2378;1177;1201;3869;1981;1888
3139300;Manga;MG;31;Sudeste;NORTE DE MINAS;JANUARIA;-14.756;-43.932;True;20903;10424;10459;14375;6966;7404;6528;3458;3055
3139409;Manhuaçu;MG;31;Sudeste;ZONA DA MATA;MANHUACU;-20.258;-42.034;True;74297;36261;37306;59908;28787;30499;14389;7474;6807
3139508;Manhumirim;MG;31;Sudeste;ZONA DA MATA;MANHUACU;-20.358;-41.958;True;20209;9774;10087;16675;7871;8505;3534;1903;1582
3139607;Mantena;MG;31;Sudeste;VALE DO RIO DOCE;MANTENA;-18.782;-40.98;True;26721;12967;13751;20620;9805;10815;6101;3162;2936
3139706;Maravilhas;MG;31;Sudeste;METROPOLITANA DE BELO HORIZONTE;SETE LAGOAS;-19.516;-44.676;True;6840;3436;3366;4685;2323;2359;2155;1113;1007
3139805;Mar de Espanha;MG;31;Sudeste;ZONA DA MATA;JUIZ DE FORA;-21.867;-43.01;True;11139;5408;5660;10078;4866;5179;1061;542;481
3139904;Maria da Fé;MG;31;Sudeste;SUL/SUDOESTE DE MINAS;ITAJUBA;-22.308;-45.375;True;14249;7273;6969;7885;3948;3937;6364;3325;3032
3140001;Mariana;MG;31;Sudeste;METROPOLITANA DE BELO HORIZONTE;OURO PRETO;-20.378;-43.416;True;51693;25033;25815;44744;21628;22514;6949;3405;3301
3140100;Marilac;MG;31;Sudeste;VALE DO RIO DOCE;GOVERNADOR VALADARES;-18.508;-42.084;True;4285;2134;2148;3431;1691;1737;854;443;411
3140159;Mário Campos;MG;31;Sudeste;METROPOLITANA DE BELO HORIZONTE;BELO HORIZONTE;-20.056;-44.188;True;11421;5680;5710;10807;5357;5419;614;323;291
3140209;Maripá de Minas;MG;31;Sudeste;ZONA DA MATA;JUIZ DE FORA;-21.698;-42.959;True;2827;1423;1404;2261;1115;1146;566;308;258
3140308;Marliéria;MG;31;Sudeste;VALE DO RIO DOCE;IPATINGA;-19.712;-42.732;True;3743;1811;1930;2631;1272;1359;1112;539;571
3140407;Marmelópolis;MG;31;Sudeste;SUL/SUDOESTE DE MINAS;ITAJUBA;-22.449;-45.165;True;3100;1572;1528;1629;812;817;1471;760;711
3140506;Martinho Campos;MG;31;Sudeste;CENTRAL MINEIRA;BOM DESPACHO;-19.332;-45.237;True;12165;6189;5863;10010;5036;4896;2155;1153;967
3140530;Martins Soares;MG;31;Sudeste;ZONA DA MATA;MANHUACU;-20.257;-41.877;True;6338;3211;3053;2513;1227;1241;3825;1984;1812
3140555;Mata Verde;MG;31;Sudeste;JEQUITINHONHA;ALMENARA;-15.686;-40.741;True;7458;3899;3549;6088;3098;2982;1370;801;567
3140605;Materlândia;MG;31;Sudeste;VALE DO RIO DOCE;GUANHAES;-18.474;-43.06;True;4662;2341;2272;2017;1003;1014;2645;1338;1258
3140704;Mateus Leme;MG;31;Sudeste;METROPOLITANA DE BELO HORIZONTE;BELO HORIZONTE;-19.986;-44.428;True;25627;12723;12805;22063;10851;11144;3564;1872;1661
3140803;Matias Barbosa;MG;31;Sudeste;ZONA DA MATA;JUIZ DE FORA;-21.869;-43.319;True;13205;6612;6588;12671;6324;6347;534;288;241
3140852;Matias Cardoso;MG;31;Sudeste;NORTE DE MINAS;JANUARIA;-14.855;-43.922;True;10270;5320;4927;5062;2573;2489;5208;2747;2438
3140902;Matipó;MG;31;Sudeste;ZONA DA MATA;MANHUACU;-20.284;-42.341;True;16430;8170;8163;12536;6173;6332;3894;1997;1831
3141009;Mato Verde;MG;31;Sudeste;NORTE DE MINAS;JANAUBA;-15.397;-42.866;True;12664;6310;6354;9206;4486;4720;3458;1824;1634
3141108;Matozinhos;MG;31;Sudeste;METROPOLITANA DE BELO HORIZONTE;SETE LAGOAS;-19.558;-44.081;True;33317;16423;16832;30056;14770;15240;3261;1653;1592
3141207;Matutina;MG;31;Sudeste;TRIANGULO MINEIRO/ALTO PARANAIBA;PATOS DE MINAS;-19.223;-45.969;True;3700;1805;1892;2754;1324;1430;946;481;462
3141306;Medeiros;MG;31;Sudeste;OESTE DE MINAS;PIUI;-19.996;-46.226;True;3238;1705;1533;1800;903;897;1438;802;636
3141405;Medina;MG;31;Sudeste;JEQUITINHONHA;PEDRA AZUL;-16.223;-41.477;True;20667;10327;10194;14393;7014;7355;6274;3313;2839
3141504;Mendes Pimentel;MG;31;Sudeste;VALE DO RIO DOCE;MANTENA;-18.661;-41.405;True;6431;3211;3220;3406;1655;1751;3025;1556;1469
3141603;Mercês;MG;31;Sudeste;ZONA DA MATA;UBA;-21.194;-43.341;True;10452;5200;5156;6847;3330;3449;3605;1870;1707
3141702;Mesquita;MG;31;Sudeste;VALE DO RIO DOCE;IPATINGA;-19.223;-42.607;True;6493;3296;3196;3797;1902;1895;2696;1394;1301
3141801;Minas Novas;MG;31;Sudeste;JEQUITINHONHA;CAPELINHA;-17.219;-42.59;True;30578;15110;15298;12271;5848;6411;18307;9262;8887
3141900;Minduri;MG;31;Sudeste;SUL/SUDOESTE DE MINAS;ANDRELANDIA;-21.682;-44.604;True;3603;1766;1837;3139;1525;1614;464;241;223
3142007;Mirabela;MG;31;Sudeste;NORTE DE MINAS;MONTES CLAROS;-16.263;-44.164;True;12769;6486;6247;9860;4951;4894;2909;1535;1353
3142106;Miradouro;MG;31;Sudeste;ZONA DA MATA;MURIAE;-20.891;-42.343;True;10197;5229;4968;5535;2722;2813;4662;2507;2155
3142205;Miraí;MG;31;Sudeste;ZONA DA MATA;MURIAE;-21.195;-42.614;True;12949;6511;6438;10139;4998;5141;2810;1513;1297
3142254;Miravânia;MG;31;Sudeste;NORTE DE MINAS;JANUARIA;-14.741;-44.404;True;4708;2363;2345;842;431;411;3866;1932;1934
3142304;Moeda;MG;31;Sudeste;METROPOLITANA DE BELO HORIZONTE;ITAGUARA;-20.333;-44.053;True;4506;2287;2219;1803;876;927;2703;1411;1292
3142403;Moema;MG;31;Sudeste;CENTRAL MINEIRA;BOM DESPACHO;-19.843;-45.411;True;6754;3390;3360;5902;2921;2981;852;469;379
3142502;Monjolos;MG;31;Sudeste;CENTRAL MINEIRA;CURVELO;-18.325;-44.119;True;2303;1141;1109;1438;699;729;865;442;380
3142601;Monsenhor Paulo;MG;31;Sudeste;SUL/SUDOESTE DE MINAS;VARGINHA;-21.758;-45.541;True;7391;3759;3586;5457;2743;2670;1934;1016;916
3142700;Montalvânia;MG;31;Sudeste;NORTE DE MINAS;JANUARIA;-14.423;-44.366;True;15961;8051;7899;9890;4886;4993;6071;3165;2906
3142809;Monte Alegre de Minas;MG;31;Sudeste;TRIANGULO MINEIRO/ALTO PARANAIBA;UBERLANDIA;-18.871;-48.881;True;18348;9293;8868;13231;6487;6644;5117;2806;2224
3142908;Monte Azul;MG;31;Sudeste;NORTE DE MINAS;JANAUBA;-15.155;-42.875;True;22437;11073;11359;11836;5766;6070;10601;5307;5289
3143005;Monte Belo;MG;31;Sudeste;SUL/SUDOESTE DE MINAS;SAO SEBASTIAO DO PARAISO;-21.326;-46.368;True;12573;6403;6051;8616;4276;4302;3957;2127;1749
3143104;Monte Carmelo;MG;31;Sudeste;TRIANGULO MINEIRO/ALTO PARANAIBA;PATROCINIO;-18.725;-47.499;True;44367;22415;21825;38674;19296;19257;5693;3119;2568
3143153;Monte Formoso;MG;31;Sudeste;JEQUITINHONHA;ALMENARA;-16.866;-41.255;True;4709;2475;2234;1627;842;785;3082;1633;1449
3143203;Monte Santo de Minas;MG;31;Sudeste;SUL/SUDOESTE DE MINAS;SAO SEBASTIAO DO PARAISO;-21.19;-46.98;True;20133;10122;9987;15884;7816;8068;4249;2306;1919
3143302;Montes Claros;MG;31;Sudeste;NORTE DE MINAS;MONTES CLAROS;-16.735;-43.862;True;352384;;;;;;;;
3143401;Monte Sião;MG;31;Sudeste;SUL/SUDOESTE DE MINAS;POCOS DE CALDAS;-22.433;-46.573;True;19228;9646;9582;14198;6916;7282;5030;2730;2300
3143450;Montezuma;MG;31;Sudeste;NORTE DE MINAS;SALINAS;-15.172;-42.497;True;7259;3622;3564;2872;1431;1441;4387;2191;2123
3143500;Morada Nova de Minas;MG;31;Sudeste;CENTRAL MINEIRA;TRES MARIAS;-18.604;-45.357;True;8297;4310;3987;6402;3282;3120;1895;1028;867
3143609;Morro da Garça;MG;31;Sudeste;CENTRAL MINEIRA;CURVELO;-18.547;-44.603;True;2887;1490;1359;1715;869;842;1172;621;517
3143708;Morro do Pilar;MG;31;Sudeste;METROPOLITANA DE BELO HORIZONTE;CONCEICAO DO MATO DENTRO;-19.216;-43.376;True;3474;1759;1704;2636;1302;1334;838;457;370
3143807;Munhoz;MG;31;Sudeste;SUL/SUDOESTE DE MINAS;POUSO ALEGRE;-22.613;-46.361;True;6298;3255;3043;3492;1760;1732;2806;1495;1311
3143906;Muriaé;MG;31;Sudeste;ZONA DA MATA;MURIAE;-21.131;-42.366;True;95548;46100;49192;88428;42303;45895;7120;3797;3297
3144003;Mutum;MG;31;Sudeste;VALE DO RIO DOCE;AIMORES;-19.8;-41.438;True;26331;13345;12865;13256;6446;6744;13075;6899;6121
3144102;Muzambinho;MG;31;Sudeste;SUL/SUDOESTE DE MINAS;SAO SEBASTIAO DO PARAISO;-21.376;-46.526;True;19925;9944;9965;14685;7144;7536;5240;2800;2429
3144201;Nacip Raydan;MG;31;Sudeste;VALE DO RIO DOCE;GOVERNADOR VALADARES;-18.459;-42.249;True;2957;1477;1480;1847;898;949;1110;579;531
3144300;Nanuque;MG;31;Sudeste;VALE DO MUCURI;NANUQUE;-17.839;-40.354;True;40307;19652;20369;37253;18024;18978;3054;1628;1391
3144359;Naque;MG;31;Sudeste;VALE DO RIO DOCE;IPATINGA;-19.23;-42.328;True;5885;2875;2937;5474;2683;2774;411;192;163
3144375;Natalândia;MG;31;Sudeste;NOROESTE DE MINAS;UNAI;-16.504;-46.493;True;3271;1752;1503;2415;1266;1149;856;486;354
3144409;Natércia;MG;31;Sudeste;SUL/SUDOESTE DE MINAS;SANTA RITA DO SAPUCAI;-22.12;-45.512;True;4623;2408;2178;2868;1427;1434;1755;981;744
3144508;Nazareno;MG;31;Sudeste;CAMPO DAS VERTENTES;SAO JOAO DEL REI;-21.216;-44.611;True;7716;3959;3747;5938;2971;2957;1778;988;790
3144607;Nepomuceno;MG;31;Sudeste;CAMPO DAS VERTENTES;LAVRAS;-21.236;-45.236;True;24430;11939;12138;18708;8949;9550;5722;2990;2588
3144656;Ninheira;MG;31;Sudeste;NORTE DE MINAS;SALINAS;-15.321;-41.754;True;10414;5043;4730;2690;1251;1280;7724;3792;3450
3144672;Nova Belém;MG;31;Sudeste;VALE DO RIO DOCE;MANTENA;-18.475;-41.017;True;3629;1834;1795;1059;495;564;2570;1339;1231
3144706;Nova Era;MG;31;Sudeste;METROPOLITANA DE BELO HORIZONTE;ITABIRA;-19.75;-43.038;True;17932;8527;9275;15475;7308;8074;2457;1219;1201
3144805;Nova Lima;MG;31;Sudeste;METROPOLITANA DE BELO HORIZONTE;BELO HORIZONTE;-19.986;-43.847;True;72207;34844;37147;70561;34009;36345;1646;835;802
3144904;Nova Módica;MG;31;Sudeste;VALE DO RIO DOCE;GOVERNADOR VALADARES;-18.437;-41.501;True;3878;1967;1905;2180;1053;1127;1698;914;778
3145000;Nova Ponte;MG;31;Sudeste;TRIANGULO MINEIRO/ALTO PARANAIBA;ARAXA;-19.136;-47.683;True;11586;5940;5516;9916;5010;4783;1670;930;733
3145059;Nova Porteirinha;MG;31;Sudeste;NORTE DE MINAS;JANAUBA;-15.803;-43.301;True;7358;3778;3580;4039;2015;2024;3319;1763;1556
3145109;Nova Resende;MG;31;Sudeste;SUL/SUDOESTE DE MINAS;SAO SEBASTIAO DO PARAISO;-21.126;-46.42;True;14145;7347;6662;8044;4094;3893;6101;3253;2769
3145208;Nova Serrana;MG;31;Sudeste;OESTE DE MINAS;DIVINOPOLIS;-19.876;-44.984;True;60195;30967;29146;56833;29177;27580;3362;1790;1566
3145307;Novo Cruzeiro;MG;31;Sudeste;JEQUITINHONHA;ARACUAI;-17.468;-41.875;True;30331;15114;15103;9359;4423;4917;20972;10691;10186
3145356;Novo Oriente de Minas;MG;31;Sudeste;VALE DO MUCURI;TEOFILO OTONI;-17.415;-41.215;True;10327;5295;5027;4175;2030;2145;6152;3265;2882
3145372;Novorizonte;MG;31;Sudeste;NORTE DE MINAS;SALINAS;-16.017;-42.408;True;4899;2457;2403;1507;734;767;3392;1723;1636
3145406;Olaria;MG;31;Sudeste;ZONA DA MATA;JUIZ DE FORA;-21.861;-43.937;True;2380;1299;1081;962;496;466;1418;803;615
3145455;Olhos-D'Água;MG;31;Sudeste;NORTE DE MINAS;BOCAIUVA;-17.397;-43.573;True;4991;2538;2262;2633;1319;1294;2358;1219;968
3145505;Olímpio Noronha;MG;31;Sudeste;SUL/SUDOESTE DE MINAS;SAO LOURENCO;-22.068;-45.264;True;2505;1300;1205;2045;1043;1002;460;257;203
3145604;Oliveira;MG;31;Sudeste;OESTE DE MINAS;OLIVEIRA;-20.696;-44.827;True;37805;18529;19272;33653;16274;17375;4152;2255;1897
3145703;Oliveira Fortes;MG;31;Sudeste;ZONA DA MATA;JUIZ DE FORA;-21.339;-43.456;True;1939;998;937;1079;530;549;860;468;388
3145802;Onça de Pitangui;MG;31;Sudeste;METROPOLITANA DE BELO HORIZONTE;PARA DE MINAS;-19.73;-44.807;True;3019;1575;1424;1485;763;719;1534;812;705
3145851;Oratórios;MG;31;Sudeste;ZONA DA MATA;PONTE NOVA;-20.431;-42.806;True;4385;2158;2227;2880;1384;1496;1505;774;731
3145877;Orizânia;MG;31;Sudeste;ZONA DA MATA;MURIAE;-20.506;-42.21;True;6771;3439;3301;1984;955;1029;4787;2484;2272
3145901;Ouro Branco;MG;31;Sudeste;METROPOLITANA DE BELO HORIZONTE;CONSELHEIRO LAFAIETE;-20.521;-43.692;True;33548;16833;16715;29631;14808;14823;3917;2025;1892
3146008;Ouro Fino;MG;31;Sudeste;SUL/SUDOESTE DE MINAS;POCOS DE CALDAS;-22.283;-46.369;True;31154;15360;15301;22115;10565;11176;9039;4795;4125
3146107;Ouro Preto;MG;31;Sudeste;METROPOLITANA DE BELO HORIZONTE;OURO PRETO;-20.288;-43.508;True;67048;32675;34106;57946;27932;29793;9102;4743;4313
3146206;Ouro Verde de Minas;MG;31;Sudeste;VALE DO MUCURI;TEOFILO OTONI;-18.071;-41.27;True;6832;3441;3367;3965;1975;1990;2867;1466;1377
3146255;Padre Carvalho;MG;31;Sudeste;NORTE DE MINAS;GRAO MOGOL;-16.364;-42.515;True;5828;2956;2872;3498;1754;1744;2330;1202;1128
3146305;Padre Paraíso;MG;31;Sudeste;JEQUITINHONHA;ARACUAI;-17.072;-41.524;True;18120;9031;9077;11208;5445;5763;6912;3586;3314
3146404;Paineiras;MG;31;Sudeste;CENTRAL MINEIRA;TRES MARIAS;-18.908;-45.532;True;4594;2306;2285;3527;1718;1806;1067;588;479
3146503;Pains;MG;31;Sudeste;OESTE DE MINAS;FORMIGA;-20.371;-45.661;True;8122;4088;4026;5778;2844;2934;2344;1244;1092
3146552;Pai Pedro;MG;31;Sudeste;NORTE DE MINAS;JANAUBA;-15.517;-43.065;True;5979;3023;2956;1635;792;843;4344;2231;2113
3146602;Paiva;MG;31;Sudeste;ZONA DA MATA;JUIZ DE FORA;-21.289;-43.416;True;1630;845;785;1212;612;600;418;233;185
3146701;Palma;MG;31;Sudeste;ZONA DA MATA;CATAGUASES;-21.375;-42.314;True;6118;3069;3049;4766;2361;2405;1352;708;644
3146750;Palmópolis;MG;31;Sudeste;JEQUITINHONHA;ALMENARA;-16.735;-40.42;True;7041;3646;3389;4438;2202;2233;2603;1444;1156
3146909;Papagaios;MG;31;Sudeste;METROPOLITANA DE BELO HORIZONTE;SETE LAGOAS;-19.449;-44.748;True;14410;7420;6986;12086;6126;5956;2324;1294;1030
3147006;Paracatu;MG;31;Sudeste;NOROESTE DE MINAS;PARACATU;-17.222;-46.875;True;79739;39910;39146;68625;33973;34214;11114;5937;4932
3147105;Pará de Minas;MG;31;Sudeste;METROPOLITANA DE BELO HORIZONTE;PARA DE MINAS;-19.86;-44.608;True;79852;39377;40400;75731;37044;38626;4121;2333;1774
3147204;Paraguaçu;MG;31;Sudeste;SUL/SUDOESTE DE MINAS;ALFENAS;-21.547;-45.738;True;19603;9792;9673;15822;7796;7949;3781;1996;1724
3147303;Paraisópolis;MG;31;Sudeste;SUL/SUDOESTE DE MINAS;ITAJUBA;-22.554;-45.78;True;18088;9129;8927;15227;7565;7662;2861;1564;1265
3147402;Paraopeba;MG;31;Sudeste;METROPOLITANA DE BELO HORIZONTE;SETE LAGOAS;-19.274;-44.404;True;22204;10989;11188;19295;9434;9858;2909;1555;1330
3147501;Passabém;MG;31;Sudeste;METROPOLITANA DE BELO HORIZONTE;CONCEICAO DO MATO DENTRO;-19.353;-43.136;True;1801;892;902;965;456;509;836;436;393
3147600;Passa Quatro;MG;31;Sudeste;SUL/SUDOESTE DE MINAS;SAO LOURENCO;-22.39;-44.967;True;15285;7602;7663;11689;5732;5957;3596;1870;1706
3147709;Passa Tempo;MG;31;Sudeste;OESTE DE MINAS;OLIVEIRA;-20.651;-44.496;True;8494;4268;4226;6406;3169;3237;2088;1099;989
3147808;Passa-Vinte;MG;31;Sudeste;SUL/SUDOESTE DE MINAS;ANDRELANDIA;-22.209;-44.234;True;2082;1088;991;1285;640;642;797;448;349
3147907;Passos;MG;31;Sudeste;SUL/SUDOESTE DE MINAS;PASSOS;-20.719;-46.61;True;102765;50933;51761;97880;48286;49544;4885;2647;2217
3147956;Patis;MG;31;Sudeste;NORTE DE MINAS;MONTES CLAROS;-16.076;-44.082;True;5346;2784;2498;2289;1176;1113;3057;1608;1385
3148004;Patos de Minas;MG;31;Sudeste;TRIANGULO MINEIRO/ALTO PARANAIBA;PATOS DE MINAS;-18.579;-46.518;True;133054;65013;67457;121805;58855;62416;11249;6158;5041
3148103;Patrocínio;MG;31;Sudeste;TRIANGULO MINEIRO/ALTO PARANAIBA;PATROCINIO;-18.944;-46.993;True;81589;41566;39964;70976;35571;35349;10613;5995;4615
3148202;Patrocínio do Muriaé;MG;31;Sudeste;ZONA DA MATA;MURIAE;-21.153;-42.215;True;5319;2691;2628;4064;2011;2053;1255;680;575
3148301;Paula Cândido;MG;31;Sudeste;ZONA DA MATA;VICOSA;-20.874;-42.98;True;9086;4600;4443;4758;2332;2422;4328;2268;2021
3148400;Paulistas;MG;31;Sudeste;VALE DO RIO DOCE;GUANHAES;-18.427;-42.868;True;4893;2404;2489;2275;1067;1208;2618;1337;1281
3148509;Pavão;MG;31;Sudeste;VALE DO MUCURI;TEOFILO OTONI;-17.428;-40.999;True;8868;4503;4318;5390;2666;2724;3478;1837;1594
3148608;Peçanha;MG;31;Sudeste;VALE DO RIO DOCE;PECANHA;-18.549;-42.557;True;17157;8440;8682;8472;4019;4451;8685;4421;4231
3148707;Pedra Azul;MG;31;Sudeste;JEQUITINHONHA;PEDRA AZUL;-16.005;-41.297;True;24851;12342;12431;22052;10797;11180;2799;1545;1251
3148756;Pedra Bonita;MG;31;Sudeste;ZONA DA MATA;MANHUACU;-20.521;-42.33;True;6474;3331;3077;1632;822;810;4842;2509;2267
3148806;Pedra do Anta;MG;31;Sudeste;ZONA DA MATA;VICOSA;-20.597;-42.714;True;3672;1876;1796;2245;1103;1142;1427;773;654
3148905;Pedra do Indaiá;MG;31;Sudeste;OESTE DE MINAS;FORMIGA;-20.258;-45.209;True;3921;2039;1882;1984;999;985;1937;1040;897
3149002;Pedra Dourada;MG;31;Sudeste;ZONA DA MATA;MURIAE;-20.83;-42.154;True;2100;1106;987;1176;587;582;924;519;405
3149101;Pedralva;MG;31;Sudeste;SUL/SUDOESTE DE MINAS;SANTA RITA DO SAPUCAI;-22.243;-45.466;True;11184;5719;5458;5234;2562;2672;5950;3157;2786
3149150;Pedras de Maria da Cruz;MG;31;Sudeste;NORTE DE MINAS;JANUARIA;-15.607;-44.391;True;10976;5702;5212;6283;3193;3090;4693;2509;2122
3149200;Pedrinópolis;MG;31;Sudeste;TRIANGULO MINEIRO/ALTO PARANAIBA;ARAXA;-19.228;-47.462;True;3448;1754;1694;2885;1437;1448;563;317;246
3149309;Pedro Leopoldo;MG;31;Sudeste;METROPOLITANA DE BELO HORIZONTE;BELO HORIZONTE;-19.618;-44.043;True;56518;27447;28584;47338;22911;24028;9180;4536;4556
3149408;Pedro Teixeira;MG;31;Sudeste;ZONA DA MATA;JUIZ DE FORA;-21.706;-43.746;True;1658;899;759;869;451;418;789;448;341
3149507;Pequeri;MG;31;Sudeste;ZONA DA MATA;JUIZ DE FORA;-21.834;-43.121;True;2997;1499;1493;2762;1362;1395;235;137;98
3149606;Pequi;MG;31;Sudeste;METROPOLITANA DE BELO HORIZONTE;SETE LAGOAS;-19.633;-44.659;True;4232;2162;2069;2980;1473;1507;1252;689;562
3149705;Perdigão;MG;31;Sudeste;OESTE DE MINAS;DIVINOPOLIS;-19.953;-45.084;True;7310;3692;3593;6279;3127;3132;1031;565;461
3149804;Perdizes;MG;31;Sudeste;TRIANGULO MINEIRO/ALTO PARANAIBA;ARAXA;-19.353;-47.293;True;13924;7435;6477;8751;4462;4283;5173;2973;2194
3149903;PerdõEs;MG;31;Sudeste;OESTE DE MINAS;CAMPO BELO;-21.091;-45.091;True;19407;9573;9821;17109;8346;8750;2298;1227;1071
3149952;Periquito;MG;31;Sudeste;VALE DO RIO DOCE;IPATINGA;-19.158;-42.234;True;7030;3407;3620;5414;2617;2794;1616;790;826
3150000;Pescador;MG;31;Sudeste;VALE DO RIO DOCE;GOVERNADOR VALADARES;-18.357;-41.598;True;4056;2004;2040;3250;1550;1690;806;454;350
3150109;Piau;MG;31;Sudeste;ZONA DA MATA;JUIZ DE FORA;-21.509;-43.323;True;2973;1556;1353;1720;879;841;1253;677;512
3150158;Piedade de Caratinga;MG;31;Sudeste;VALE DO RIO DOCE;CARATINGA;-19.759;-42.076;True;6444;3284;3133;4139;2055;2080;2305;1229;1053
3150208;Piedade de Ponte Nova;MG;31;Sudeste;ZONA DA MATA;PONTE NOVA;-20.245;-42.734;True;4113;2007;2106;3130;1507;1623;983;500;483
3150307;Piedade do Rio Grande;MG;31;Sudeste;CAMPO DAS VERTENTES;SAO JOAO DEL REI;-21.469;-44.196;True;4781;2429;2342;3510;1740;1770;1271;689;572
3150406;Piedade dos Gerais;MG;31;Sudeste;METROPOLITANA DE BELO HORIZONTE;ITAGUARA;-20.471;-44.227;True;4542;2392;2150;1896;975;921;2646;1417;1229
3150505;Pimenta;MG;31;Sudeste;OESTE DE MINAS;FORMIGA;-20.484;-45.799;True;8164;4201;3868;6652;3410;3242;1512;791;626
3150539;Pingo-D'Água;MG;31;Sudeste;VALE DO RIO DOCE;CARATINGA;-19.727;-42.408;True;4016;1995;2021;3663;1798;1865;353;197;156
3150570;Pintópolis;MG;31;Sudeste;NORTE DE MINAS;JANUARIA;-16.059;-45.156;True;7727;4119;3608;2498;1284;1214;5229;2835;2394
3150604;Piracema;MG;31;Sudeste;OESTE DE MINAS;OLIVEIRA;-20.508;-44.483;True;6554;3331;3223;3075;1498;1577;3479;1833;1646
3150703;Pirajuba;MG;31;Sudeste;TRIANGULO MINEIRO/ALTO PARANAIBA;FRUTAL;-19.907;-48.701;True;3694;1975;1604;3358;1805;1465;336;170;139
3150802;Piranga;MG;31;Sudeste;ZONA DA MATA;VICOSA;-20.685;-43.3;True;17208;8649;8559;5730;2770;2960;11478;5879;5599
3150901;Piranguçu;MG;31;Sudeste;SUL/SUDOESTE DE MINAS;ITAJUBA;-22.528;-45.495;True;5113;2680;2433;1717;880;837;3396;1800;1596
3151008;Piranguinho;MG;31;Sudeste;SUL/SUDOESTE DE MINAS;ITAJUBA;-22.401;-45.532;True;7849;4013;3836;4654;2324;2330;3195;1689;1506
3151107;Pirapetinga;MG;31;Sudeste;ZONA DA MATA;CATAGUASES;-21.656;-42.346;True;10240;5038;5202;8927;4358;4569;1313;680;633
3151206;Pirapora;MG;31;Sudeste;NORTE DE MINAS;PIRAPORA;-17.345;-44.942;True;51636;25191;26066;50439;24526;25543;1197;665;523
3151305;Piraúba;MG;31;Sudeste;ZONA DA MATA;UBA;-21.276;-43.026;True;10686;5342;5344;8462;4150;4312;2224;1192;1032
3151404;Pitangui;MG;31;Sudeste;METROPOLITANA DE BELO HORIZONTE;PARA DE MINAS;-19.683;-44.89;True;24618;12129;12303;20665;10115;10471;3953;2014;1832
3151503;Piumhi;MG;31;Sudeste;OESTE DE MINAS;PIUI;-20.465;-45.958;True;30984;15387;15502;27491;13492;13955;3493;1895;1547
3151602;Planura;MG;31;Sudeste;TRIANGULO MINEIRO/ALTO PARANAIBA;FRUTAL;-20.138;-48.702;True;10289;5441;4847;9989;5273;4716;300;168;131
3151701;Poço Fundo;MG;31;Sudeste;SUL/SUDOESTE DE MINAS;ALFENAS;-21.781;-45.965;True;15350;7781;7401;9126;4532;4572;6224;3249;2829
3151800;Poços de Caldas;MG;31;Sudeste;SUL/SUDOESTE DE MINAS;POCOS DE CALDAS;-21.788;-46.561;True;144386;69818;74476;140455;67730;72661;3931;2088;1815
3151909;Pocrane;MG;31;Sudeste;VALE DO RIO DOCE;AIMORES;-19.62;-41.637;True;8769;4390;4370;4826;2331;2495;3943;2059;1875
3152006;Pompéu;MG;31;Sudeste;CENTRAL MINEIRA;TRES MARIAS;-19.224;-44.935;True;28393;14315;13989;25098;12526;12492;3295;1789;1497
3152105;Ponte Nova;MG;31;Sudeste;ZONA DA MATA;PONTE NOVA;-20.416;-42.909;True;55687;26376;29180;49845;23438;26318;5842;2938;2862
3152131;Ponto Chique;MG;31;Sudeste;NORTE DE MINAS;MONTES CLAROS;-16.631;-45.066;True;4046;2058;1959;2575;1280;1295;1471;778;664
3152170;Ponto dos Volantes;MG;31;Sudeste;JEQUITINHONHA;ARACUAI;-16.753;-41.504;True;10976;5556;5417;3871;1913;1958;7105;3643;3459
3152204;Porteirinha;MG;31;Sudeste;NORTE DE MINAS;JANAUBA;-15.743;-43.028;True;36864;18507;18306;18340;8960;9364;18524;9547;8942
3152303;Porto Firme;MG;31;Sudeste;ZONA DA MATA;VICOSA;-20.673;-43.084;True;10404;5227;5140;4888;2360;2528;5516;2867;2612
3152402;Poté;MG;31;Sudeste;VALE DO MUCURI;TEOFILO OTONI;-17.807;-41.786;True;14749;7093;7442;8752;4108;4528;5997;2985;2914
3152501;Pouso Alegre;MG;31;Sudeste;SUL/SUDOESTE DE MINAS;POUSO ALEGRE;-22.23;-45.936;True;120467;58758;60220;110567;53451;55707;9900;5307;4513
3152600;Pouso Alto;MG;31;Sudeste;SUL/SUDOESTE DE MINAS;SAO LOURENCO;-22.194;-44.973;True;6359;3257;3097;3519;1706;1811;2840;1551;1286
3152709;Prados;MG;31;Sudeste;CAMPO DAS VERTENTES;SAO JOAO DEL REI;-21.058;-44.08;True;8168;4114;4054;5408;2664;2744;2760;1450;1310
3152808;Prata;MG;31;Sudeste;TRIANGULO MINEIRO/ALTO PARANAIBA;UBERLANDIA;-19.307;-48.924;True;25511;13145;12271;18766;9396;9361;6745;3749;2910
3152907;Pratápolis;MG;31;Sudeste;SUL/SUDOESTE DE MINAS;PASSOS;-20.745;-46.861;True;8653;4362;4280;7423;3697;3726;1230;665;554
3153004;Pratinha;MG;31;Sudeste;TRIANGULO MINEIRO/ALTO PARANAIBA;ARAXA;-19.751;-46.378;True;3236;1652;1489;1729;832;869;1507;820;620
3153103;Presidente Bernardes;MG;31;Sudeste;ZONA DA MATA;VICOSA;-20.769;-43.188;True;5699;2896;2782;1568;719;828;4131;2177;1954
3153202;Presidente Juscelino;MG;31;Sudeste;CENTRAL MINEIRA;CURVELO;-18.637;-44.058;True;4257;2218;2028;1835;939;896;2422;1279;1132
3153301;Presidente Kubitschek;MG;31;Sudeste;JEQUITINHONHA;DIAMANTINA;-18.614;-43.562;True;2978;1502;1476;1900;939;961;1078;563;515
3153400;Presidente Olegário;MG;31;Sudeste;NOROESTE DE MINAS;PARACATU;-18.418;-46.418;True;18256;9260;8941;12344;6093;6233;5912;3167;2708
3153509;Alto Jequitibá;MG;31;Sudeste;ZONA DA MATA;MANHUACU;-20.424;-41.966;True;7976;4092;3875;4176;2044;2132;3800;2048;1743
3153608;Prudente de Morais;MG;31;Sudeste;METROPOLITANA DE BELO HORIZONTE;SETE LAGOAS;-19.482;-44.155;True;8874;4426;4448;8484;4210;4274;390;216;174
3153707;Quartel Geral;MG;31;Sudeste;CENTRAL MINEIRA;BOM DESPACHO;-19.274;-45.557;True;3200;1619;1581;2616;1284;1332;584;335;249
3153806;Queluzito;MG;31;Sudeste;METROPOLITANA DE BELO HORIZONTE;CONSELHEIRO LAFAIETE;-20.74;-43.884;True;1826;939;887;775;402;373;1051;537;514
3153905;Raposos;MG;31;Sudeste;METROPOLITANA DE BELO HORIZONTE;BELO HORIZONTE;-19.967;-43.804;True;14874;7236;7633;14204;6903;7296;670;333;337
3154002;Raul Soares;MG;31;Sudeste;ZONA DA MATA;PONTE NOVA;-20.102;-42.453;True;23901;11789;11993;15153;7233;7836;8748;4556;4157
3154101;Recreio;MG;31;Sudeste;ZONA DA MATA;CATAGUASES;-21.525;-42.469;True;10194;4999;5188;9044;4391;4653;1150;608;535
3154150;Reduto;MG;31;Sudeste;ZONA DA MATA;MANHUACU;-20.24;-41.983;True;6344;3244;3017;3306;1611;1658;3038;1633;1359
3154200;Resende Costa;MG;31;Sudeste;CAMPO DAS VERTENTES;SAO JOAO DEL REI;-20.922;-44.238;True;10537;5182;5355;8190;3917;4273;2347;1265;1082
3154309;Resplendor;MG;31;Sudeste;VALE DO RIO DOCE;AIMORES;-19.326;-41.255;True;17024;8283;8728;13123;6219;6897;3901;2064;1831
3154408;Ressaquinha;MG;31;Sudeste;CAMPO DAS VERTENTES;BARBACENA;-21.063;-43.763;True;4574;2254;2306;2894;1398;1496;1680;856;810
3154457;Riachinho;MG;31;Sudeste;NORTE DE MINAS;PIRAPORA;-16.23;-45.992;True;8126;4267;3857;4512;2259;2253;3614;2008;1604
3154507;Riacho dos Machados;MG;31;Sudeste;NORTE DE MINAS;JANAUBA;-16.006;-43.049;True;9392;4735;4642;3467;1664;1803;5925;3071;2839
3154606;Ribeirão das Neves;MG;31;Sudeste;METROPOLITANA DE BELO HORIZONTE;BELO HORIZONTE;-19.767;-44.087;True;329112;;;;;;;;
3154705;Ribeirão Vermelho;MG;31;Sudeste;CAMPO DAS VERTENTES;LAVRAS;-21.191;-45.062;True;3773;1802;1956;3489;1649;1840;284;153;116
3154804;Rio Acima;MG;31;Sudeste;METROPOLITANA DE BELO HORIZONTE;BELO HORIZONTE;-20.088;-43.789;True;8257;4041;4216;7108;3454;3654;1149;587;562
3154903;Rio Casca;MG;31;Sudeste;ZONA DA MATA;PONTE NOVA;-20.226;-42.651;True;14496;7087;7406;11406;5497;5908;3090;1590;1498
3155009;Rio Doce;MG;31;Sudeste;ZONA DA MATA;PONTE NOVA;-20.242;-42.907;True;2520;1264;1256;1661;818;843;859;446;413
3155108;Rio do Prado;MG;31;Sudeste;JEQUITINHONHA;ALMENARA;-16.608;-40.57;True;4489;2317;2172;2697;1345;1352;1792;972;820
3155207;Rio Espera;MG;31;Sudeste;ZONA DA MATA;VICOSA;-20.855;-43.474;True;6594;3367;3201;2365;1134;1231;4229;2233;1970
3155306;Rio Manso;MG;31;Sudeste;METROPOLITANA DE BELO HORIZONTE;ITAGUARA;-20.265;-44.308;True;5007;2639;2368;2486;1284;1202;2521;1355;1166
3155405;Rio Novo;MG;31;Sudeste;ZONA DA MATA;JUIZ DE FORA;-21.458;-43.125;True;8910;4520;4390;7756;3889;3867;1154;631;523
3155504;Rio Paranaíba;MG;31;Sudeste;TRIANGULO MINEIRO/ALTO PARANAIBA;PATOS DE MINAS;-19.194;-46.247;True;10809;5546;5254;6616;3286;3321;4193;2260;1933
3155603;Rio Pardo de Minas;MG;31;Sudeste;NORTE DE MINAS;SALINAS;-15.61;-42.54;True;28633;13998;13437;11209;5301;5556;17424;8697;7881
3155702;Rio Piracicaba;MG;31;Sudeste;METROPOLITANA DE BELO HORIZONTE;ITABIRA;-19.929;-43.174;True;14319;7023;7291;11401;5534;5862;2918;1489;1429
3155801;Rio Pomba;MG;31;Sudeste;ZONA DA MATA;UBA;-21.275;-43.179;True;16709;8322;8387;14011;6840;7171;2698;1482;1216
3155900;Rio Preto;MG;31;Sudeste;ZONA DA MATA;JUIZ DE FORA;-22.089;-43.828;True;5388;2734;2648;4487;2228;2257;901;506;391
3156007;Rio Vermelho;MG;31;Sudeste;METROPOLITANA DE BELO HORIZONTE;CONCEICAO DO MATO DENTRO;-18.294;-43.009;True;14856;7425;7386;5721;2660;3024;9135;4765;4362
3156106;Ritápolis;MG;31;Sudeste;CAMPO DAS VERTENTES;SAO JOAO DEL REI;-21.022;-44.318;True;5068;2474;2547;3344;1589;1755;1724;885;792
3156205;Rochedo de Minas;MG;31;Sudeste;ZONA DA MATA;JUIZ DE FORA;-21.63;-43.02;True;2036;1022;1005;1820;907;913;216;115;92
3156304;Rodeiro;MG;31;Sudeste;ZONA DA MATA;UBA;-21.2;-42.865;True;6178;3189;2989;5076;2610;2466;1102;579;523
3156403;Romaria;MG;31;Sudeste;TRIANGULO MINEIRO/ALTO PARANAIBA;PATROCINIO;-18.883;-47.586;True;3561;1876;1681;2717;1425;1292;844;451;389
3156452;Rosário da Limeira;MG;31;Sudeste;ZONA DA MATA;MURIAE;-20.979;-42.512;True;4151;2131;1988;1836;921;915;2315;1210;1073
3156502;Rubelita;MG;31;Sudeste;NORTE DE MINAS;SALINAS;-16.408;-42.263;True;8299;4273;4014;2523;1233;1290;5776;3040;2724
3156601;Rubim;MG;31;Sudeste;JEQUITINHONHA;ALMENARA;-16.375;-40.538;True;9561;4763;4647;7664;3721;3807;1897;1042;840
3156700;Sabará;MG;31;Sudeste;METROPOLITANA DE BELO HORIZONTE;BELO HORIZONTE;-19.886;-43.807;True;120770;58395;62328;117498;56563;60901;3272;1832;1427
3156809;Sabinópolis;MG;31;Sudeste;VALE DO RIO DOCE;GUANHAES;-18.666;-43.084;True;15889;7882;7970;10084;4851;5222;5805;3031;2748
3156908;Sacramento;MG;31;Sudeste;TRIANGULO MINEIRO/ALTO PARANAIBA;ARAXA;-19.865;-47.44;True;22159;11032;10903;17480;8490;8890;4679;2542;2013
3157005;Salinas;MG;31;Sudeste;NORTE DE MINAS;SALINAS;-16.17;-42.29;True;37370;18412;18810;28310;13657;14579;9060;4755;4231
3157104;Salto da Divisa;MG;31;Sudeste;JEQUITINHONHA;ALMENARA;-16.003;-39.947;True;6896;3549;3314;5653;2842;2811;1243;707;503
3157203;Santa Bárbara;MG;31;Sudeste;METROPOLITANA DE BELO HORIZONTE;ITABIRA;-19.959;-43.415;True;26185;12485;12812;23478;11139;11572;2707;1346;1240
3157252;Santa Bárbara do Leste;MG;31;Sudeste;VALE DO RIO DOCE;CARATINGA;-19.978;-42.14;True;7451;3789;3649;3907;1948;1954;3544;1841;1695
3157278;Santa Bárbara do Monte Verde;MG;31;Sudeste;ZONA DA MATA;JUIZ DE FORA;-21.959;-43.702;True;2796;1454;1342;1529;752;777;1267;702;565
3157302;Santa Bárbara do Tugúrio;MG;31;Sudeste;CAMPO DAS VERTENTES;BARBACENA;-21.246;-43.559;True;4504;2333;2171;2047;1016;1031;2457;1317;1140
3157336;Santa Cruz de Minas;MG;31;Sudeste;CAMPO DAS VERTENTES;SAO JOAO DEL REI;-21.12;-44.223;True;7347;3583;3752;7347;3583;3752;;;
3157377;Santa Cruz de Salinas;MG;31;Sudeste;NORTE DE MINAS;SALINAS;-16.098;-41.746;True;5192;2572;2460;1242;580;583;3950;1992;1877
3157401;Santa Cruz do Escalvado;MG;31;Sudeste;ZONA DA MATA;PONTE NOVA;-20.236;-42.814;True;5193;2629;2563;1662;828;834;3531;1801;1729
3157500;Santa Efigênia de Minas;MG;31;Sudeste;VALE DO RIO DOCE;GUANHAES;-18.827;-42.448;True;4519;2187;2322;2817;1326;1481;1702;861;841
3157609;Santa Fé de Minas;MG;31;Sudeste;NORTE DE MINAS;PIRAPORA;-16.69;-45.414;True;4034;2098;1849;1994;972;1022;2040;1126;827
3157658;Santa Helena de Minas;MG;31;Sudeste;VALE DO MUCURI;NANUQUE;-16.983;-40.686;True;5892;3015;2866;3305;1666;1639;2587;1349;1227
3157708;Santa Juliana;MG;31;Sudeste;TRIANGULO MINEIRO/ALTO PARANAIBA;ARAXA;-19.309;-47.525;True;10582;5555;4982;8825;4589;4191;1757;966;791
3157807;Santa Luzia;MG;31;Sudeste;METROPOLITANA DE BELO HORIZONTE;BELO HORIZONTE;-19.77;-43.851;True;222507;;;;;;;;
3157906;Santa Margarida;MG;31;Sudeste;ZONA DA MATA;MANHUACU;-20.384;-42.251;True;14205;7176;6913;6805;3375;3424;7400;3801;3489
3158003;Santa Maria de Itabira;MG;31;Sudeste;METROPOLITANA DE BELO HORIZONTE;ITABIRA;-19.449;-43.113;True;10445;5233;5198;6069;2955;3114;4376;2278;2084
3158102;Santa Maria do Salto;MG;31;Sudeste;JEQUITINHONHA;ALMENARA;-16.249;-40.149;True;5724;2955;2711;4009;2002;1981;1715;953;730
3158201;Santa Maria do Suaçuí;MG;31;Sudeste;VALE DO RIO DOCE;PECANHA;-18.19;-42.414;True;14427;7166;7177;10385;5009;5320;4042;2157;1857
3158300;Santana da Vargem;MG;31;Sudeste;SUL/SUDOESTE DE MINAS;VARGINHA;-21.249;-45.507;True;7092;3616;3466;4947;2498;2447;2145;1118;1019
3158409;Santana de Cataguases;MG;31;Sudeste;ZONA DA MATA;CATAGUASES;-21.287;-42.557;True;3603;1854;1749;2724;1360;1364;879;494;385
3158508;Santana de Pirapama;MG;31;Sudeste;METROPOLITANA DE BELO HORIZONTE;SETE LAGOAS;-19.006;-44.043;True;8549;4482;4067;3220;1573;1647;5329;2909;2420
3158607;Santana do Deserto;MG;31;Sudeste;ZONA DA MATA;JUIZ DE FORA;-21.95;-43.166;True;3833;1961;1869;1357;662;695;2476;1299;1174
3158706;Santana do Garambéu;MG;31;Sudeste;CAMPO DAS VERTENTES;SAO JOAO DEL REI;-21.601;-44.104;True;2104;1112;992;1476;759;717;628;353;275
3158805;Santana do Jacaré;MG;31;Sudeste;OESTE DE MINAS;CAMPO BELO;-20.898;-45.131;True;4532;2299;2230;4374;2211;2160;158;88;70
3158904;Santana do Manhuaçu;MG;31;Sudeste;ZONA DA MATA;MANHUACU;-20.108;-41.925;True;8185;4169;3971;4090;2019;2061;4095;2150;1910
3158953;Santana do Paraíso;MG;31;Sudeste;VALE DO RIO DOCE;IPATINGA;-19.364;-42.569;True;22765;11037;11196;21453;10363;10578;1312;674;618
3159001;Santana do Riacho;MG;31;Sudeste;METROPOLITANA DE BELO HORIZONTE;SETE LAGOAS;-19.169;-43.714;True;4159;2073;2023;2170;1067;1103;1989;1006;920
3159100;Santana dos Montes;MG;31;Sudeste;METROPOLITANA DE BELO HORIZONTE;CONSELHEIRO LAFAIETE;-20.788;-43.692;True;3989;2065;1921;2259;1132;1127;1730;933;794
3159209;Santa Rita de Caldas;MG;31;Sudeste;SUL/SUDOESTE DE MINAS;POCOS DE CALDAS;-22.029;-46.337;True;9078;4632;4383;5570;2759;2811;3508;1873;1572
3159308;Santa Rita de Jacutinga;MG;31;Sudeste;ZONA DA MATA;JUIZ DE FORA;-22.149;-44.095;True;5588;2856;2720;4067;1998;2069;1521;858;651
3159357;Santa Rita de Minas;MG;31;Sudeste;VALE DO RIO DOCE;CARATINGA;-19.875;-42.132;True;5787;2836;2873;4146;1981;2099;1641;855;774
3159407;Santa Rita de Ibitipoca;MG;31;Sudeste;ZONA DA MATA;JUIZ DE FORA;-21.563;-43.915;True;3747;1920;1826;2259;1133;1126;1488;787;700
3159506;Santa Rita do Itueto;MG;31;Sudeste;VALE DO RIO DOCE;AIMORES;-19.36;-41.38;True;5652;2873;2770;2332;1141;1186;3320;1732;1584
3159605;Santa Rita do Sapucaí;MG;31;Sudeste;SUL/SUDOESTE DE MINAS;SANTA RITA DO SAPUCAI;-22.252;-45.703;True;34246;16996;17243;29031;14187;14837;5215;2809;2406
3159704;Santa Rosa da Serra;MG;31;Sudeste;TRIANGULO MINEIRO/ALTO PARANAIBA;PATOS DE MINAS;-19.53;-45.966;True;3261;1716;1542;2049;1056;993;1212;660;549
3159803;Santa Vitória;MG;31;Sudeste;TRIANGULO MINEIRO/ALTO PARANAIBA;ITUIUTABA;-18.839;-50.121;True;15492;7896;7542;12461;6244;6185;3031;1652;1357
3159902;Santo Antônio do Amparo;MG;31;Sudeste;OESTE DE MINAS;OLIVEIRA;-20.946;-44.919;True;17255;8533;8703;15262;7466;7796;1993;1067;907
3160009;Santo Antônio do Aventureiro;MG;31;Sudeste;ZONA DA MATA;CATAGUASES;-21.758;-42.816;True;3489;1775;1708;2284;1145;1136;1205;630;572
3160108;Santo Antônio do Grama;MG;31;Sudeste;ZONA DA MATA;PONTE NOVA;-20.314;-42.609;True;4241;2117;2121;3376;1662;1714;865;455;407
3160207;Santo Antônio do Itambé;MG;31;Sudeste;METROPOLITANA DE BELO HORIZONTE;CONCEICAO DO MATO DENTRO;-18.466;-43.307;True;4517;2291;2226;1215;588;627;3302;1703;1599
3160306;Santo Antônio do Jacinto;MG;31;Sudeste;JEQUITINHONHA;ALMENARA;-16.534;-40.176;True;11294;5701;5362;6220;3047;3105;5074;2654;2257
3160405;Santo Antônio do Monte;MG;31;Sudeste;OESTE DE MINAS;DIVINOPOLIS;-20.087;-45.294;True;24746;12541;12205;20954;10435;10519;3792;2106;1686
3160454;Santo Antônio do Retiro;MG;31;Sudeste;NORTE DE MINAS;SALINAS;-15.339;-42.624;True;6817;3441;3376;1572;758;814;5245;2683;2562
3160504;Santo Antônio do Rio Abaixo;MG;31;Sudeste;METROPOLITANA DE BELO HORIZONTE;CONCEICAO DO MATO DENTRO;-19.228;-43.254;True;1753;870;883;860;411;449;893;459;434
3160603;Santo Hipólito;MG;31;Sudeste;CENTRAL MINEIRA;CURVELO;-18.297;-44.223;True;3541;1790;1751;2262;1104;1158;1279;686;593
3160702;Santos Dumont;MG;31;Sudeste;ZONA DA MATA;JUIZ DE FORA;-21.457;-43.553;True;45922;22200;23635;39927;19060;20842;5995;3140;2793
3160801;São Bento Abade;MG;31;Sudeste;SUL/SUDOESTE DE MINAS;VARGINHA;-21.582;-45.076;True;4400;2279;2059;4117;2139;1933;283;140;126
3160900;São Brás do Suaçuí;MG;31;Sudeste;METROPOLITANA DE BELO HORIZONTE;CONSELHEIRO LAFAIETE;-20.625;-43.949;True;3488;1716;1748;2973;1457;1516;515;259;232
3160959;São Domingos das Dores;MG;31;Sudeste;VALE DO RIO DOCE;CARATINGA;-19.527;-42.011;True;5232;2634;2580;2543;1258;1279;2689;1376;1301
3161007;São Domingos do Prata;MG;31;Sudeste;METROPOLITANA DE BELO HORIZONTE;ITABIRA;-19.865;-42.968;True;17349;8444;8841;10176;4814;5328;7173;3630;3513
3161056;São Félix de Minas;MG;31;Sudeste;VALE DO RIO DOCE;MANTENA;-18.591;-41.486;True;3387;1726;1644;1839;895;944;1548;831;700
3161106;São Francisco;MG;31;Sudeste;NORTE DE MINAS;JANUARIA;-15.949;-44.864;True;52985;27067;25849;30279;14877;15399;22706;12190;10450
3161205;São Francisco de Paula;MG;31;Sudeste;OESTE DE MINAS;OLIVEIRA;-20.71;-44.985;True;6246;3168;3078;4293;2135;2158;1953;1033;920
3161304;São Francisco de Sales;MG;31;Sudeste;TRIANGULO MINEIRO/ALTO PARANAIBA;FRUTAL;-19.863;-49.774;True;5167;2670;2481;3926;1990;1920;1241;680;561
3161403;São Francisco do Glória;MG;31;Sudeste;ZONA DA MATA;MURIAE;-20.789;-42.268;True;5539;2843;2650;3118;1544;1548;2421;1299;1102
3161502;São Geraldo;MG;31;Sudeste;ZONA DA MATA;UBA;-20.923;-42.834;True;9171;4308;4209;6378;3007;3080;2793;1301;1129
3161601;São Geraldo da Piedade;MG;31;Sudeste;VALE DO RIO DOCE;GOVERNADOR VALADARES;-18.836;-42.288;True;4768;2262;2506;1107;496;611;3661;1766;1895
3161650;São Geraldo do Baixio;MG;31;Sudeste;VALE DO RIO DOCE;GOVERNADOR VALADARES;-18.9;-41.36;True;3253;1596;1648;2191;1045;1140;1062;551;508
3161700;São Gonçalo do Abaeté;MG;31;Sudeste;NOROESTE DE MINAS;PARACATU;-18.338;-45.833;True;6156;3260;2875;4100;2107;1993;2056;1153;882
3161809;São Gonçalo do Pará;MG;31;Sudeste;OESTE DE MINAS;DIVINOPOLIS;-19.983;-44.859;True;10308;5254;5042;7852;3935;3905;2456;1319;1137
3161908;São Gonçalo do Rio Abaixo;MG;31;Sudeste;METROPOLITANA DE BELO HORIZONTE;ITABIRA;-19.826;-43.362;True;9233;4567;4572;4279;2147;2115;4954;2420;2457
3162005;São Gonçalo do Sapucaí;MG;31;Sudeste;SUL/SUDOESTE DE MINAS;SANTA RITA DO SAPUCAI;-21.892;-45.595;True;22751;11398;11353;18578;9171;9407;4173;2227;1946
3162104;São Gotardo;MG;31;Sudeste;TRIANGULO MINEIRO/ALTO PARANAIBA;PATOS DE MINAS;-19.311;-46.049;True;30757;15563;15164;28849;14499;14337;1908;1064;827
3162203;São João Batista do Glória;MG;31;Sudeste;SUL/SUDOESTE DE MINAS;PASSOS;-20.641;-46.506;True;6828;3542;3271;5775;2971;2804;1053;571;467
3162252;São João da Lagoa;MG;31;Sudeste;NORTE DE MINAS;MONTES CLAROS;-16.853;-44.352;True;4729;2509;2219;2371;1173;1198;2358;1336;1021
3162302;São João da Mata;MG;31;Sudeste;SUL/SUDOESTE DE MINAS;SANTA RITA DO SAPUCAI;-21.93;-45.929;True;2858;1474;1384;1713;858;855;1145;616;529
3162401;São João da Ponte;MG;31;Sudeste;NORTE DE MINAS;MONTES CLAROS;-15.929;-44.008;True;26091;13354;12253;8366;4152;4030;17725;9202;8223
3162450;São João das MissõEs;MG;31;Sudeste;NORTE DE MINAS;JANUARIA;-14.884;-44.091;True;10769;5613;5151;2133;1080;1053;8636;4533;4098
3162500;São João Del Rei;MG;31;Sudeste;CAMPO DAS VERTENTES;SAO JOAO DEL REI;-21.136;-44.262;True;81918;39330;42213;76978;36620;40026;4940;2710;2187
3162559;São João do Manhuaçu;MG;31;Sudeste;ZONA DA MATA;MANHUACU;-20.394;-42.151;True;9394;4779;4597;4352;2151;2189;5042;2628;2408
3162575;São João do Manteninha;MG;31;Sudeste;VALE DO RIO DOCE;MANTENA;-18.721;-41.16;True;4855;2400;2453;2293;1122;1171;2562;1278;1282
3162609;São João do Oriente;MG;31;Sudeste;VALE DO RIO DOCE;CARATINGA;-19.339;-42.158;True;7988;3945;4040;6277;3048;3229;1711;897;811
3162658;São João do Pacuí;MG;31;Sudeste;NORTE DE MINAS;MONTES CLAROS;-16.542;-44.516;True;4003;2087;1875;1655;814;832;2348;1273;1043
3162708;São João do Paraíso;MG;31;Sudeste;NORTE DE MINAS;SALINAS;-15.314;-42.014;True;21839;10846;10827;9614;4639;4885;12225;6207;5942
3162807;São João Evangelista;MG;31;Sudeste;VALE DO RIO DOCE;GUANHAES;-18.548;-42.763;True;15686;7699;7920;9901;4759;5142;5785;2940;2778
3162906;São João Nepomuceno;MG;31;Sudeste;ZONA DA MATA;JUIZ DE FORA;-21.54;-43.011;True;25011;12078;12794;23593;11317;12217;1418;761;577
3162922;São Joaquim de Bicas;MG;31;Sudeste;METROPOLITANA DE BELO HORIZONTE;BELO HORIZONTE;-20.049;-44.274;True;22214;11646;10242;16212;7904;8053;6002;3742;2189
3162948;São José da Barra;MG;31;Sudeste;SUL/SUDOESTE DE MINAS;PASSOS;-20.718;-46.311;True;6701;3476;3198;4888;2494;2374;1813;982;824
3162955;São José da Lapa;MG;31;Sudeste;METROPOLITANA DE BELO HORIZONTE;BELO HORIZONTE;-19.701;-43.955;True;17900;8809;8976;10349;5032;5265;7551;3777;3711
3163003;São José da Safira;MG;31;Sudeste;VALE DO RIO DOCE;GOVERNADOR VALADARES;-18.324;-42.143;True;3929;1928;1991;2742;1310;1432;1187;618;559
3163102;São José da Varginha;MG;31;Sudeste;METROPOLITANA DE BELO HORIZONTE;PARA DE MINAS;-19.71;-44.557;True;3797;1954;1843;2071;1027;1044;1726;927;799
3163201;São José do Alegre;MG;31;Sudeste;SUL/SUDOESTE DE MINAS;SANTA RITA DO SAPUCAI;-22.329;-45.526;True;3908;1970;1938;2724;1353;1371;1184;617;567
3163300;São José do Divino;MG;31;Sudeste;VALE DO RIO DOCE;GOVERNADOR VALADARES;-18.479;-41.389;True;3776;1830;1946;2653;1236;1417;1123;594;529
3163409;São José do Goiabal;MG;31;Sudeste;METROPOLITANA DE BELO HORIZONTE;ITABIRA;-19.929;-42.705;True;5646;2739;2899;3538;1674;1856;2108;1065;1043
3163508;São José do Jacuri;MG;31;Sudeste;VALE DO RIO DOCE;PECANHA;-18.275;-42.67;True;6958;3561;3393;2080;999;1081;4878;2562;2312
3163607;São José do Mantimento;MG;31;Sudeste;ZONA DA MATA;MANHUACU;-20.005;-41.745;True;2472;1257;1206;1454;734;715;1018;523;491
3163706;São Lourenço;MG;31;Sudeste;SUL/SUDOESTE DE MINAS;SAO LOURENCO;-22.116;-45.054;True;40441;19348;21093;40441;19348;21093;;;
3163805;São Miguel do Anta;MG;31;Sudeste;ZONA DA MATA;VICOSA;-20.707;-42.719;True;6820;3476;3270;3726;1853;1862;3094;1623;1408
3163904;São Pedro da União;MG;31;Sudeste;SUL/SUDOESTE DE MINAS;SAO SEBASTIAO DO PARAISO;-21.127;-46.615;True;5291;2736;2481;2778;1413;1360;2513;1323;1121
3164001;São Pedro dos Ferros;MG;31;Sudeste;ZONA DA MATA;PONTE NOVA;-20.17;-42.524;True;8880;4379;4501;7256;3539;3717;1624;840;784
3164100;São Pedro do Suaçuí;MG;31;Sudeste;VALE DO RIO DOCE;PECANHA;-18.366;-42.603;True;5801;2859;2942;2310;1093;1217;3491;1766;1725
3164209;São Romão;MG;31;Sudeste;NORTE DE MINAS;PIRAPORA;-16.369;-45.069;True;9080;4443;4324;6704;3175;3298;2376;1268;1026
3164308;São Roque de Minas;MG;31;Sudeste;OESTE DE MINAS;PIUI;-20.245;-46.366;True;6141;3141;2987;4042;1990;2052;2099;1151;935
3164407;São Sebastião da Bela Vista;MG;31;Sudeste;SUL/SUDOESTE DE MINAS;SANTA RITA DO SAPUCAI;-22.159;-45.754;True;4884;2583;2295;2563;1317;1246;2321;1266;1049
3164431;São Sebastião da Vargem Alegre;MG;31;Sudeste;ZONA DA MATA;MURIAE;-21.072;-42.636;True;2743;1432;1311;1501;768;733;1242;664;578
3164472;São Sebastião do Anta;MG;31;Sudeste;VALE DO RIO DOCE;CARATINGA;-19.498;-41.984;True;5388;2743;2645;3318;1652;1666;2070;1091;979
3164506;São Sebastião do Maranhão;MG;31;Sudeste;VALE DO RIO DOCE;PECANHA;-18.084;-42.571;True;11686;6053;5620;3403;1625;1778;8283;4428;3842
3164605;São Sebastião do Oeste;MG;31;Sudeste;OESTE DE MINAS;DIVINOPOLIS;-20.276;-45.005;True;5336;2769;2567;2508;1249;1259;2828;1520;1308
3164704;São Sebastião do Paraíso;MG;31;Sudeste;SUL/SUDOESTE DE MINAS;SAO SEBASTIAO DO PARAISO;-20.917;-46.991;True;61838;30413;31291;56659;27562;29004;5179;2851;2287
3164803;São Sebastião do Rio Preto;MG;31;Sudeste;METROPOLITANA DE BELO HORIZONTE;CONCEICAO DO MATO DENTRO;-19.292;-43.174;True;1700;795;842;823;375;437;877;420;405
3164902;São Sebastião do Rio Verde;MG;31;Sudeste;SUL/SUDOESTE DE MINAS;SAO LOURENCO;-22.218;-44.976;True;2170;1093;1077;1267;619;648;903;474;429
3165008;São Tiago;MG;31;Sudeste;CAMPO DAS VERTENTES;SAO JOAO DEL REI;-20.913;-44.509;True;10289;5145;5120;7990;3917;4073;2299;1228;1047
3165107;São Tomás de Aquino;MG;31;Sudeste;SUL/SUDOESTE DE MINAS;SAO SEBASTIAO DO PARAISO;-20.784;-47.098;True;6934;3475;3454;5444;2707;2737;1490;768;717
3165206;São Thomé das Letras;MG;31;Sudeste;SUL/SUDOESTE DE MINAS;VARGINHA;-21.722;-44.985;True;6617;3529;3082;3471;1807;1662;3146;1722;1420
3165305;São Vicente de Minas;MG;31;Sudeste;SUL/SUDOESTE DE MINAS;ANDRELANDIA;-21.713;-44.444;True;6283;3039;3244;5299;2558;2741;984;481;503
3165404;Sapucaí-Mirim;MG;31;Sudeste;SUL/SUDOESTE DE MINAS;POUSO ALEGRE;-22.748;-45.743;True;5772;3000;2772;3543;1807;1736;2229;1193;1036
3165503;Sardoá;MG;31;Sudeste;VALE DO RIO DOCE;GUANHAES;-18.784;-42.365;True;5196;2501;2647;1745;806;924;3451;1695;1723
3165537;Sarzedo;MG;31;Sudeste;METROPOLITANA DE BELO HORIZONTE;BELO HORIZONTE;-20.035;-44.145;True;23282;11429;11472;19043;9375;9446;4239;2054;2026
3165552;Setubinha;MG;31;Sudeste;VALE DO MUCURI;TEOFILO OTONI;-17.6;-42.159;True;10834;5310;5385;2465;1177;1285;8369;4133;4100
3165560;Sem-Peixe;MG;31;Sudeste;ZONA DA MATA;PONTE NOVA;-20.109;-42.839;True;2950;1458;1492;1241;591;650;1709;867;842
3165578;Senador Amaral;MG;31;Sudeste;SUL/SUDOESTE DE MINAS;POUSO ALEGRE;-22.587;-46.177;True;5051;2664;2385;2986;1526;1458;2065;1138;927
3165602;Senador Cortes;MG;31;Sudeste;ZONA DA MATA;JUIZ DE FORA;-21.801;-42.946;True;2011;1004;1007;1274;619;655;737;385;352
3165701;Senador Firmino;MG;31;Sudeste;ZONA DA MATA;UBA;-20.912;-43.097;True;7019;3535;3478;4578;2227;2351;2441;1308;1127
3165800;Senador José Bento;MG;31;Sudeste;SUL/SUDOESTE DE MINAS;POUSO ALEGRE;-22.164;-46.179;True;1908;1015;893;684;341;343;1224;674;550
3165909;Senador Modestino Gonçalves;MG;31;Sudeste;JEQUITINHONHA;DIAMANTINA;-17.947;-43.225;True;4988;2560;2418;1839;897;942;3149;1663;1476
3166006;Senhora de Oliveira;MG;31;Sudeste;ZONA DA MATA;VICOSA;-20.794;-43.344;True;5675;2839;2836;3092;1522;1570;2583;1317;1266
3166105;Senhora do Porto;MG;31;Sudeste;VALE DO RIO DOCE;GUANHAES;-18.892;-43.084;True;3517;1766;1735;1494;712;782;2023;1054;953
3166204;Senhora dos Remédios;MG;31;Sudeste;CAMPO DAS VERTENTES;BARBACENA;-21.028;-43.583;True;10201;5184;4985;3458;1676;1773;6743;3508;3212
3166303;Sericita;MG;31;Sudeste;ZONA DA MATA;PONTE NOVA;-20.474;-42.482;True;7083;3628;3428;3081;1551;1515;4002;2077;1913
3166402;Seritinga;MG;31;Sudeste;SUL/SUDOESTE DE MINAS;ANDRELANDIA;-21.909;-44.519;True;1755;902;853;1407;699;708;348;203;145
3166501;Serra Azul de Minas;MG;31;Sudeste;METROPOLITANA DE BELO HORIZONTE;CONCEICAO DO MATO DENTRO;-18.362;-43.17;True;4307;2180;2125;1731;833;896;2576;1347;1229
3166600;Serra da Saudade;MG;31;Sudeste;CENTRAL MINEIRA;BOM DESPACHO;-19.438;-45.796;True;863;457;406;558;287;271;305;170;135
3166709;Serra dos Aimorés;MG;31;Sudeste;VALE DO MUCURI;NANUQUE;-17.783;-40.248;True;8345;4168;4175;6847;3378;3467;1498;790;708
3166808;Serra do Salitre;MG;31;Sudeste;TRIANGULO MINEIRO/ALTO PARANAIBA;PATROCINIO;-19.111;-46.69;True;10224;5280;4926;7527;3778;3744;2697;1502;1182
3166907;Serrania;MG;31;Sudeste;SUL/SUDOESTE DE MINAS;ALFENAS;-21.548;-46.04;True;7370;3816;3554;6320;3226;3094;1050;590;460
3166956;Serranópolis de Minas;MG;31;Sudeste;NORTE DE MINAS;JANAUBA;-15.829;-42.871;True;4515;2148;2137;1737;838;899;2778;1310;1238
3167004;Serranos;MG;31;Sudeste;SUL/SUDOESTE DE MINAS;ANDRELANDIA;-21.89;-44.51;True;2063;1031;1032;1577;786;791;486;245;241
3167103;Serro;MG;31;Sudeste;METROPOLITANA DE BELO HORIZONTE;CONCEICAO DO MATO DENTRO;-18.605;-43.379;True;20862;10431;10413;12400;6028;6364;8462;4403;4049
3167202;Sete Lagoas;MG;31;Sudeste;METROPOLITANA DE BELO HORIZONTE;SETE LAGOAS;-19.466;-44.247;True;217506;;;;;;;;
3167301;Silveirânia;MG;31;Sudeste;ZONA DA MATA;UBA;-21.159;-43.215;True;2125;1116;1009;1385;698;687;740;418;322
3167400;Silvianópolis;MG;31;Sudeste;SUL/SUDOESTE DE MINAS;SANTA RITA DO SAPUCAI;-22.029;-45.835;True;6018;3122;2883;3408;1695;1713;2610;1427;1170
3167509;Simão Pereira;MG;31;Sudeste;ZONA DA MATA;JUIZ DE FORA;-21.964;-43.312;True;2503;1226;1246;1455;701;748;1048;525;498
3167608;Simonésia;MG;31;Sudeste;ZONA DA MATA;MANHUACU;-20.124;-42.001;True;17257;8852;8201;6839;3394;3421;10418;5458;4780
3167707;Sobrália;MG;31;Sudeste;VALE DO RIO DOCE;GOVERNADOR VALADARES;-19.235;-42.098;True;5990;2906;3068;4154;1964;2190;1836;942;878
3167806;Soledade de Minas;MG;31;Sudeste;SUL/SUDOESTE DE MINAS;SAO LOURENCO;-22.06;-45.045;True;5518;2786;2732;3517;1694;1823;2001;1092;909
3167905;Tabuleiro;MG;31;Sudeste;ZONA DA MATA;UBA;-21.359;-43.248;True;4061;2021;2026;2601;1268;1333;1460;753;693
3168002;Taiobeiras;MG;31;Sudeste;NORTE DE MINAS;SALINAS;-15.808;-42.233;True;29732;14526;15206;23983;11562;12421;5749;2964;2785
3168051;Taparuba;MG;31;Sudeste;VALE DO RIO DOCE;AIMORES;-19.759;-41.616;True;3243;1688;1555;1498;754;744;1745;934;811
3168101;Tapira;MG;31;Sudeste;TRIANGULO MINEIRO/ALTO PARANAIBA;ARAXA;-19.922;-46.823;True;3575;1828;1676;2421;1221;1198;1154;607;478
3168200;Tapiraí;MG;31;Sudeste;OESTE DE MINAS;PIUI;-19.888;-46.02;True;1841;982;851;1092;567;525;749;415;326
3168309;Taquaraçu de Minas;MG;31;Sudeste;METROPOLITANA DE BELO HORIZONTE;ITABIRA;-19.67;-43.687;True;3757;2018;1706;1613;834;779;2144;1184;927
3168408;Tarumirim;MG;31;Sudeste;VALE DO RIO DOCE;CARATINGA;-19.281;-42.007;True;14185;6903;7269;7778;3655;4114;6407;3248;3155
3168507;Teixeiras;MG;31;Sudeste;ZONA DA MATA;VICOSA;-20.651;-42.857;True;11665;5683;5827;7558;3565;3916;4107;2118;1911
3168606;Teófilo Otoni;MG;31;Sudeste;VALE DO MUCURI;TEOFILO OTONI;-17.858;-41.505;True;126895;60392;66195;102474;47746;54497;24421;12646;11698
3168705;Timóteo;MG;31;Sudeste;VALE DO RIO DOCE;IPATINGA;-19.583;-42.644;True;76092;36652;39254;75994;36598;39210;98;54;44
3168804;Tiradentes;MG;31;Sudeste;CAMPO DAS VERTENTES;SAO JOAO DEL REI;-21.11;-44.178;True;6547;3191;3295;4964;2431;2516;1583;760;779
3168903;Tiros;MG;31;Sudeste;TRIANGULO MINEIRO/ALTO PARANAIBA;PATOS DE MINAS;-19.004;-45.964;True;7416;3721;3517;5041;2419;2577;2375;1302;940
3169000;Tocantins;MG;31;Sudeste;ZONA DA MATA;UBA;-21.175;-43.018;True;15704;7882;7807;12464;6125;6337;3240;1757;1470
3169059;Tocos do Moji;MG;31;Sudeste;SUL/SUDOESTE DE MINAS;POUSO ALEGRE;-22.371;-46.096;True;3926;2129;1789;940;489;451;2986;1640;1338
3169109;Toledo;MG;31;Sudeste;SUL/SUDOESTE DE MINAS;POUSO ALEGRE;-22.743;-46.372;True;5720;2996;2615;2285;1184;1075;3435;1812;1540
3169208;Tombos;MG;31;Sudeste;ZONA DA MATA;MURIAE;-20.905;-42.023;True;9194;4560;4630;7283;3540;3739;1911;1020;891
3169307;Três CoraçõEs;MG;31;Sudeste;SUL/SUDOESTE DE MINAS;VARGINHA;-21.697;-45.253;True;71737;35587;35948;64895;31826;32958;6842;3761;2990
3169356;Três Marias;MG;31;Sudeste;CENTRAL MINEIRA;TRES MARIAS;-18.206;-45.242;True;26431;13202;12954;24636;12212;12369;1795;990;585
3169406;Três Pontas;MG;31;Sudeste;SUL/SUDOESTE DE MINAS;VARGINHA;-21.367;-45.513;True;52121;25884;26229;43966;21590;22376;8155;4294;3853
3169505;Tumiritinga;MG;31;Sudeste;VALE DO RIO DOCE;GOVERNADOR VALADARES;-18.979;-41.645;True;5964;2986;2978;4009;1936;2073;1955;1050;905
3169604;Tupaciguara;MG;31;Sudeste;TRIANGULO MINEIRO/ALTO PARANAIBA;UBERLANDIA;-18.593;-48.705;True;23076;11429;11440;20759;10244;10482;2317;1185;958
3169703;Turmalina;MG;31;Sudeste;JEQUITINHONHA;CAPELINHA;-17.286;-42.73;True;17219;8726;8477;11851;5902;5941;5368;2824;2536
3169802;Turvolândia;MG;31;Sudeste;SUL/SUDOESTE DE MINAS;SANTA RITA DO SAPUCAI;-21.876;-45.787;True;4737;2213;2068;2746;1252;1260;1991;961;808
3169901;Ubá;MG;31;Sudeste;ZONA DA MATA;UBA;-21.12;-42.943;True;94228;46514;47634;85858;42153;43677;8370;4361;3957
3170008;Ubaí;MG;31;Sudeste;NORTE DE MINAS;MONTES CLAROS;-16.285;-44.778;True;11834;6128;5700;5675;2863;2812;6159;3265;2888
3170057;Ubaporanga;MG;31;Sudeste;VALE DO RIO DOCE;CARATINGA;-19.635;-42.106;True;12060;6116;5933;6103;3022;3079;5957;3094;2854
3170107;Uberaba;MG;31;Sudeste;TRIANGULO MINEIRO/ALTO PARANAIBA;UBERABA;-19.748;-47.932;True;287760;;;;;;;;
3170206;Uberlândia;MG;31;Sudeste;TRIANGULO MINEIRO/ALTO PARANAIBA;UBERLANDIA;-18.919;-48.277;True;608369;;;;;;;;
3170305;Umburatiba;MG;31;Sudeste;VALE DO MUCURI;NANUQUE;-17.256;-40.573;True;2776;1374;1271;1591;798;763;1185;576;508
3170404;Unaí;MG;31;Sudeste;NOROESTE DE MINAS;UNAI;-16.358;-46.906;True;74495;37809;36291;58677;28891;29508;15818;8918;6783
3170438;União de Minas;MG;31;Sudeste;TRIANGULO MINEIRO/ALTO PARANAIBA;FRUTAL;-19.53;-50.336;True;4593;2570;2016;2643;1471;1172;1950;1099;844
3170479;Uruana de Minas;MG;31;Sudeste;NOROESTE DE MINAS;UNAI;-16.064;-46.254;True;2777;1397;1358;1649;801;848;1128;596;510
3170503;Urucânia;MG;31;Sudeste;ZONA DA MATA;PONTE NOVA;-20.351;-42.739;True;10203;5069;5134;7557;3677;3880;2646;1392;1254
3170529;Urucuia;MG;31;Sudeste;NORTE DE MINAS;JANUARIA;-16.133;-45.742;True;11376;6097;5279;5942;3063;2879;5434;3034;2400
3170578;Vargem Alegre;MG;31;Sudeste;VALE DO RIO DOCE;CARATINGA;-19.608;-42.298;True;6594;3303;3282;4818;2352;2466;1776;951;816
3170602;Vargem Bonita;MG;31;Sudeste;OESTE DE MINAS;PIUI;-20.327;-46.366;True;2098;1119;977;1093;565;528;1005;554;449
3170651;Vargem Grande do Rio Pardo;MG;31;Sudeste;NORTE DE MINAS;SALINAS;-15.403;-42.308;True;4703;2407;2292;2254;1126;1128;2449;1281;1164
3170701;Varginha;MG;31;Sudeste;SUL/SUDOESTE DE MINAS;VARGINHA;-21.551;-45.43;True;116093;56579;59184;112321;54626;57399;3772;1953;1785
3170750;Varjão de Minas;MG;31;Sudeste;NOROESTE DE MINAS;PARACATU;-18.378;-46.032;True;5993;3149;2816;4871;2537;2328;1122;612;488
3170800;Várzea da Palma;MG;31;Sudeste;NORTE DE MINAS;PIRAPORA;-17.598;-44.731;True;34448;17131;16770;30125;14865;14870;4323;2266;1900
3170909;Varzelândia;MG;31;Sudeste;NORTE DE MINAS;MONTES CLAROS;-15.701;-44.028;True;19137;9525;9104;9259;4493;4443;9878;5032;4661
3171006;Vazante;MG;31;Sudeste;NOROESTE DE MINAS;PARACATU;-17.987;-46.908;True;19300;9668;9341;15595;7675;7711;3705;1993;1630
3171030;Verdelândia;MG;31;Sudeste;NORTE DE MINAS;MONTES CLAROS;-15.589;-43.603;True;8029;3958;3748;4212;2042;2006;3817;1916;1742
3171071;Veredinha;MG;31;Sudeste;JEQUITINHONHA;CAPELINHA;-17.399;-42.736;True;5732;3007;2725;3781;1952;1829;1951;1055;896
3171105;Veríssimo;MG;31;Sudeste;TRIANGULO MINEIRO/ALTO PARANAIBA;UBERABA;-19.663;-48.308;True;3667;1950;1701;1830;943;887;1837;1007;814
3171154;Vermelho Novo;MG;31;Sudeste;ZONA DA MATA;PONTE NOVA;-20.036;-42.267;True;4551;2388;2150;1724;888;836;2827;1500;1314
3171204;Vespasiano;MG;31;Sudeste;METROPOLITANA DE BELO HORIZONTE;BELO HORIZONTE;-19.692;-43.923;True;94191;46156;47776;90200;44171;45800;3991;1985;1976
3171303;Viçosa;MG;31;Sudeste;ZONA DA MATA;VICOSA;-20.754;-42.882;True;70404;34202;36039;65042;31370;33519;5362;2832;2520
3171402;Vieiras;MG;31;Sudeste;ZONA DA MATA;MURIAE;-20.866;-42.244;True;3808;1891;1834;1695;840;838;2113;1051;996
3171501;Mathias Lobato;MG;31;Sudeste;VALE DO RIO DOCE;GOVERNADOR VALADARES;-18.592;-41.908;True;3457;1772;1679;3131;1590;1535;326;182;144
3171600;Virgem da Lapa;MG;31;Sudeste;JEQUITINHONHA;ARACUAI;-16.804;-42.343;True;14103;6781;6834;6733;3110;3515;7370;3671;3319
3171709;Virgínia;MG;31;Sudeste;SUL/SUDOESTE DE MINAS;ITAJUBA;-22.333;-45.092;True;8351;4224;4119;3585;1692;1893;4766;2532;2226
3171808;Virginópolis;MG;31;Sudeste;VALE DO RIO DOCE;GUANHAES;-18.823;-42.704;True;10891;5442;5449;6198;3011;3187;4693;2431;2262
3171907;Virgolândia;MG;31;Sudeste;VALE DO RIO DOCE;GOVERNADOR VALADARES;-18.476;-42.307;True;5724;2815;2909;3234;1540;1694;2490;1275;1215
3172004;Visconde do Rio Branco;MG;31;Sudeste;ZONA DA MATA;UBA;-21.01;-42.841;True;35346;17274;17841;28955;13963;14855;6391;3311;2986
3172103;Volta Grande;MG;31;Sudeste;ZONA DA MATA;CATAGUASES;-21.771;-42.539;True;5166;2522;2644;3783;1826;1957;1383;696;687
3172202;Wenceslau Braz;MG;31;Sudeste;SUL/SUDOESTE DE MINAS;ITAJUBA;-22.534;-45.363;True;2509;1233;1186;1237;601;588;1272;632;598
3200102;Afonso Cláudio;ES;32;Sudeste;CENTRAL ESPIRITO-SANTENSE;AFONSO CLAUDIO;-20.074;-41.124;True;30773;15573;15170;14811;7156;7648;15962;8417;7522
3200136;Águia Branca;ES;32;Sudeste;NOROESTE ESPIRITO-SANTENSE;NOVA VENECIA;-18.983;-40.74;True;9281;4768;4452;2791;1373;1409;6490;3395;3043
3200169;Água Doce do Norte;ES;32;Sudeste;NOROESTE ESPIRITO-SANTENSE;BARRA DE SAO FRANCISCO;-18.547;-40.979;True;11934;5958;5919;6623;3189;3409;5311;2769;2510
3200201;Alegre;ES;32;Sudeste;SUL ESPIRITO-SANTENSE;ALEGRE;-20.764;-41.533;True;30473;15095;15298;19951;9478;10422;10522;5617;4876
3200300;Alfredo Chaves;ES;32;Sudeste;CENTRAL ESPIRITO-SANTENSE;GUARAPARI;-20.635;-40.75;True;13983;7155;6719;6458;3170;3261;7525;3985;3458
3200359;Alto Rio Novo;ES;32;Sudeste;NOROESTE ESPIRITO-SANTENSE;COLATINA;-19.056;-41.017;True;6198;3103;3048;3226;1590;1624;2972;1513;1424
3200409;Anchieta;ES;32;Sudeste;CENTRAL ESPIRITO-SANTENSE;GUARAPARI;-20.722;-40.782;True;19459;9807;9491;13686;6844;6727;5773;2963;2764
3200508;Apiacá;ES;32;Sudeste;SUL ESPIRITO-SANTENSE;CACHOEIRO DE ITAPEMIRIM;-21.154;-41.568;True;7617;3849;3768;5152;2526;2626;2465;1323;1142
3200607;Aracruz;ES;32;Sudeste;LITORAL NORTE ESPIRITO-SANTENSE;LINHARES;-19.82;-40.273;True;73358;36217;36261;64240;31579;31931;9118;4638;4330
3200706;Atilio Vivacqua;ES;32;Sudeste;SUL ESPIRITO-SANTENSE;CACHOEIRO DE ITAPEMIRIM;-20.914;-41.198;True;8878;4463;4404;4809;2364;2438;4069;2099;1966
3200805;Baixo Guandu;ES;32;Sudeste;NOROESTE ESPIRITO-SANTENSE;COLATINA;-19.519;-41.016;True;28637;14071;14539;21577;10385;11187;7060;3686;3352
3200904;Barra de São Francisco;ES;32;Sudeste;NOROESTE ESPIRITO-SANTENSE;BARRA DE SAO FRANCISCO;-18.755;-40.891;True;39627;19504;19373;24695;11681;12546;14932;7823;6827
3201001;Boa Esperança;ES;32;Sudeste;NOROESTE ESPIRITO-SANTENSE;NOVA VENECIA;-18.54;-40.296;True;12912;6395;6275;9492;4598;4687;3420;1797;1588
3201100;Bom Jesus do Norte;ES;32;Sudeste;SUL ESPIRITO-SANTENSE;CACHOEIRO DE ITAPEMIRIM;-21.114;-41.672;True;9318;4463;4840;8264;3913;4343;1054;550;497
3201159;Brejetuba;ES;32;Sudeste;CENTRAL ESPIRITO-SANTENSE;AFONSO CLAUDIO;-20.146;-41.29;True;10949;5732;5164;2785;1414;1371;8164;4318;3793
3201209;Cachoeiro de Itapemirim;ES;32;Sudeste;SUL ESPIRITO-SANTENSE;CACHOEIRO DE ITAPEMIRIM;-20.849;-41.113;True;195288;;;;;;;;
3201308;Cariacica;ES;32;Sudeste;CENTRAL ESPIRITO-SANTENSE;VITORIA;-20.264;-40.42;True;356536;;;;;;;;
3201407;Castelo;ES;32;Sudeste;SUL ESPIRITO-SANTENSE;CACHOEIRO DE ITAPEMIRIM;-20.604;-41.185;True;32250;16053;16010;19132;9167;9859;13118;6886;6151
3201506;Colatina;ES;32;Sudeste;NOROESTE ESPIRITO-SANTENSE;COLATINA;-19.539;-40.631;True;106637;51582;54378;92819;44430;47918;13818;7152;6460
3201605;Conceição da Barra;ES;32;Sudeste;LITORAL NORTE ESPIRITO-SANTENSE;SAO MATEUS;-18.593;-39.732;True;26230;13116;13045;18855;9232;9564;7375;3884;3481
3201704;Conceição do Castelo;ES;32;Sudeste;CENTRAL ESPIRITO-SANTENSE;AFONSO CLAUDIO;-20.368;-41.244;True;11326;5782;5530;5420;2647;2773;5906;3135;2757
3201803;Divino de São Lourenço;ES;32;Sudeste;SUL ESPIRITO-SANTENSE;ALEGRE;-20.62;-41.686;True;4837;2512;2272;1786;888;880;3051;1624;1392
3201902;Domingos Martins;ES;32;Sudeste;CENTRAL ESPIRITO-SANTENSE;AFONSO CLAUDIO;-20.363;-40.659;True;31175;15863;15307;7847;3773;4074;23328;12090;11233
3202009;Dores do Rio Preto;ES;32;Sudeste;SUL ESPIRITO-SANTENSE;ALEGRE;-20.689;-41.845;True;6106;3038;3051;3335;1612;1716;2771;1426;1335
3202108;Ecoporanga;ES;32;Sudeste;NOROESTE ESPIRITO-SANTENSE;BARRA DE SAO FRANCISCO;-18.373;-40.831;True;23296;11297;11348;14163;6696;7187;9133;4601;4161
3202207;Fundão;ES;32;Sudeste;LITORAL NORTE ESPIRITO-SANTENSE;LINHARES;-19.933;-40.407;True;15209;7127;7194;12987;5940;6212;2222;1187;982
3202256;Governador Lindenberg;ES;32;Sudeste;NOROESTE ESPIRITO-SANTENSE;COLATINA;-19.2519;-40.4614;True;9890;5133;4720;3423;1743;1680;6467;3390;3040
3202306;Guaçuí;ES;32;Sudeste;SUL ESPIRITO-SANTENSE;ALEGRE;-20.776;-41.679;True;25761;12566;13080;19822;9379;10338;5939;3187;2742
3202405;Guarapari;ES;32;Sudeste;CENTRAL ESPIRITO-SANTENSE;GUARAPARI;-20.658;-40.511;False;98073;47791;49184;92978;45131;46774;5095;2660;2410
3202454;Ibatiba;ES;32;Sudeste;SUL ESPIRITO-SANTENSE;ALEGRE;-20.234;-41.511;True;19649;9854;9633;11841;5744;6041;7808;4110;3592
3202504;Ibiraçu;ES;32;Sudeste;LITORAL NORTE ESPIRITO-SANTENSE;LINHARES;-19.832;-40.37;True;10312;5099;5150;7480;3631;3841;2832;1468;1309
3202553;Ibitirama;ES;32;Sudeste;SUL ESPIRITO-SANTENSE;ALEGRE;-20.541;-41.667;True;8994;4694;4293;3080;1523;1550;5914;3171;2743
3202603;Iconha;ES;32;Sudeste;CENTRAL ESPIRITO-SANTENSE;GUARAPARI;-20.793;-40.811;True;11496;5820;5630;6283;3120;3152;5213;2700;2478
3202652;Irupi;ES;32;Sudeste;SUL ESPIRITO-SANTENSE;ALEGRE;-20.345;-41.641;True;10369;5322;5016;3778;1872;1902;6591;3450;3114
3202702;Itaguaçu;ES;32;Sudeste;CENTRAL ESPIRITO-SANTENSE;SANTA TERESA;-19.802;-40.856;True;13881;7061;6793;7476;3673;3803;6405;3388;2990
3202801;Itapemirim;ES;32;Sudeste;SUL ESPIRITO-SANTENSE;ITAPEMIRIM;-21.011;-40.834;True;30833;15420;15345;19699;9690;9972;11134;5730;5373
3202900;Itarana;ES;32;Sudeste;CENTRAL ESPIRITO-SANTENSE;SANTA TERESA;-19.874;-40.875;True;10569;5287;5253;3807;1805;1999;6762;3482;3254
3203007;Iúna;ES;32;Sudeste;SUL ESPIRITO-SANTENSE;ALEGRE;-20.346;-41.536;True;25533;12730;12762;15079;7237;7820;10454;5493;4942
3203056;Jaguaré;ES;32;Sudeste;LITORAL NORTE ESPIRITO-SANTENSE;SAO MATEUS;-18.906;-40.076;True;21949;10843;10465;13418;6495;6449;8531;4348;4016
3203106;Jerônimo Monteiro;ES;32;Sudeste;SUL ESPIRITO-SANTENSE;CACHOEIRO DE ITAPEMIRIM;-20.789;-41.395;True;10701;5218;5397;7950;3760;4129;2751;1458;1268
3203130;João Neiva;ES;32;Sudeste;LITORAL NORTE ESPIRITO-SANTENSE;LINHARES;-19.758;-40.386;True;14403;7039;7227;11766;5695;5952;2637;1344;1275
3203163;Laranja da Terra;ES;32;Sudeste;CENTRAL ESPIRITO-SANTENSE;AFONSO CLAUDIO;-19.899;-41.057;True;10802;5476;5310;3018;1471;1547;7784;4005;3763
3203205;Linhares;ES;32;Sudeste;LITORAL NORTE ESPIRITO-SANTENSE;LINHARES;-19.391;-40.072;True;124564;61185;62195;104646;50855;52730;19918;10330;9465
3203304;Mantenópolis;ES;32;Sudeste;NOROESTE ESPIRITO-SANTENSE;BARRA DE SAO FRANCISCO;-18.863;-41.123;True;11463;5490;5562;7022;3264;3509;4441;2226;2053
3203320;Marataízes;ES;32;Sudeste;SUL ESPIRITO-SANTENSE;ITAPEMIRIM;-21.043;-40.824;True;31221;15485;15689;24218;11896;12286;7003;3589;3403
3203346;Marechal Floriano;ES;32;Sudeste;CENTRAL ESPIRITO-SANTENSE;AFONSO CLAUDIO;-20.413;-40.683;True;12699;6424;6260;6050;2962;3079;6649;3462;3181
3203353;Marilândia;ES;32;Sudeste;NOROESTE ESPIRITO-SANTENSE;COLATINA;-19.413;-40.542;True;10226;5182;5034;4827;2380;2447;5399;2802;2587
3203403;Mimoso do Sul;ES;32;Sudeste;SUL ESPIRITO-SANTENSE;CACHOEIRO DE ITAPEMIRIM;-21.064;-41.366;True;26208;13324;12884;14773;7186;7587;11435;6138;5297
3203502;Montanha;ES;32;Sudeste;LITORAL NORTE ESPIRITO-SANTENSE;MONTANHA;-18.127;-40.363;True;17998;9063;8762;13366;6563;6689;4632;2500;2073
3203601;Mucurici;ES;32;Sudeste;LITORAL NORTE ESPIRITO-SANTENSE;MONTANHA;-18.093;-40.516;True;5755;2785;2669;3519;1614;1690;2236;1171;979
3203700;Muniz Freire;ES;32;Sudeste;SUL ESPIRITO-SANTENSE;ALEGRE;-20.464;-41.413;True;18196;9238;8879;7498;3603;3857;10698;5635;5022
3203809;Muqui;ES;32;Sudeste;SUL ESPIRITO-SANTENSE;CACHOEIRO DE ITAPEMIRIM;-20.952;-41.346;True;13841;6962;6829;9126;4393;4709;4715;2569;2120
3203908;Nova Venécia;ES;32;Sudeste;NOROESTE ESPIRITO-SANTENSE;NOVA VENECIA;-18.711;-40.401;True;44380;22261;22027;29121;14129;14963;15259;8132;7064
3204005;Pancas;ES;32;Sudeste;NOROESTE ESPIRITO-SANTENSE;COLATINA;-19.225;-40.851;True;18465;9272;9111;9273;4443;4776;9192;4829;4335
3204054;Pedro Canário;ES;32;Sudeste;LITORAL NORTE ESPIRITO-SANTENSE;SAO MATEUS;-18.03;-40.151;True;23204;11587;11400;21421;10670;10540;1783;917;860
3204104;Pinheiros;ES;32;Sudeste;LITORAL NORTE ESPIRITO-SANTENSE;MONTANHA;-18.406;-40.225;True;22663;11420;11114;18115;8998;9017;4548;2422;2097
3204203;Piúma;ES;32;Sudeste;CENTRAL ESPIRITO-SANTENSE;GUARAPARI;-20.835;-40.729;True;16249;8030;8180;15389;7597;7753;860;433;427
3204252;Ponto Belo;ES;32;Sudeste;LITORAL NORTE ESPIRITO-SANTENSE;MONTANHA;-18.124;-40.541;True;6831;3440;3305;5324;2606;2657;1507;834;648
3204302;Presidente Kennedy;ES;32;Sudeste;SUL ESPIRITO-SANTENSE;ITAPEMIRIM;-21.099;-41.047;True;10307;5294;5001;3548;1823;1713;6759;3471;3288
3204351;Rio Bananal;ES;32;Sudeste;LITORAL NORTE ESPIRITO-SANTENSE;LINHARES;-19.265;-40.333;True;16587;8465;7810;5528;2705;2771;11059;5760;5039
3204401;Rio Novo do Sul;ES;32;Sudeste;CENTRAL ESPIRITO-SANTENSE;GUARAPARI;-20.863;-40.936;True;11111;5611;5460;5927;2935;2992;5184;2676;2468
3204500;Santa Leopoldina;ES;32;Sudeste;CENTRAL ESPIRITO-SANTENSE;SANTA TERESA;-20.101;-40.53;True;12349;6356;5778;2467;1224;1229;9882;5132;4549
3204559;Santa Maria de Jetibá;ES;32;Sudeste;CENTRAL ESPIRITO-SANTENSE;SANTA TERESA;-20.041;-40.746;True;31845;16370;15399;10311;5133;5164;21534;11237;10235
3204609;Santa Teresa;ES;32;Sudeste;CENTRAL ESPIRITO-SANTENSE;SANTA TERESA;-19.936;-40.6;True;20179;9984;9821;10278;4893;5203;9901;5091;4618
3204658;São Domingos do Norte;ES;32;Sudeste;NOROESTE ESPIRITO-SANTENSE;COLATINA;-19.144;-40.624;True;7840;4072;3759;3142;1560;1579;4698;2512;2180
3204708;São Gabriel da Palha;ES;32;Sudeste;NOROESTE ESPIRITO-SANTENSE;NOVA VENECIA;-19.017;-40.536;True;28878;14352;14226;21502;10445;10793;7376;3907;3433
3204807;São José do Calçado;ES;32;Sudeste;SUL ESPIRITO-SANTENSE;CACHOEIRO DE ITAPEMIRIM;-21.025;-41.654;True;10570;5304;5262;7924;3871;4049;2646;1433;1213
3204906;São Mateus;ES;32;Sudeste;LITORAL NORTE ESPIRITO-SANTENSE;SAO MATEUS;-18.716;-39.859;True;96390;47267;47831;74812;36058;37671;21578;11209;10160
3204955;São Roque do Canaã;ES;32;Sudeste;CENTRAL ESPIRITO-SANTENSE;SANTA TERESA;-19.739;-40.657;True;10439;5282;5039;5073;2547;2483;5366;2735;2556
3205002;Serra;ES;32;Sudeste;CENTRAL ESPIRITO-SANTENSE;VITORIA;-20.129;-40.308;True;385370;;;;;;;;
3205010;Sooretama;ES;32;Sudeste;LITORAL NORTE ESPIRITO-SANTENSE;LINHARES;-19.197;-40.098;True;21867;10664;10386;14869;7104;7084;6998;3560;3302
3205036;Vargem Alta;ES;32;Sudeste;SUL ESPIRITO-SANTENSE;CACHOEIRO DE ITAPEMIRIM;-20.671;-41.007;True;17862;9208;8631;5442;2701;2735;12420;6507;5896
3205069;Venda Nova do Imigrante;ES;32;Sudeste;CENTRAL ESPIRITO-SANTENSE;AFONSO CLAUDIO;-20.34;-41.135;True;18610;9254;9034;12747;6117;6348;5863;3137;2686
3205101;Viana;ES;32;Sudeste;CENTRAL ESPIRITO-SANTENSE;VITORIA;-20.39;-40.496;True;57539;29218;28058;53307;26962;26096;4232;2256;1962
3205150;Vila Pavão;ES;32;Sudeste;NOROESTE ESPIRITO-SANTENSE;NOVA VENECIA;-18.615;-40.611;True;8705;4518;4183;2673;1338;1335;6032;3180;2848
3205176;Vila Valério;ES;32;Sudeste;NOROESTE ESPIRITO-SANTENSE;NOVA VENECIA;-18.998;-40.389;True;13646;7064;6545;4857;2406;2434;8789;4658;4111
3205200;Vila Velha;ES;32;Sudeste;CENTRAL ESPIRITO-SANTENSE;VITORIA;-20.33;-40.292;False;398068;;;;;;;;
3205309;Vitória;ES;32;Sudeste;CENTRAL ESPIRITO-SANTENSE;VITORIA;-20.319;-40.338;False;314042;;;;;;;;
3300100;Angra dos Reis;RJ;33;Sudeste;SUL FLUMINENSE;BAIA DA ILHA GRANDE;-23.007;-44.318;False;148476;73841;73016;143552;71295;70672;4924;2546;2344
3300159;Aperibé;RJ;33;Sudeste;NOROESTE FLUMINENSE;SANTO ANTONIO DE PADUA;-21.621;-42.103;True;8820;4390;4423;7823;3860;3956;997;530;467
3300209;Araruama;RJ;33;Sudeste;BAIXADAS;LAGOS;-22.873;-42.343;True;98268;47269;49668;91375;43806;46355;6893;3463;3313
3300225;Areal;RJ;33;Sudeste;CENTRO FLUMINENSE;TRES RIOS;-22.231;-43.106;True;11009;5406;5599;9582;4661;4917;1427;745;682
3300233;Armação dos Búzios;RJ;33;Sudeste;BAIXADAS;LAGOS;-22.747;-41.882;True;24560;12283;11919;24560;12283;11919;;;
3300258;Arraial do Cabo;RJ;33;Sudeste;BAIXADAS;LAGOS;-22.966;-42.028;True;25248;12429;12694;25248;12429;12694;;;
3300308;Barra do Piraí;RJ;33;Sudeste;SUL FLUMINENSE;BARRA DO PIRAI;-22.47;-43.826;True;96282;46196;49860;92714;44344;48147;3568;1852;1713
3300407;Barra Mansa;RJ;33;Sudeste;SUL FLUMINENSE;VALE DO PARAIBA FLUMINENSE;-22.544;-44.171;True;175315;;;;;;;;
3300456;Belford Roxo;RJ;33;Sudeste;METROPOLITANA DO RIO DE JANEIRO;RIO DE JANEIRO;-22.764;-43.399;True;480555;;;;;;;;
3300506;Bom Jardim;RJ;33;Sudeste;CENTRO FLUMINENSE;NOVA FRIBURGO;-22.152;-42.419;True;24626;12283;12195;13795;6640;7120;10831;5643;5075
3300605;Bom Jesus do Itabapoana;RJ;33;Sudeste;NOROESTE FLUMINENSE;ITAPERUNA;-21.134;-41.68;True;33888;16599;17274;28247;13622;14610;5641;2977;2664
3300704;Cabo Frio;RJ;33;Sudeste;BAIXADAS;LAGOS;-22.879;-42.019;True;162229;79243;81939;127051;61621;64493;35178;17622;17446
3300803;Cachoeiras de Macacu;RJ;33;Sudeste;METROPOLITANA DO RIO DE JANEIRO;MACACU-CACERIBU;-22.463;-42.653;True;53037;26180;26475;44676;21746;22648;8361;4434;3827
3300902;Cambuci;RJ;33;Sudeste;NOROESTE FLUMINENSE;SANTO ANTONIO DE PADUA;-21.575;-41.911;True;14368;7168;7087;10603;5192;5386;3765;1976;1701
3300936;Carapebus;RJ;33;Sudeste;NORTE FLUMINENSE;MACAE;-22.187;-41.661;True;10677;5293;5210;8702;4310;4313;1975;983;897
3300951;Comendador Levy Gasparian;RJ;33;Sudeste;CENTRO FLUMINENSE;TRES RIOS;-22.029;-43.205;True;8322;4171;4148;7921;3950;3971;401;221;177
3301009;Campos dos Goytacazes;RJ;33;Sudeste;NORTE FLUMINENSE;CAMPOS DOS GOYTACAZES;-21.754;-41.324;True;426154;;;;;;;;
3301108;Cantagalo;RJ;33;Sudeste;CENTRO FLUMINENSE;CANTAGALO-CORDEIRO;-21.981;-42.368;True;19799;9704;9933;13464;6455;6881;6335;3249;3052
3301157;Cardoso Moreira;RJ;33;Sudeste;NORTE FLUMINENSE;CAMPOS DOS GOYTACAZES;-21.488;-41.616;True;12206;6068;6104;8594;4206;4388;3612;1862;1716
3301207;Carmo;RJ;33;Sudeste;CENTRO FLUMINENSE;CANTAGALO-CORDEIRO;-21.934;-42.609;True;16690;8248;8434;12671;6161;6506;4019;2087;1928
3301306;Casimiro de Abreu;RJ;33;Sudeste;BAIXADAS;BACIA DE SAO JOAO;-22.481;-42.204;True;27086;13371;13621;23418;11499;11840;3668;1872;1781
3301405;Conceição de Macabu;RJ;33;Sudeste;NORTE FLUMINENSE;MACAE;-22.085;-41.868;True;19479;9570;9739;16909;8254;8590;2570;1316;1149
3301504;Cordeiro;RJ;33;Sudeste;CENTRO FLUMINENSE;CANTAGALO-CORDEIRO;-22.029;-42.361;True;18984;9094;9773;18367;8785;9504;617;309;269
3301603;Duas Barras;RJ;33;Sudeste;CENTRO FLUMINENSE;NOVA FRIBURGO;-22.051;-42.522;True;10438;5289;5112;6789;3371;3416;3649;1918;1696
3301702;Duque de Caxias;RJ;33;Sudeste;METROPOLITANA DO RIO DE JANEIRO;RIO DE JANEIRO;-22.786;-43.312;True;842686;;;;;;;;
3301801;Engenheiro Paulo de Frontin;RJ;33;Sudeste;METROPOLITANA DO RIO DE JANEIRO;VASSOURAS;-22.55;-43.678;True;12544;6143;6381;9055;4355;4694;3489;1788;1687
3301850;Guapimirim;RJ;33;Sudeste;METROPOLITANA DO RIO DE JANEIRO;RIO DE JANEIRO;-22.537;-42.982;True;44692;22016;22521;42613;20950;21525;2079;1066;996
3301876;Iguaba Grande;RJ;33;Sudeste;BAIXADAS;LAGOS;-22.839;-42.229;True;19716;9600;9974;19716;9600;9974;;;
3301900;Itaboraí;RJ;33;Sudeste;METROPOLITANA DO RIO DE JANEIRO;RIO DE JANEIRO;-22.744;-42.859;True;215792;;;;;;;;
3302007;Itaguaí;RJ;33;Sudeste;METROPOLITANA DO RIO DE JANEIRO;ITAGUAI;-22.852;-43.775;False;95356;47127;47822;91844;45281;46156;3512;1846;1666
3302056;Italva;RJ;33;Sudeste;NOROESTE FLUMINENSE;ITAPERUNA;-21.421;-41.691;True;13645;6690;6951;9927;4753;5174;3718;1937;1777
3302106;Itaocara;RJ;33;Sudeste;NOROESTE FLUMINENSE;SANTO ANTONIO DE PADUA;-21.679;-42.082;True;22069;10804;11252;16044;7693;8344;6025;3111;2908
3302205;Itaperuna;RJ;33;Sudeste;NOROESTE FLUMINENSE;ITAPERUNA;-21.205;-41.888;True;92852;44907;47095;85030;40878;43483;7822;4029;3612
3302254;Itatiaia;RJ;33;Sudeste;SUL FLUMINENSE;VALE DO PARAIBA FLUMINENSE;-22.496;-44.563;True;31185;15439;15682;29367;14482;14827;1818;957;855
3302270;Japeri;RJ;33;Sudeste;METROPOLITANA DO RIO DE JANEIRO;RIO DE JANEIRO;-22.643;-43.653;True;93197;46849;46243;93197;46849;46243;;;
3302304;Laje do Muriaé;RJ;33;Sudeste;NOROESTE FLUMINENSE;ITAPERUNA;-21.206;-42.123;True;7769;3876;3893;5899;2856;3043;1870;1020;850
3302403;Macaé;RJ;33;Sudeste;NORTE FLUMINENSE;MACAE;-22.371;-41.787;False;169513;82579;83418;165001;80180;81378;4512;2399;2040
3302452;Macuco;RJ;33;Sudeste;CENTRO FLUMINENSE;CANTAGALO-CORDEIRO;-21.984;-42.253;True;5246;2443;2679;4281;1991;2166;965;452;513
3302502;Magé;RJ;33;Sudeste;METROPOLITANA DO RIO DE JANEIRO;RIO DE JANEIRO;-22.653;-43.041;True;232171;;;;;;;;
3302601;Mangaratiba;RJ;33;Sudeste;METROPOLITANA DO RIO DE JANEIRO;ITAGUAI;-22.96;-44.041;False;29253;14486;14559;24173;11896;12132;5080;2590;2427
3302700;Maricá;RJ;33;Sudeste;METROPOLITANA DO RIO DE JANEIRO;RIO DE JANEIRO;-22.919;-42.819;True;105294;51454;52905;102884;50222;51741;2410;1232;1164
3302809;Mendes;RJ;33;Sudeste;METROPOLITANA DO RIO DE JANEIRO;VASSOURAS;-22.527;-43.733;True;17242;8254;8920;17094;8180;8846;148;74;74
3302858;Mesquita;RJ;33;Sudeste;METROPOLITANA DO RIO DE JANEIRO;RIO DE JANEIRO;-22.7815;-43.429;True;182495;;;;;;;;
3302908;Miguel Pereira;RJ;33;Sudeste;METROPOLITANA DO RIO DE JANEIRO;VASSOURAS;-22.454;-43.469;True;24585;11806;12719;21282;10087;11161;3303;1719;1558
3303005;Miracema;RJ;33;Sudeste;NOROESTE FLUMINENSE;SANTO ANTONIO DE PADUA;-21.412;-42.197;True;26231;12662;13510;24284;11644;12619;1947;1018;891
3303104;Natividade;RJ;33;Sudeste;NOROESTE FLUMINENSE;ITAPERUNA;-21.042;-41.973;True;14930;7358;7571;11885;5748;6136;3045;1610;1435
3303203;Nilópolis;RJ;33;Sudeste;METROPOLITANA DO RIO DE JANEIRO;RIO DE JANEIRO;-22.808;-43.414;True;153581;70992;80439;153581;70992;80439;;;
3303302;Niterói;RJ;33;Sudeste;METROPOLITANA DO RIO DE JANEIRO;RIO DE JANEIRO;-22.883;-43.104;True;474002;;;;;;;;
3303401;Nova Friburgo;RJ;33;Sudeste;CENTRO FLUMINENSE;NOVA FRIBURGO;-22.282;-42.531;True;177376;;;;;;;;
3303500;Nova Iguaçu;RJ;33;Sudeste;METROPOLITANA DO RIO DE JANEIRO;RIO DE JANEIRO;-22.759;-43.451;True;830672;;;;;;;;
3303609;Paracambi;RJ;33;Sudeste;METROPOLITANA DO RIO DE JANEIRO;VASSOURAS;-22.611;-43.709;True;42423;20243;21332;39026;18577;19733;3397;1666;1599
3303708;Paraíba do Sul;RJ;33;Sudeste;CENTRO FLUMINENSE;TRES RIOS;-22.162;-43.293;True;39257;18842;20132;34145;16218;17701;5112;2624;2431
3303807;Parati;RJ;33;Sudeste;SUL FLUMINENSE;BAIA DA ILHA GRANDE;-23.218;-44.713;False;32838;16288;15995;14970;7143;7578;17868;9145;8417
3303856;Paty do Alferes;RJ;33;Sudeste;METROPOLITANA DO RIO DE JANEIRO;VASSOURAS;-22.429;-43.419;True;25132;12280;12827;17755;8537;9215;7377;3743;3612
3303906;Petrópolis;RJ;33;Sudeste;METROPOLITANA DO RIO DE JANEIRO;SERRANA;-22.505;-43.179;True;306645;;;;;;;;
3303955;Pinheiral;RJ;33;Sudeste;SUL FLUMINENSE;VALE DO PARAIBA FLUMINENSE;-22.513;-44.001;True;20885;10220;10621;19135;9302;9794;1750;918;827
3304003;Piraí;RJ;33;Sudeste;SUL FLUMINENSE;VALE DO PARAIBA FLUMINENSE;-22.629;-43.898;True;24170;11751;12294;20497;9828;10572;3673;1923;1722
3304102;Porciúncula;RJ;33;Sudeste;NOROESTE FLUMINENSE;ITAPERUNA;-20.963;-42.041;True;17178;8549;8629;13030;6333;6697;4148;2216;1932
3304110;Porto Real;RJ;33;Sudeste;SUL FLUMINENSE;VALE DO PARAIBA FLUMINENSE;-22.42;-44.29;True;14503;7148;7223;14423;7097;7194;80;51;29
3304128;Quatis;RJ;33;Sudeste;SUL FLUMINENSE;VALE DO PARAIBA FLUMINENSE;-22.407;-44.258;True;12031;5980;6034;10840;5313;5518;1191;667;516
3304144;Queimados;RJ;33;Sudeste;METROPOLITANA DO RIO DE JANEIRO;RIO DE JANEIRO;-22.716;-43.555;True;130275;62742;67028;130275;62742;67028;;;
3304151;Quissamã;RJ;33;Sudeste;NORTE FLUMINENSE;MACAE;-22.107;-41.472;True;17376;8475;8619;10135;4899;5106;7241;3576;3513
3304201;Resende;RJ;33;Sudeste;SUL FLUMINENSE;VALE DO PARAIBA FLUMINENSE;-22.469;-44.447;True;118547;57584;60591;111439;53885;57242;7108;3699;3349
3304300;Rio Bonito;RJ;33;Sudeste;METROPOLITANA DO RIO DE JANEIRO;MACACU-CACERIBU;-22.708;-42.626;True;51942;25552;26259;39749;19229;20461;12193;6323;5798
3304409;Rio Claro;RJ;33;Sudeste;SUL FLUMINENSE;VALE DO PARAIBA FLUMINENSE;-22.723;-44.136;True;17216;8580;8559;15053;7461;7570;2163;1119;989
3304508;Rio das Flores;RJ;33;Sudeste;SUL FLUMINENSE;BARRA DO PIRAI;-22.168;-43.586;True;8192;3976;4110;5776;2749;2978;2416;1227;1132
3304524;Rio das Ostras;RJ;33;Sudeste;BAIXADAS;BACIA DE SAO JOAO;-22.527;-41.945;True;74750;35767;36518;73211;34944;35822;1539;823;696
3304557;Rio de Janeiro;RJ;33;Sudeste;METROPOLITANA DO RIO DE JANEIRO;RIO DE JANEIRO;-22.903;-43.208;False;6093472;;;;;;;;
3304607;Santa Maria Madalena;RJ;33;Sudeste;CENTRO FLUMINENSE;SANTA MARIA MADALENA;-21.955;-42.008;True;10409;5351;5054;5772;2838;2933;4637;2513;2121
3304706;Santo Antônio de Pádua;RJ;33;Sudeste;NOROESTE FLUMINENSE;SANTO ANTONIO DE PADUA;-21.539;-42.18;True;40145;19719;20400;30310;14636;15658;9835;5083;4742
3304755;São Francisco de Itabapoana;RJ;33;Sudeste;NORTE FLUMINENSE;CAMPOS DOS GOYTACAZES;-21.47;-41.119;True;44475;22491;21984;22419;11097;11322;22056;11394;10662
3304805;São Fidélis;RJ;33;Sudeste;NORTE FLUMINENSE;CAMPOS DOS GOYTACAZES;-21.646;-41.747;True;37477;18619;18844;28584;13833;14745;8893;4786;4099
3304904;São Gonçalo;RJ;33;Sudeste;METROPOLITANA DO RIO DE JANEIRO;RIO DE JANEIRO;-22.827;-43.054;True;960631;;;;;;;;
3305000;São João da Barra;RJ;33;Sudeste;NORTE FLUMINENSE;CAMPOS DOS GOYTACAZES;-21.64;-41.051;True;28889;14301;14582;21672;10581;11085;7217;3720;3497
3305109;São João de Meriti;RJ;33;Sudeste;METROPOLITANA DO RIO DE JANEIRO;RIO DE JANEIRO;-22.804;-43.372;True;464282;;;;;;;;
3305133;São José de Ubá;RJ;33;Sudeste;NOROESTE FLUMINENSE;SANTO ANTONIO DE PADUA;-21.358;-41.943;True;6829;3411;3407;2974;1422;1541;3855;1989;1866
3305158;São José do Vale do Rio Preto;RJ;33;Sudeste;METROPOLITANA DO RIO DE JANEIRO;SERRANA;-22.151;-42.924;True;19439;9499;9534;8402;4071;4204;11037;5428;5330
3305208;São Pedro da Aldeia;RJ;33;Sudeste;BAIXADAS;LAGOS;-22.839;-42.103;True;75869;37592;38203;70641;34946;35632;5228;2646;2571
3305307;São Sebastião do Alto;RJ;33;Sudeste;CENTRO FLUMINENSE;SANTA MARIA MADALENA;-21.957;-42.135;True;8616;4332;4282;4174;2028;2146;4442;2304;2136
3305406;Sapucaia;RJ;33;Sudeste;CENTRO FLUMINENSE;TRES RIOS;-21.995;-42.914;True;16858;8364;8435;12472;6034;6397;4386;2330;2038
3305505;Saquarema;RJ;33;Sudeste;BAIXADAS;LAGOS;-22.92;-42.51;True;62174;30474;31406;60364;29561;30536;1810;913;870
3305554;Seropédica;RJ;33;Sudeste;METROPOLITANA DO RIO DE JANEIRO;ITAGUAI;-22.744;-43.708;True;72466;35399;36695;59069;28720;30090;13397;6679;6605
3305604;Silva Jardim;RJ;33;Sudeste;BAIXADAS;BACIA DE SAO JOAO;-22.651;-42.392;True;21362;10721;10597;16127;7876;8241;5235;2845;2356
3305703;Sumidouro;RJ;33;Sudeste;CENTRO FLUMINENSE;NOVA FRIBURGO;-22.05;-42.675;True;14562;7461;7095;2373;1102;1268;12189;6359;5827
3305752;Tanguá;RJ;33;Sudeste;METROPOLITANA DO RIO DE JANEIRO;RIO DE JANEIRO;-22.73;-42.714;True;28322;13990;14205;25202;12376;12705;3120;1614;1500
3305802;Teresópolis;RJ;33;Sudeste;METROPOLITANA DO RIO DE JANEIRO;SERRANA;-22.412;-42.966;True;150268;71907;76401;127039;59940;65194;23229;11967;11207
3305901;Trajano de Morais;RJ;33;Sudeste;CENTRO FLUMINENSE;SANTA MARIA MADALENA;-22.063;-42.066;True;9706;4861;4739;4517;2193;2298;5189;2668;2441
3306008;Três Rios;RJ;33;Sudeste;CENTRO FLUMINENSE;TRES RIOS;-22.117;-43.209;True;72848;34707;37887;70218;33291;36675;2630;1416;1212
3306107;Valença;RJ;33;Sudeste;SUL FLUMINENSE;BARRA DO PIRAI;-22.246;-43.7;True;70850;33914;36268;62701;29713;32483;8149;4201;3785
3306156;Varre-Sai;RJ;33;Sudeste;NOROESTE FLUMINENSE;ITAPERUNA;-20.931;-41.869;True;8308;4262;4046;4854;2448;2406;3454;1814;1640
3306206;Vassouras;RJ;33;Sudeste;METROPOLITANA DO RIO DE JANEIRO;VASSOURAS;-22.404;-43.663;True;32495;15534;16937;21243;9936;11285;11252;5598;5652
3306305;Volta Redonda;RJ;33;Sudeste;SUL FLUMINENSE;VALE DO PARAIBA FLUMINENSE;-22.523;-44.104;True;255653;;;;;;;;
3500105;Adamantina;SP;35;Sudeste;PRESIDENTE PRUDENTE;ADAMANTINA;-21.685;-51.073;True;33289;16187;17102;31210;15042;16168;2079;1145;934
3500204;Adolfo;SP;35;Sudeste;SAO JOSE DO RIO PRETO;SAO JOSE DO RIO PRETO;-21.235;-49.644;True;3609;1816;1789;3275;1642;1629;334;174;160
3500303;Aguaí;SP;35;Sudeste;CAMPINAS;PIRASSUNUNGA;-22.059;-46.979;True;30181;15022;14827;27369;13514;13582;2812;1508;1245
3500402;Águas da Prata;SP;35;Sudeste;CAMPINAS;SAO JOAO DA BOA VISTA;-21.937;-46.717;True;7367;3463;3527;6612;3091;3199;755;372;328
3500501;Águas de Lindóia;SP;35;Sudeste;CAMPINAS;AMPARO;-22.476;-46.633;True;15867;7721;8086;15753;7664;8042;114;57;44
3500550;Águas de Santa Bárbara;SP;35;Sudeste;BAURU;AVARE;-22.881;-49.239;True;5360;2684;2676;4069;1978;2091;1291;706;585
3500600;Águas de São Pedro;SP;35;Sudeste;PIRACICABA;PIRACICABA;-22.599;-47.876;True;2340;886;1013;2340;886;1013;;;
3500709;Agudos;SP;35;Sudeste;BAURU;BAURU;-22.469;-48.988;True;34221;16837;17315;32632;15937;16647;1589;900;668
3500758;Alambari;SP;35;Sudeste;ITAPETININGA;ITAPETININGA;-23.551;-47.899;True;4070;2041;2029;2995;1517;1478;1075;524;551
3500808;Alfredo Marcondes;SP;35;Sudeste;PRESIDENTE PRUDENTE;PRESIDENTE PRUDENTE;-21.955;-51.413;True;3851;1922;1876;3184;1563;1578;667;359;298
3500907;Altair;SP;35;Sudeste;SAO JOSE DO RIO PRETO;SAO JOSE DO RIO PRETO;-20.524;-49.059;True;3272;1723;1530;2561;1340;1202;711;383;328
3501004;Altinópolis;SP;35;Sudeste;RIBEIRAO PRETO;BATATAIS;-21.026;-47.374;True;15139;7550;7468;13281;6564;6625;1858;986;843
3501103;Alto Alegre;SP;35;Sudeste;ARACATUBA;BIRIGUI;-21.581;-50.164;True;4157;2141;2011;3173;1610;1558;984;531;453
3501152;Alumínio;SP;35;Sudeste;MACRO METROPOLITANA PAULISTA;SOROCABA;-23.535;-47.262;True;15678;7898;7726;14110;7098;6966;1568;800;760
3501202;Álvares Florence;SP;35;Sudeste;SAO JOSE DO RIO PRETO;VOTUPORANGA;-20.321;-49.911;True;3902;2014;1872;2568;1324;1236;1334;690;636
3501301;Álvares Machado;SP;35;Sudeste;PRESIDENTE PRUDENTE;PRESIDENTE PRUDENTE;-22.079;-51.472;True;22859;11269;11389;20694;10119;10377;2165;1150;1012
3501400;Álvaro de Carvalho;SP;35;Sudeste;MARILIA;MARILIA;-22.089;-49.719;True;4610;2922;1684;2913;1423;1486;1697;1499;198
3501509;Alvinlândia;SP;35;Sudeste;MARILIA;MARILIA;-22.444;-49.763;True;2787;1394;1393;2492;1238;1254;295;156;139
3501608;Americana;SP;35;Sudeste;CAMPINAS;CAMPINAS;-22.739;-47.331;True;199094;;;;;;;;
3501707;Américo Brasiliense;SP;35;Sudeste;ARARAQUARA;ARARAQUARA;-21.724;-48.102;True;31005;15639;15299;30562;15405;15093;443;234;206
3501806;Américo de Campos;SP;35;Sudeste;SAO JOSE DO RIO PRETO;VOTUPORANGA;-20.299;-49.732;True;5379;2674;2705;4437;2174;2263;942;500;442
3501905;Amparo;SP;35;Sudeste;CAMPINAS;AMPARO;-22.701;-46.764;True;62692;30950;31602;46900;22667;24118;15792;8283;7484
3502002;Analândia;SP;35;Sudeste;ARARAQUARA;SAO CARLOS;-22.126;-47.663;True;4166;2111;2038;3197;1618;1579;969;493;459
3502101;Andradina;SP;35;Sudeste;ARACATUBA;ANDRADINA;-20.896;-51.379;True;54753;26808;27638;50995;24839;25891;3758;1969;1747
3502200;Angatuba;SP;35;Sudeste;ITAPETININGA;ITAPETININGA;-23.49;-48.413;True;21523;11015;10502;15290;7708;7576;6233;3307;2926
3502309;Anhembi;SP;35;Sudeste;BAURU;BOTUCATU;-22.789;-48.127;True;5271;2726;2416;3668;1828;1739;1603;898;677
3502408;Anhumas;SP;35;Sudeste;PRESIDENTE PRUDENTE;PRESIDENTE PRUDENTE;-22.295;-51.387;True;3695;1796;1773;2871;1403;1428;824;393;345
3502507;Aparecida;SP;35;Sudeste;VALE DO PARAIBA PAULISTA;GUARATINGUETA;-22.847;-45.23;True;35903;16746;17740;35468;16508;17566;435;238;174
3502606;Aparecida D'Oeste;SP;35;Sudeste;SAO JOSE DO RIO PRETO;JALES;-20.449;-50.88;True;4577;2279;2298;3623;1797;1826;954;482;472
3502705;Apiaí;SP;35;Sudeste;ITAPETININGA;CAPAO BONITO;-24.509;-48.843;True;25463;12698;12629;18316;8969;9271;7147;3729;3358
3502754;Araçariguama;SP;35;Sudeste;MACRO METROPOLITANA PAULISTA;SOROCABA;-23.439;-47.061;True;12291;6117;5898;7911;3939;3962;4380;2178;1936
3502804;Araçatuba;SP;35;Sudeste;ARACATUBA;ARACATUBA;-21.209;-50.433;True;178839;;;;;;;;
3502903;Araçoiaba da Serra;SP;35;Sudeste;MACRO METROPOLITANA PAULISTA;SOROCABA;-23.505;-47.614;True;24022;11982;11848;16449;8098;8159;7573;3884;3689
3503000;Aramina;SP;35;Sudeste;RIBEIRAO PRETO;ITUVERAVA;-20.09;-47.786;True;5019;2501;2492;4475;2201;2248;544;300;244
3503109;Arandu;SP;35;Sudeste;BAURU;AVARE;-23.134;-49.054;True;6013;3025;2988;4506;2212;2294;1507;813;694
3503158;Arapeí;SP;35;Sudeste;VALE DO PARAIBA PAULISTA;BANANAL;-22.674;-44.448;True;2527;1271;1256;1917;941;976;610;330;280
3503208;Araraquara;SP;35;Sudeste;ARARAQUARA;ARARAQUARA;-21.794;-48.176;True;195815;;;;;;;;
3503307;Araras;SP;35;Sudeste;PIRACICABA;LIMEIRA;-22.357;-47.384;True;108689;53534;54280;103830;50981;51989;4859;2553;2291
3503356;Arco-Íris;SP;35;Sudeste;MARILIA;TUPA;-21.773;-50.465;True;2003;1032;971;1182;608;574;821;424;397
3503406;Arealva;SP;35;Sudeste;BAURU;BAURU;-22.029;-48.911;True;7504;3691;3502;5330;2653;2669;2174;1038;833
3503505;Areias;SP;35;Sudeste;VALE DO PARAIBA PAULISTA;BANANAL;-22.58;-44.697;True;3571;1769;1802;2612;1273;1339;959;496;463
3503604;Areiópolis;SP;35;Sudeste;BAURU;BAURU;-22.668;-48.665;True;10630;5556;5044;9588;5016;4564;1042;540;480
3503703;Ariranha;SP;35;Sudeste;SAO JOSE DO RIO PRETO;CATANDUVA;-21.188;-48.787;True;8255;4217;4038;7876;4016;3860;379;201;178
3503802;Artur Nogueira;SP;35;Sudeste;CAMPINAS;MOJI-MIRIM;-22.573;-47.173;True;39457;19648;19650;36278;18011;18137;3179;1637;1513
3503901;Arujá;SP;35;Sudeste;METROPOLITANA DE SAO PAULO;GUARULHOS;-23.396;-46.321;True;72713;35942;36608;69754;34371;35271;2959;1571;1337
3503950;Aspásia;SP;35;Sudeste;SAO JOSE DO RIO PRETO;JALES;-20.159;-50.733;True;1790;903;887;1195;592;603;595;311;284
3504008;Assis;SP;35;Sudeste;ASSIS;ASSIS;-22.662;-50.412;True;92965;44635;47641;89262;42174;46399;3703;2461;1242
3504107;Atibaia;SP;35;Sudeste;MACRO METROPOLITANA PAULISTA;BRAGANCA PAULISTA;-23.117;-46.55;True;119166;58159;60030;107223;52064;54500;11943;6095;5530
3504206;Auriflama;SP;35;Sudeste;SAO JOSE DO RIO PRETO;AURIFLAMA;-20.686;-50.555;True;13760;6831;6870;12638;6257;6369;1122;574;501
3504305;Avaí;SP;35;Sudeste;BAURU;BAURU;-22.147;-49.333;True;4877;2499;2378;3122;1562;1560;1755;937;818
3504404;Avanhandava;SP;35;Sudeste;ARACATUBA;BIRIGUI;-21.461;-49.95;True;10875;6132;4743;9076;4619;4457;1799;1513;286
3504503;Avaré;SP;35;Sudeste;BAURU;AVARE;-23.099;-48.926;True;80026;39717;40298;76484;37811;38662;3542;1906;1636
3504602;Bady Bassitt;SP;35;Sudeste;SAO JOSE DO RIO PRETO;SAO JOSE DO RIO PRETO;-20.918;-49.445;True;13039;6460;6579;12113;5954;6159;926;506;420
3504701;Balbinos;SP;35;Sudeste;BAURU;BAURU;-21.9;-49.357;True;3619;2927;683;1170;573;588;2449;2354;95
3504800;Bálsamo;SP;35;Sudeste;SAO JOSE DO RIO PRETO;SAO JOSE DO RIO PRETO;-20.735;-49.584;True;7767;3812;3911;7035;3408;3583;732;404;328
3504909;Bananal;SP;35;Sudeste;VALE DO PARAIBA PAULISTA;BANANAL;-22.684;-44.323;True;10233;5081;5150;8008;3894;4114;2225;1187;1036
3505005;Barão de Antonina;SP;35;Sudeste;ITAPETININGA;ITAPEVA;-23.627;-49.561;True;2751;1391;1358;1431;706;723;1320;685;635
3505104;Barbosa;SP;35;Sudeste;ARACATUBA;BIRIGUI;-21.267;-49.949;True;6454;3229;3225;5068;2515;2553;1386;714;672
3505203;Bariri;SP;35;Sudeste;BAURU;JAU;-22.074;-48.74;True;30995;15413;15582;29460;14577;14883;1535;836;699
3505302;Barra Bonita;SP;35;Sudeste;BAURU;JAU;-22.495;-48.558;True;35090;17262;17828;34361;16899;17462;729;363;366
3505351;Barra do Chapéu;SP;35;Sudeste;ITAPETININGA;CAPAO BONITO;-24.473;-49.025;True;5077;2562;2263;1678;795;805;3399;1767;1458
3505401;Barra do Turvo;SP;35;Sudeste;LITORAL SUL PAULISTA;REGISTRO;-24.756;-48.505;True;7620;4009;3594;2881;1443;1438;4739;2566;2156
3505500;Barretos;SP;35;Sudeste;RIBEIRAO PRETO;BARRETOS;-20.557;-48.568;True;107988;52340;55481;104263;50359;53743;3725;1981;1738
3505609;Barrinha;SP;35;Sudeste;RIBEIRAO PRETO;RIBEIRAO PRETO;-21.194;-48.164;True;25642;12864;12778;25275;12658;12617;367;206;161
3505708;Barueri;SP;35;Sudeste;METROPOLITANA DE SAO PAULO;OSASCO;-23.511;-46.876;True;252748;;;;;;;;
3505807;Bastos;SP;35;Sudeste;MARILIA;TUPA;-21.922;-50.734;True;20613;10183;10430;17547;8541;9006;3066;1642;1424
3505906;Batatais;SP;35;Sudeste;RIBEIRAO PRETO;BATATAIS;-20.891;-47.585;True;53525;26152;27091;49391;23963;25179;4134;2189;1912
3506003;Bauru;SP;35;Sudeste;BAURU;BAURU;-22.315;-49.061;True;347601;;;;;;;;
3506102;Bebedouro;SP;35;Sudeste;RIBEIRAO PRETO;JABOTICABAL;-20.949;-48.479;True;74865;36648;38217;70801;34507;36294;4064;2141;1923
3506201;Bento de Abreu;SP;35;Sudeste;ARACATUBA;ARACATUBA;-21.271;-50.812;True;2740;1388;1352;2482;1261;1221;258;127;131
3506300;Bernardino de Campos;SP;35;Sudeste;ASSIS;OURINHOS;-23.013;-49.474;True;10487;5077;5295;9358;4536;4822;1129;541;473
3506359;Bertioga;SP;35;Sudeste;METROPOLITANA DE SAO PAULO;SANTOS;-23.854;-46.139;False;39091;18890;18694;38395;18543;18373;696;347;321
3506409;Bilac;SP;35;Sudeste;ARACATUBA;BIRIGUI;-21.403;-50.471;True;6905;3436;3466;6299;3108;3188;606;328;278
3506508;Birigui;SP;35;Sudeste;ARACATUBA;BIRIGUI;-21.289;-50.34;True;103394;50473;52813;100491;48865;51533;2903;1608;1280
3506607;Biritiba-Mirim;SP;35;Sudeste;METROPOLITANA DE SAO PAULO;MOJI DAS CRUZES;-23.573;-46.039;True;27483;13533;13376;23768;11630;11591;3715;1903;1785
3506706;Boa Esperança do Sul;SP;35;Sudeste;ARARAQUARA;ARARAQUARA;-21.993;-48.391;True;13208;6660;6525;11732;5894;5833;1476;766;692
3506805;Bocaina;SP;35;Sudeste;BAURU;JAU;-22.136;-48.518;True;10299;5167;5132;9272;4615;4657;1027;552;475
3506904;Bofete;SP;35;Sudeste;BAURU;BOTUCATU;-23.102;-48.258;True;8565;4391;4112;6088;3042;3041;2477;1349;1071
3507001;Boituva;SP;35;Sudeste;ITAPETININGA;TATUI;-23.283;-47.672;True;40783;20622;20091;37828;19062;18726;2955;1560;1365
3507100;Bom Jesus dos PerdõEs;SP;35;Sudeste;MACRO METROPOLITANA PAULISTA;BRAGANCA PAULISTA;-23.135;-46.465;True;16211;7959;7940;14179;6948;7034;2032;1011;906
3507159;Bom Sucesso de Itararé;SP;35;Sudeste;ITAPETININGA;ITAPEVA;-24.318;-49.144;True;3658;1821;1774;2248;1090;1095;1410;731;679
3507209;Borá;SP;35;Sudeste;ASSIS;ASSIS;-22.27;-50.534;True;804;413;387;639;318;321;165;95;66
3507308;Boracéia;SP;35;Sudeste;BAURU;JAU;-22.193;-48.779;True;4128;2143;1985;3676;1892;1784;452;251;201
3507407;Borborema;SP;35;Sudeste;ARARAQUARA;ARARAQUARA;-21.62;-49.074;True;13752;6847;6783;12034;5962;6016;1718;885;767
3507456;Borebi;SP;35;Sudeste;BAURU;BAURU;-22.569;-48.971;True;2172;1112;1060;1939;981;958;233;131;102
3507506;Botucatu;SP;35;Sudeste;BAURU;BOTUCATU;-22.886;-48.445;True;120800;58426;61595;116184;56029;59437;4616;2397;2158
3507605;Bragança Paulista;SP;35;Sudeste;MACRO METROPOLITANA PAULISTA;BRAGANCA PAULISTA;-22.952;-46.542;True;136286;66462;68885;130461;63418;66177;5825;3044;2708
3507704;Braúna;SP;35;Sudeste;ARACATUBA;BIRIGUI;-21.499;-50.316;True;4728;2405;2288;4024;2018;1971;704;387;317
3507753;Brejo Alegre;SP;35;Sudeste;ARACATUBA;BIRIGUI;-21.166;-50.185;True;2432;1245;1187;2010;1020;990;422;225;197
3507803;Brodowski;SP;35;Sudeste;RIBEIRAO PRETO;RIBEIRAO PRETO;-20.991;-47.659;True;19018;9440;9547;18492;9174;9318;526;266;229
3507902;Brotas;SP;35;Sudeste;PIRACICABA;RIO CLARO;-22.284;-48.127;True;20996;10492;10504;18876;9364;9512;2120;1128;992
3508009;Buri;SP;35;Sudeste;ITAPETININGA;ITAPEVA;-23.798;-48.593;True;17539;9064;8458;13788;7058;6714;3751;2006;1744
3508108;Buritama;SP;35;Sudeste;ARACATUBA;BIRIGUI;-21.066;-50.147;True;14735;7354;7368;13790;6833;6944;945;521;424
3508207;Buritizal;SP;35;Sudeste;RIBEIRAO PRETO;ITUVERAVA;-20.191;-47.708;True;3872;1950;1922;3203;1597;1606;669;353;316
3508306;Cabrália Paulista;SP;35;Sudeste;BAURU;BAURU;-22.456;-49.338;True;4340;2218;2114;3857;1957;1900;483;261;214
3508405;Cabreúva;SP;35;Sudeste;MACRO METROPOLITANA PAULISTA;SOROCABA;-23.308;-47.133;True;38898;19680;19188;32489;16359;16100;6409;3321;3088
3508504;Caçapava;SP;35;Sudeste;VALE DO PARAIBA PAULISTA;SAO JOSE DOS CAMPOS;-23.101;-45.707;True;80458;39834;40338;70077;34340;35489;10381;5494;4849
3508603;Cachoeira Paulista;SP;35;Sudeste;VALE DO PARAIBA PAULISTA;GUARATINGUETA;-22.665;-45.009;True;31674;15516;16094;25862;12478;13323;5812;3038;2771
3508702;Caconde;SP;35;Sudeste;CAMPINAS;SAO JOAO DA BOA VISTA;-21.529;-46.644;True;18552;9379;9172;12328;5971;6356;6224;3408;2816
3508801;Cafelândia;SP;35;Sudeste;BAURU;LINS;-21.803;-49.61;True;16073;7882;8152;13808;6709;7085;2265;1173;1067
3508900;Caiabu;SP;35;Sudeste;PRESIDENTE PRUDENTE;PRESIDENTE PRUDENTE;-22.012;-51.236;True;4011;2049;1962;3228;1629;1599;783;420;363
3509007;Caieiras;SP;35;Sudeste;METROPOLITANA DE SAO PAULO;FRANCO DA ROCHA;-23.364;-46.741;True;81163;39076;40452;78141;37556;39101;3022;1520;1351
3509106;Caiuá;SP;35;Sudeste;PRESIDENTE PRUDENTE;PRESIDENTE PRUDENTE;-21.832;-51.998;True;4953;2622;2331;1921;940;981;3032;1682;1350
3509205;Cajamar;SP;35;Sudeste;METROPOLITANA DE SAO PAULO;OSASCO;-23.356;-46.877;True;58403;28291;28386;54994;26607;26872;3409;1684;1514
3509254;Cajati;SP;35;Sudeste;LITORAL SUL PAULISTA;REGISTRO;-24.736;-48.123;True;28285;14302;13833;19972;9901;9921;8313;4401;3912
3509304;Cajobi;SP;35;Sudeste;SAO JOSE DO RIO PRETO;CATANDUVA;-20.88;-48.809;True;9519;4886;4633;8856;4543;4313;663;343;320
3509403;Cajuru;SP;35;Sudeste;RIBEIRAO PRETO;BATATAIS;-21.275;-47.304;True;22695;11348;11273;20049;9959;10034;2646;1389;1239
3509452;Campina do Monte Alegre;SP;35;Sudeste;ITAPETININGA;ITAPETININGA;-23.592;-48.477;True;5320;2692;2599;4415;2224;2162;905;468;437
3509502;Campinas;SP;35;Sudeste;CAMPINAS;CAMPINAS;-22.906;-47.061;True;1039297;;;;;;;;
3509601;Campo Limpo Paulista;SP;35;Sudeste;MACRO METROPOLITANA PAULISTA;JUNDIAI;-23.206;-46.784;True;69810;34008;34877;68223;33214;34114;1587;794;763
3509700;Campos do Jordão;SP;35;Sudeste;VALE DO PARAIBA PAULISTA;CAMPOS DO JORDAO;-22.739;-45.591;True;44688;21704;22394;44422;21560;22272;266;144;122
3509809;Campos Novos Paulista;SP;35;Sudeste;ASSIS;ASSIS;-22.603;-50.003;True;4651;2412;2216;3560;1826;1731;1091;586;485
3509908;Cananéia;SP;35;Sudeste;LITORAL SUL PAULISTA;REGISTRO;-25.015;-47.927;False;12039;6076;5881;9978;4982;4990;2061;1094;891
3509957;Canas;SP;35;Sudeste;VALE DO PARAIBA PAULISTA;GUARATINGUETA;-22.704;-45.055;True;4318;2170;2146;4077;2045;2030;241;125;116
3510005;Cândido Mota;SP;35;Sudeste;ASSIS;ASSIS;-22.746;-50.387;True;29572;14537;15029;27726;13549;14174;1846;988;855
3510104;Cândido Rodrigues;SP;35;Sudeste;RIBEIRAO PRETO;JABOTICABAL;-21.325;-48.631;True;2655;1317;1335;2144;1052;1092;511;265;243
3510153;Canitar;SP;35;Sudeste;ASSIS;OURINHOS;-23.006;-49.783;True;4265;2152;2113;3990;2001;1989;275;151;124
3510203;Capão Bonito;SP;35;Sudeste;ITAPETININGA;CAPAO BONITO;-24.006;-48.349;True;45275;22503;22582;37710;18601;19070;7565;3902;3512
3510302;Capela do Alto;SP;35;Sudeste;MACRO METROPOLITANA PAULISTA;SOROCABA;-23.471;-47.735;True;15950;8080;7824;13078;6595;6442;2872;1485;1382
3510401;Capivari;SP;35;Sudeste;PIRACICABA;PIRACICABA;-22.995;-47.508;True;43779;21558;22001;36079;17664;18223;7700;3894;3778
3510500;Caraguatatuba;SP;35;Sudeste;VALE DO PARAIBA PAULISTA;CARAGUATATUBA;-23.62;-45.413;False;88815;43726;44863;85105;41786;43093;3710;1940;1770
3510609;Carapicuíba;SP;35;Sudeste;METROPOLITANA DE SAO PAULO;OSASCO;-23.523;-46.836;True;379566;;;;;;;;
3510708;Cardoso;SP;35;Sudeste;SAO JOSE DO RIO PRETO;VOTUPORANGA;-20.082;-49.914;True;11324;5589;5727;10256;5010;5238;1068;579;489
3510807;Casa Branca;SP;35;Sudeste;CAMPINAS;SAO JOAO DA BOA VISTA;-21.774;-47.086;True;27081;14285;12726;22351;10906;11399;4730;3379;1327
3510906;Cássia dos Coqueiros;SP;35;Sudeste;RIBEIRAO PRETO;BATATAIS;-21.283;-47.17;True;2706;1353;1285;1714;862;852;992;491;433
3511003;Castilho;SP;35;Sudeste;ARACATUBA;ANDRADINA;-20.872;-51.488;True;15410;7638;7757;12292;5981;6305;3118;1657;1452
3511102;Catanduva;SP;35;Sudeste;SAO JOSE DO RIO PRETO;CATANDUVA;-21.138;-48.973;True;109362;53153;56209;108166;52533;55633;1196;620;576
3511201;Catiguá;SP;35;Sudeste;SAO JOSE DO RIO PRETO;CATANDUVA;-21.049;-49.058;True;6870;3535;3312;6406;3312;3094;464;223;218
3511300;Cedral;SP;35;Sudeste;SAO JOSE DO RIO PRETO;SAO JOSE DO RIO PRETO;-20.903;-49.268;True;7607;3758;3805;5876;2878;2965;1731;880;840
3511409;Cerqueira César;SP;35;Sudeste;BAURU;AVARE;-23.036;-49.166;True;16276;8057;8216;14549;7136;7413;1727;921;803
3511508;Cerquilho;SP;35;Sudeste;ITAPETININGA;TATUI;-23.165;-47.744;True;34769;17092;17371;33139;16236;16605;1630;856;766
3511607;Cesário Lange;SP;35;Sudeste;ITAPETININGA;TATUI;-23.227;-47.953;True;14005;7241;6610;9326;4737;4557;4679;2504;2053
3511706;Charqueada;SP;35;Sudeste;PIRACICABA;PIRACICABA;-22.51;-47.778;True;14356;7185;7014;13032;6491;6384;1324;694;630
3511904;Clementina;SP;35;Sudeste;ARACATUBA;BIRIGUI;-21.56;-50.449;True;6081;3164;2908;5690;2954;2733;391;210;175
3512001;Colina;SP;35;Sudeste;RIBEIRAO PRETO;BARRETOS;-20.713;-48.541;True;16989;8533;8454;15673;7835;7836;1316;698;618
3512100;Colômbia;SP;35;Sudeste;RIBEIRAO PRETO;BARRETOS;-20.176;-48.689;True;6073;3121;2948;4260;2147;2113;1813;974;835
3512209;Conchal;SP;35;Sudeste;PIRACICABA;LIMEIRA;-22.33;-47.173;True;23352;11445;11295;21641;10535;10525;1711;910;770
3512308;Conchas;SP;35;Sudeste;BAURU;BOTUCATU;-23.015;-48.011;True;15473;7655;7543;11973;5793;5908;3500;1862;1635
3512407;Cordeirópolis;SP;35;Sudeste;PIRACICABA;LIMEIRA;-22.482;-47.457;True;19309;9681;9579;17266;8624;8593;2043;1057;986
3512506;Coroados;SP;35;Sudeste;ARACATUBA;BIRIGUI;-21.352;-50.281;True;4881;2443;2437;3927;1932;1995;954;511;442
3512605;Coronel Macedo;SP;35;Sudeste;ITAPETININGA;ITAPEVA;-23.631;-49.314;True;5277;2722;2555;3961;2020;1941;1316;702;614
3512704;Corumbataí;SP;35;Sudeste;PIRACICABA;RIO CLARO;-22.22;-47.626;True;3935;2012;1915;2124;1041;1075;1811;971;840
3512803;Cosmópolis;SP;35;Sudeste;CAMPINAS;CAMPINAS;-22.646;-47.196;True;53561;26307;26230;49776;24390;24449;3785;1917;1781
3512902;Cosmorama;SP;35;Sudeste;SAO JOSE DO RIO PRETO;VOTUPORANGA;-20.478;-49.778;True;6951;3468;3483;4641;2262;2379;2310;1206;1104
3513009;Cotia;SP;35;Sudeste;METROPOLITANA DE SAO PAULO;ITAPECERICA DA SERRA;-23.604;-46.919;True;172823;;;;;;;;
3513108;Cravinhos;SP;35;Sudeste;RIBEIRAO PRETO;RIBEIRAO PRETO;-21.34;-47.729;True;29377;14700;14578;28593;14281;14213;784;419;365
3513207;Cristais Paulista;SP;35;Sudeste;RIBEIRAO PRETO;FRANCA;-20.397;-47.42;True;7005;3573;3423;4942;2450;2490;2063;1123;933
3513306;Cruzália;SP;35;Sudeste;ASSIS;ASSIS;-22.677;-50.794;True;2368;1163;1199;1544;753;791;824;410;408
3513405;Cruzeiro;SP;35;Sudeste;VALE DO PARAIBA PAULISTA;GUARATINGUETA;-22.576;-44.963;True;76098;37083;38803;74288;36093;37983;1810;990;820
3513504;Cubatão;SP;35;Sudeste;METROPOLITANA DE SAO PAULO;SANTOS;-23.895;-46.425;True;120271;57206;58360;120271;57206;58360;;;
3513603;Cunha;SP;35;Sudeste;VALE DO PARAIBA PAULISTA;PARAIBUNA/PARAITINGA;-23.074;-44.96;True;22951;11594;10824;11902;5859;6034;11049;5735;4790
3513702;Descalvado;SP;35;Sudeste;ARARAQUARA;SAO CARLOS;-21.904;-47.619;True;29533;14613;14910;23854;11674;12170;5679;2939;2740
3513801;Diadema;SP;35;Sudeste;METROPOLITANA DE SAO PAULO;SAO PAULO;-23.686;-46.623;True;386779;;;;;;;;
3513850;Dirce Reis;SP;35;Sudeste;SAO JOSE DO RIO PRETO;JALES;-20.466;-50.606;True;1582;814;768;1281;646;635;301;168;133
3513900;Divinolândia;SP;35;Sudeste;CAMPINAS;SAO JOAO DA BOA VISTA;-21.661;-46.739;True;11246;5585;5661;7532;3623;3909;3714;1962;1752
3514007;Dobrada;SP;35;Sudeste;ARARAQUARA;ARARAQUARA;-21.517;-48.394;True;7664;4020;3644;7503;3939;3564;161;81;80
3514106;Dois Córregos;SP;35;Sudeste;BAURU;JAU;-22.366;-48.38;True;24384;12449;11935;23109;11730;11379;1275;719;556
3514205;Dolcinópolis;SP;35;Sudeste;SAO JOSE DO RIO PRETO;JALES;-20.123;-50.513;True;2181;1118;1063;1884;958;926;297;160;137
3514304;Dourado;SP;35;Sudeste;ARARAQUARA;SAO CARLOS;-22.1;-48.318;True;8751;4317;4216;8146;4007;3961;605;310;255
3514403;Dracena;SP;35;Sudeste;PRESIDENTE PRUDENTE;DRACENA;-21.483;-51.533;True;42107;21014;21074;38134;18386;19736;3973;2628;1338
3514502;Duartina;SP;35;Sudeste;BAURU;BAURU;-22.414;-49.404;True;12381;5962;6330;10797;5152;5623;1584;810;707
3514601;Dumont;SP;35;Sudeste;RIBEIRAO PRETO;RIBEIRAO PRETO;-21.236;-47.973;True;7557;3886;3667;7218;3721;3497;339;165;170
3514700;Echaporã;SP;35;Sudeste;MARILIA;MARILIA;-22.429;-50.201;True;6247;3089;3158;4969;2432;2537;1278;657;621
3514809;Eldorado;SP;35;Sudeste;LITORAL SUL PAULISTA;REGISTRO;-24.52;-48.108;True;14038;7247;6727;6692;3333;3352;7346;3914;3375
3514908;Elias Fausto;SP;35;Sudeste;CAMPINAS;CAMPINAS;-23.043;-47.374;True;14521;7479;7039;11755;5974;5778;2766;1505;1261
3514924;Elisiário;SP;35;Sudeste;SAO JOSE DO RIO PRETO;CATANDUVA;-21.166;-49.112;True;3024;1581;1440;2703;1412;1291;321;169;149
3514957;Embaúba;SP;35;Sudeste;SAO JOSE DO RIO PRETO;CATANDUVA;-20.983;-48.836;True;2391;1257;1134;2011;1062;949;380;195;185
3515004;Embu;SP;35;Sudeste;METROPOLITANA DE SAO PAULO;ITAPECERICA DA SERRA;-23.649;-46.852;True;237318;;;;;;;;
3515103;Embu-Guaçu;SP;35;Sudeste;METROPOLITANA DE SAO PAULO;ITAPECERICA DA SERRA;-23.832;-46.811;True;59083;29592;29445;57399;28709;28644;1684;883;801
3515129;Emilianópolis;SP;35;Sudeste;PRESIDENTE PRUDENTE;PRESIDENTE PRUDENTE;-21.833;-51.483;True;3021;1466;1477;2431;1201;1224;590;265;253
3515152;Engenheiro Coelho;SP;35;Sudeste;CAMPINAS;MOJI-MIRIM;-22.488;-47.215;True;12729;6306;6040;9230;4693;4337;3499;1613;1703
3515186;Espírito Santo do Pinhal;SP;35;Sudeste;CAMPINAS;SAO JOAO DA BOA VISTA;-22.191;-46.741;True;40684;19821;20614;36417;17582;18660;4267;2239;1954
3515194;Espírito Santo do Turvo;SP;35;Sudeste;ASSIS;OURINHOS;-22.692;-49.43;True;4103;2067;2019;3480;1735;1731;623;332;288
3515202;Estrela D'Oeste;SP;35;Sudeste;SAO JOSE DO RIO PRETO;FERNANDOPOLIS;-20.288;-50.401;True;8590;4329;4171;6955;3519;3433;1635;810;738
3515301;Estrela do Norte;SP;35;Sudeste;PRESIDENTE PRUDENTE;PRESIDENTE PRUDENTE;-22.488;-51.66;True;2454;1261;1186;1845;947;898;609;314;288
3515350;Euclides da Cunha Paulista;SP;35;Sudeste;PRESIDENTE PRUDENTE;PRESIDENTE PRUDENTE;-22.561;-52.59;True;9923;5074;4849;6093;2957;3136;3830;2117;1713
3515400;Fartura;SP;35;Sudeste;ASSIS;OURINHOS;-23.388;-49.51;True;14601;7172;7407;11347;5468;5868;3254;1704;1539
3515509;Fernandópolis;SP;35;Sudeste;SAO JOSE DO RIO PRETO;FERNANDOPOLIS;-20.284;-50.246;True;61392;29981;31302;59431;28964;30370;1961;1017;932
3515608;Fernando Prestes;SP;35;Sudeste;RIBEIRAO PRETO;JABOTICABAL;-21.264;-48.685;True;5212;2601;2604;4353;2142;2211;859;459;393
3515657;Fernão;SP;35;Sudeste;MARILIA;MARILIA;-22.359;-49.521;True;1457;750;707;808;402;406;649;348;301
3515707;Ferraz de Vasconcelos;SP;35;Sudeste;METROPOLITANA DE SAO PAULO;MOJI DAS CRUZES;-23.541;-46.369;True;168897;;;;;;;;
3515806;Flora Rica;SP;35;Sudeste;PRESIDENTE PRUDENTE;ADAMANTINA;-21.676;-51.384;True;2019;1036;983;1614;817;797;405;219;186
3515905;Floreal;SP;35;Sudeste;SAO JOSE DO RIO PRETO;AURIFLAMA;-20.677;-50.145;True;2907;1449;1458;2401;1175;1226;506;274;232
3516002;Flórida Paulista;SP;35;Sudeste;PRESIDENTE PRUDENTE;ADAMANTINA;-21.615;-51.174;True;12660;6871;5779;9941;4950;4991;2719;1921;788
3516101;Florínia;SP;35;Sudeste;ASSIS;ASSIS;-22.903;-50.738;True;2860;1413;1447;2520;1228;1292;340;185;155
3516200;Franca;SP;35;Sudeste;RIBEIRAO PRETO;FRANCA;-20.539;-47.401;True;319094;;;;;;;;
3516309;Francisco Morato;SP;35;Sudeste;METROPOLITANA DE SAO PAULO;FRANCO DA ROCHA;-23.282;-46.745;True;146634;72021;73094;146439;71921;72999;195;100;95
3516408;Franco da Rocha;SP;35;Sudeste;METROPOLITANA DE SAO PAULO;FRANCO DA ROCHA;-23.322;-46.727;True;121451;61726;57936;113610;55310;56605;7841;6416;1331
3516507;Gabriel Monteiro;SP;35;Sudeste;ARACATUBA;BIRIGUI;-21.531;-50.555;True;2638;1331;1294;2158;1079;1066;480;252;228
3516606;Gália;SP;35;Sudeste;MARILIA;MARILIA;-22.291;-49.553;True;6812;3381;3395;5113;2472;2608;1699;909;787
3516705;Garça;SP;35;Sudeste;MARILIA;MARILIA;-22.211;-49.656;True;42218;20547;21636;37765;18132;19621;4453;2415;2015
3516804;Gastão Vidigal;SP;35;Sudeste;SAO JOSE DO RIO PRETO;AURIFLAMA;-20.799;-50.187;True;3863;2113;1750;3539;1950;1589;324;163;161
3516853;Gavião Peixoto;SP;35;Sudeste;ARARAQUARA;ARARAQUARA;-21.839;-48.495;True;4103;2101;1963;3275;1686;1573;828;415;390
3516903;General Salgado;SP;35;Sudeste;SAO JOSE DO RIO PRETO;AURIFLAMA;-20.648;-50.361;True;10626;5416;5210;8928;4493;4435;1698;923;775
3517000;Getulina;SP;35;Sudeste;BAURU;LINS;-21.799;-49.929;True;10515;5836;4599;7300;3537;3691;3215;2299;908
3517109;Glicério;SP;35;Sudeste;ARACATUBA;BIRIGUI;-21.384;-50.211;True;4398;2180;2161;3273;1621;1652;1125;559;509
3517208;Guaiçara;SP;35;Sudeste;BAURU;LINS;-21.622;-49.799;True;10357;5193;5163;9219;4573;4645;1138;620;518
3517307;Guaimbê;SP;35;Sudeste;BAURU;LINS;-21.91;-49.897;True;4752;2361;2391;4123;2024;2099;629;337;292
3517406;Guaíra;SP;35;Sudeste;RIBEIRAO PRETO;SAO JOAQUIM DA BARRA;-20.318;-48.311;True;36544;18221;18323;34548;17151;17397;1996;1070;926
3517505;Guapiaçu;SP;35;Sudeste;SAO JOSE DO RIO PRETO;SAO JOSE DO RIO PRETO;-20.795;-49.22;True;16392;8241;8146;14152;7073;7074;2240;1168;1072
3517604;Guapiara;SP;35;Sudeste;ITAPETININGA;CAPAO BONITO;-24.185;-48.533;True;20056;9581;9194;7193;3513;3632;12863;6068;5562
3517703;Guará;SP;35;Sudeste;RIBEIRAO PRETO;ITUVERAVA;-20.428;-47.824;True;18611;8959;9005;17935;8573;8715;676;386;290
3517802;Guaraçaí;SP;35;Sudeste;ARACATUBA;ANDRADINA;-21.028;-51.207;True;8505;4267;4223;6699;3291;3408;1806;976;815
3517901;Guaraci;SP;35;Sudeste;SAO JOSE DO RIO PRETO;SAO JOSE DO RIO PRETO;-20.499;-48.945;True;9045;4526;4504;7977;3969;4004;1068;557;500
3518008;Guarani D'Oeste;SP;35;Sudeste;SAO JOSE DO RIO PRETO;FERNANDOPOLIS;-20.075;-50.339;True;1963;1002;961;1718;864;854;245;138;107
3518107;Guarantã;SP;35;Sudeste;BAURU;BAURU;-21.895;-49.59;True;6410;3221;3179;4880;2408;2462;1530;813;717
3518206;Guararapes;SP;35;Sudeste;ARACATUBA;ARACATUBA;-21.261;-50.643;True;28662;14062;14591;26623;12991;13623;2039;1071;968
3518305;Guararema;SP;35;Sudeste;METROPOLITANA DE SAO PAULO;MOJI DAS CRUZES;-23.415;-46.035;True;24854;12311;12076;21014;10291;10368;3840;2020;1708
3518404;Guaratinguetá;SP;35;Sudeste;VALE DO PARAIBA PAULISTA;GUARATINGUETA;-22.816;-45.193;True;107895;51272;54564;103094;48756;52375;4801;2516;2189
3518503;Guareí;SP;35;Sudeste;ITAPETININGA;ITAPETININGA;-23.373;-48.184;True;13202;7763;5439;7047;3624;3423;6155;4139;2016
3518602;Guariba;SP;35;Sudeste;RIBEIRAO PRETO;JABOTICABAL;-21.36;-48.228;True;32664;16350;16314;32000;15999;16001;664;351;313
3518701;Guarujá;SP;35;Sudeste;METROPOLITANA DE SAO PAULO;SANTOS;-23.993;-46.256;True;296150;;;;;;;;
3518800;Guarulhos;SP;35;Sudeste;METROPOLITANA DE SAO PAULO;GUARULHOS;-23.463;-46.533;True;1236192;;;;;;;;
3518859;Guatapará;SP;35;Sudeste;RIBEIRAO PRETO;RIBEIRAO PRETO;-21.497;-48.038;True;6217;3208;2975;4115;2084;1997;2102;1124;978
3518909;Guzolândia;SP;35;Sudeste;SAO JOSE DO RIO PRETO;AURIFLAMA;-20.65;-50.662;True;4616;2416;2200;3733;1927;1806;883;489;394
3519006;Herculândia;SP;35;Sudeste;MARILIA;TUPA;-22.004;-50.385;True;8573;4315;4258;7742;3862;3880;831;453;378
3519055;Holambra;SP;35;Sudeste;CAMPINAS;CAMPINAS;-22.633;-47.056;True;9111;4530;4467;6597;3222;3286;2514;1308;1181
3519071;Hortolândia;SP;35;Sudeste;CAMPINAS;CAMPINAS;-22.858;-47.22;True;190781;;;;;;;;
3519105;Iacanga;SP;35;Sudeste;BAURU;BAURU;-21.89;-49.025;True;9074;4557;4498;8032;4007;4025;1042;550;473
3519204;Iacri;SP;35;Sudeste;MARILIA;TUPA;-21.858;-50.689;True;6677;3441;3236;5187;2645;2542;1490;796;694
3519253;Iaras;SP;35;Sudeste;BAURU;AVARE;-22.871;-49.163;True;4777;2977;1800;2629;1317;1312;2148;1660;488
3519303;Ibaté;SP;35;Sudeste;ARARAQUARA;SAO CARLOS;-21.955;-47.997;True;28040;14335;13607;27132;13862;13174;908;473;433
3519402;Ibirá;SP;35;Sudeste;SAO JOSE DO RIO PRETO;SAO JOSE DO RIO PRETO;-21.08;-49.241;True;10379;5173;5206;9588;4760;4828;791;413;378
3519501;Ibirarema;SP;35;Sudeste;ASSIS;ASSIS;-22.818;-50.073;True;6617;3321;3289;6090;3043;3046;527;278;243
3519600;Ibitinga;SP;35;Sudeste;ARARAQUARA;ARARAQUARA;-21.758;-48.829;True;49951;24676;25272;47706;23450;24253;2245;1226;1019
3519709;Ibiúna;SP;35;Sudeste;MACRO METROPOLITANA PAULISTA;PIEDADE;-23.656;-47.223;True;64832;32425;31366;23823;11287;11882;41009;21138;19484
3519808;Icém;SP;35;Sudeste;SAO JOSE DO RIO PRETO;SAO JOSE DO RIO PRETO;-20.342;-49.195;True;6429;3368;3024;5327;2775;2515;1102;593;509
3519907;Iepê;SP;35;Sudeste;ASSIS;ASSIS;-22.661;-51.076;True;7487;3723;3761;6453;3192;3261;1034;531;500
3520004;Igaraçu do Tietê;SP;35;Sudeste;BAURU;JAU;-22.509;-48.558;True;23085;11629;11456;22976;11573;11403;109;56;53
3520103;Igarapava;SP;35;Sudeste;RIBEIRAO PRETO;ITUVERAVA;-20.038;-47.747;True;26862;13426;13402;25163;12506;12634;1699;920;768
3520202;Igaratá;SP;35;Sudeste;VALE DO PARAIBA PAULISTA;SAO JOSE DOS CAMPOS;-23.204;-46.156;True;8537;4428;4105;6629;3378;3247;1908;1050;858
3520301;Iguape;SP;35;Sudeste;LITORAL SUL PAULISTA;REGISTRO;-24.708;-47.555;True;28977;14503;14128;23172;11523;11537;5805;2980;2591
3520400;Ilhabela;SP;35;Sudeste;VALE DO PARAIBA PAULISTA;CARAGUATATUBA;-23.778;-45.358;False;23886;12175;11658;23686;12070;11563;200;105;95
3520426;Ilha Comprida;SP;35;Sudeste;LITORAL SUL PAULISTA;REGISTRO;-24.741;-47.54;True;8875;4438;4422;8875;4438;4422;;;
3520442;Ilha Solteira;SP;35;Sudeste;ARACATUBA;ANDRADINA;-20.433;-51.343;True;24181;11748;12322;22776;11023;11645;1405;725;677
3520509;Indaiatuba;SP;35;Sudeste;CAMPINAS;CAMPINAS;-23.09;-47.218;True;173508;;;;;;;;
3520608;Indiana;SP;35;Sudeste;PRESIDENTE PRUDENTE;PRESIDENTE PRUDENTE;-22.174;-51.252;True;4682;2346;2281;3843;1931;1906;839;415;375
3520707;Indiaporã;SP;35;Sudeste;SAO JOSE DO RIO PRETO;FERNANDOPOLIS;-19.98;-50.29;True;3880;1953;1922;3185;1600;1585;695;353;337
3520806;Inúbia Paulista;SP;35;Sudeste;PRESIDENTE PRUDENTE;ADAMANTINA;-21.77;-50.962;True;3595;1811;1784;3130;1564;1566;465;247;218
3520905;Ipaussu;SP;35;Sudeste;ASSIS;OURINHOS;-23.057;-49.626;True;12964;6463;6495;11951;5929;6016;1013;534;479
3521002;Iperó;SP;35;Sudeste;MACRO METROPOLITANA PAULISTA;SOROCABA;-23.35;-47.689;True;24239;12267;11562;16168;7982;7959;8071;4285;3603
3521101;Ipeúna;SP;35;Sudeste;PIRACICABA;RIO CLARO;-22.436;-47.719;True;5164;2665;2499;4331;2203;2128;833;462;371
3521150;Ipiguá;SP;35;Sudeste;SAO JOSE DO RIO PRETO;SAO JOSE DO RIO PRETO;-20.657;-49.387;True;3925;1908;1872;2484;1227;1220;1441;681;652
3521200;Iporanga;SP;35;Sudeste;ITAPETININGA;CAPAO BONITO;-24.586;-48.593;True;4603;2378;2182;2446;1211;1232;2157;1167;950
3521309;Ipuã;SP;35;Sudeste;RIBEIRAO PRETO;SAO JOAQUIM DA BARRA;-20.438;-48.012;True;14344;7546;6796;13693;7194;6499;651;352;297
3521408;Iracemápolis;SP;35;Sudeste;PIRACICABA;LIMEIRA;-22.581;-47.519;True;18026;9042;8883;17521;8772;8655;505;270;228
3521507;Irapuã;SP;35;Sudeste;SAO JOSE DO RIO PRETO;NOVO HORIZONTE;-21.279;-49.409;True;6710;3446;3232;5816;2966;2827;894;480;405
3521606;Irapuru;SP;35;Sudeste;PRESIDENTE PRUDENTE;ADAMANTINA;-21.571;-51.345;True;7556;4156;3400;5563;2715;2848;1993;1441;552
3521705;Itaberá;SP;35;Sudeste;ITAPETININGA;ITAPEVA;-23.862;-49.137;True;17576;8719;8706;10988;5341;5644;6588;3378;3062
3521804;Itaí;SP;35;Sudeste;BAURU;AVARE;-23.418;-49.091;True;22617;11910;10663;17697;8784;8909;4920;3126;1754
3521903;Itajobi;SP;35;Sudeste;SAO JOSE DO RIO PRETO;NOVO HORIZONTE;-21.318;-49.054;True;14182;7157;7025;11774;5872;5902;2408;1285;1123
3522000;Itaju;SP;35;Sudeste;BAURU;JAU;-21.981;-48.805;True;2624;1367;1257;1738;895;843;886;472;414
3522109;Itanhaém;SP;35;Sudeste;LITORAL SUL PAULISTA;ITANHAEM;-24.183;-46.789;True;80778;38514;40219;79989;38089;39861;789;425;358
3522158;Itaóca;SP;35;Sudeste;ITAPETININGA;CAPAO BONITO;-24.64;-48.843;True;3087;1554;1455;1717;810;838;1370;744;617
3522208;Itapecerica da Serra;SP;35;Sudeste;METROPOLITANA DE SAO PAULO;ITAPECERICA DA SERRA;-23.717;-46.849;True;148728;71924;72877;147565;71395;72362;1163;529;515
3522307;Itapetininga;SP;35;Sudeste;ITAPETININGA;ITAPETININGA;-23.592;-48.053;True;138450;69670;68738;125310;61288;63991;13140;8382;4747
3522406;Itapeva;SP;35;Sudeste;ITAPETININGA;ITAPEVA;-23.982;-48.876;True;85537;41800;42852;61003;29395;31133;24534;12405;11719
3522505;Itapevi;SP;35;Sudeste;METROPOLITANA DE SAO PAULO;OSASCO;-23.549;-46.934;True;193686;;;;;;;;
3522604;Itapira;SP;35;Sudeste;CAMPINAS;MOJI-MIRIM;-22.436;-46.822;True;68187;33820;34077;64686;31858;32574;3501;1962;1503
3522653;Itapirapuã Paulista;SP;35;Sudeste;ITAPETININGA;CAPAO BONITO;-24.574;-49.168;True;3723;1907;1669;1803;860;796;1920;1047;873
3522703;Itápolis;SP;35;Sudeste;ARARAQUARA;ARARAQUARA;-21.596;-48.813;True;38633;19074;19478;34597;16948;17575;4036;2126;1903
3522802;Itaporanga;SP;35;Sudeste;ITAPETININGA;ITAPEVA;-23.708;-49.49;True;14284;7159;7120;10760;5263;5492;3524;1896;1628
3522901;Itapuí;SP;35;Sudeste;BAURU;JAU;-22.233;-48.719;True;11605;5914;5691;11025;5585;5440;580;329;251
3523008;Itapura;SP;35;Sudeste;ARACATUBA;ANDRADINA;-20.646;-51.509;True;3812;1932;1843;3222;1616;1589;590;316;254
3523107;Itaquaquecetuba;SP;35;Sudeste;METROPOLITANA DE SAO PAULO;MOJI DAS CRUZES;-23.486;-46.348;True;334914;;;;;;;;
3523206;Itararé;SP;35;Sudeste;ITAPETININGA;ITAPEVA;-24.115;-49.341;True;48732;23956;24753;44935;21942;22982;3797;2014;1771
3523305;Itariri;SP;35;Sudeste;LITORAL SUL PAULISTA;ITANHAEM;-24.289;-47.174;True;15115;7571;7468;14069;6972;7021;1046;599;447
3523404;Itatiba;SP;35;Sudeste;MACRO METROPOLITANA PAULISTA;BRAGANCA PAULISTA;-23.006;-46.839;True;91479;45051;45925;75941;37172;38426;15538;7879;7499
3523503;Itatinga;SP;35;Sudeste;BAURU;AVARE;-23.102;-48.616;True;17570;8956;8542;15698;7949;7715;1872;1007;827
3523602;Itirapina;SP;35;Sudeste;PIRACICABA;RIO CLARO;-22.253;-47.823;True;13889;8157;5730;12547;7413;5132;1342;744;598
3523701;Itirapuã;SP;35;Sudeste;RIBEIRAO PRETO;FRANCA;-20.641;-47.219;True;5614;2881;2733;4778;2406;2372;836;475;361
3523800;Itobi;SP;35;Sudeste;CAMPINAS;SAO JOAO DA BOA VISTA;-21.737;-46.975;True;7444;3881;3563;6833;3547;3286;611;334;277
3523909;Itu;SP;35;Sudeste;MACRO METROPOLITANA PAULISTA;SOROCABA;-23.264;-47.299;True;147157;72700;73943;136715;67247;69084;10442;5453;4859
3524006;Itupeva;SP;35;Sudeste;MACRO METROPOLITANA PAULISTA;JUNDIAI;-23.153;-47.058;True;36766;18404;17799;30185;15035;14669;6581;3369;3130
3524105;Ituverava;SP;35;Sudeste;RIBEIRAO PRETO;ITUVERAVA;-20.339;-47.781;True;38539;19113;19426;36247;17899;18348;2292;1214;1078
3524204;Jaborandi;SP;35;Sudeste;RIBEIRAO PRETO;SAO JOAQUIM DA BARRA;-20.688;-48.413;True;6462;3286;3176;6047;3063;2984;415;223;192
3524303;Jaboticabal;SP;35;Sudeste;RIBEIRAO PRETO;JABOTICABAL;-21.255;-48.322;True;69624;33897;35726;66919;32510;34409;2705;1387;1317
3524402;Jacareí;SP;35;Sudeste;VALE DO PARAIBA PAULISTA;SAO JOSE DOS CAMPOS;-23.305;-45.966;True;207028;;;;;;;;
3524501;Jaci;SP;35;Sudeste;SAO JOSE DO RIO PRETO;SAO JOSE DO RIO PRETO;-20.882;-49.57;True;5008;2534;2435;4259;2141;2118;749;393;317
3524600;Jacupiranga;SP;35;Sudeste;LITORAL SUL PAULISTA;REGISTRO;-24.693;-48.002;True;16112;8235;7848;8485;4166;4315;7627;4069;3533
3524709;Jaguariúna;SP;35;Sudeste;CAMPINAS;CAMPINAS;-22.706;-46.986;True;36804;18370;18297;34313;17050;17161;2491;1320;1136
3524808;Jales;SP;35;Sudeste;SAO JOSE DO RIO PRETO;JALES;-20.269;-50.546;True;47649;23480;24146;44664;21903;22749;2985;1577;1397
3524907;Jambeiro;SP;35;Sudeste;VALE DO PARAIBA PAULISTA;PARAIBUNA/PARAITINGA;-23.254;-45.688;True;4968;2569;2399;2350;1187;1163;2618;1382;1236
3525003;Jandira;SP;35;Sudeste;METROPOLITANA DE SAO PAULO;OSASCO;-23.528;-46.903;True;103531;50293;52006;103531;50293;52006;;;
3525102;Jardinópolis;SP;35;Sudeste;RIBEIRAO PRETO;RIBEIRAO PRETO;-21.018;-47.764;True;34611;17311;17259;32843;16396;16447;1768;915;812
3525201;Jarinu;SP;35;Sudeste;MACRO METROPOLITANA PAULISTA;BRAGANCA PAULISTA;-23.101;-46.728;True;20606;10223;9883;16148;7884;7814;4458;2339;2069
3525300;Jaú;SP;35;Sudeste;BAURU;JAU;-22.296;-48.558;True;125469;61809;63648;121229;59536;61681;4240;2273;1967
3525409;Jeriquara;SP;35;Sudeste;RIBEIRAO PRETO;FRANCA;-20.311;-47.589;True;3153;1643;1510;2456;1259;1197;697;384;313
3525508;Joanópolis;SP;35;Sudeste;MACRO METROPOLITANA PAULISTA;BRAGANCA PAULISTA;-22.93;-46.276;True;10671;5230;5104;10671;5230;5104;;;
3525607;João Ramalho;SP;35;Sudeste;PRESIDENTE PRUDENTE;PRESIDENTE PRUDENTE;-22.25;-50.768;True;4092;2098;1994;3463;1759;1704;629;339;290
3525706;José Bonifácio;SP;35;Sudeste;SAO JOSE DO RIO PRETO;SAO JOSE DO RIO PRETO;-21.053;-49.688;True;30639;15308;15311;27739;13780;13956;2900;1528;1355
3525805;Júlio Mesquita;SP;35;Sudeste;BAURU;LINS;-22.009;-49.787;True;4318;2115;2202;4040;1982;2057;278;133;145
3525854;Jumirim;SP;35;Sudeste;PIRACICABA;PIRACICABA;-23.087;-47.784;True;2205;1111;1053;1241;604;610;964;507;443
3525904;Jundiaí;SP;35;Sudeste;MACRO METROPOLITANA PAULISTA;JUNDIAI;-23.186;-46.884;True;342983;;;;;;;;
3526001;Junqueirópolis;SP;35;Sudeste;PRESIDENTE PRUDENTE;DRACENA;-21.515;-51.434;True;18628;9760;8665;15181;7495;7607;3447;2265;1058
3526100;Juquiá;SP;35;Sudeste;LITORAL SUL PAULISTA;REGISTRO;-24.321;-47.635;True;19352;9633;9466;12346;6021;6305;7006;3612;3161
3526209;Juquitiba;SP;35;Sudeste;METROPOLITANA DE SAO PAULO;ITAPECERICA DA SERRA;-23.932;-47.068;True;27777;13580;13042;21582;10333;10286;6195;3247;2756
3526308;Lagoinha;SP;35;Sudeste;VALE DO PARAIBA PAULISTA;PARAIBUNA/PARAITINGA;-23.091;-45.19;True;4798;2423;2297;3034;1493;1525;1764;930;772
3526407;Laranjal Paulista;SP;35;Sudeste;ITAPETININGA;TATUI;-23.05;-47.837;True;24454;12133;12318;22379;11028;11351;2075;1105;967
3526506;Lavínia;SP;35;Sudeste;ARACATUBA;ARACATUBA;-21.168;-51.04;True;7984;5482;2481;4166;2040;2110;3818;3442;371
3526605;Lavrinhas;SP;35;Sudeste;VALE DO PARAIBA PAULISTA;GUARATINGUETA;-22.571;-44.902;True;6543;3317;3221;5993;3014;2979;550;303;242
3526704;Leme;SP;35;Sudeste;PIRACICABA;LIMEIRA;-22.186;-47.39;True;84406;42401;41559;82085;41189;40458;2321;1212;1101
3526803;Lençóis Paulista;SP;35;Sudeste;BAURU;BAURU;-22.599;-48.8;True;59366;29593;29739;57830;28773;29023;1536;820;716
3526902;Limeira;SP;35;Sudeste;PIRACICABA;LIMEIRA;-22.565;-47.402;True;272734;;;;;;;;
3527009;Lindóia;SP;35;Sudeste;CAMPINAS;AMPARO;-22.523;-46.65;True;5657;2767;2882;5657;2767;2882;;;
3527108;Lins;SP;35;Sudeste;BAURU;LINS;-21.679;-49.743;True;69279;33406;35475;67898;32661;34845;1381;745;630
3527207;Lorena;SP;35;Sudeste;VALE DO PARAIBA PAULISTA;GUARATINGUETA;-22.731;-45.125;True;79317;37133;39758;76928;35882;38698;2389;1251;1060
3527256;Lourdes;SP;35;Sudeste;ARACATUBA;BIRIGUI;-20.967;-50.224;True;1974;990;983;1620;798;821;354;192;162
3527306;Louveira;SP;35;Sudeste;MACRO METROPOLITANA PAULISTA;JUNDIAI;-23.086;-46.951;True;29760;15065;14636;27799;14090;13650;1961;975;986
3527405;Lucélia;SP;35;Sudeste;PRESIDENTE PRUDENTE;ADAMANTINA;-21.72;-51.019;True;19212;10095;9117;16713;8208;8505;2499;1887;612
3527504;Lucianópolis;SP;35;Sudeste;BAURU;BAURU;-22.431;-49.523;True;2299;1166;1131;1756;870;884;543;296;247
3527603;Luís Antônio;SP;35;Sudeste;RIBEIRAO PRETO;RIBEIRAO PRETO;-21.555;-47.704;True;10272;5262;4942;9783;5007;4708;489;255;234
3527702;Luiziânia;SP;35;Sudeste;ARACATUBA;BIRIGUI;-21.676;-50.327;True;4763;2250;2234;4214;1994;2000;549;256;234
3527801;Lupércio;SP;35;Sudeste;MARILIA;MARILIA;-22.415;-49.817;True;4238;2081;2152;3727;1816;1906;511;265;246
3527900;Lutécia;SP;35;Sudeste;ASSIS;ASSIS;-22.34;-50.392;True;2794;1412;1362;2132;1071;1056;662;341;306
3528007;Macatuba;SP;35;Sudeste;BAURU;JAU;-22.502;-48.711;True;16173;8115;8052;15704;7862;7842;469;253;210
3528106;Macaubal;SP;35;Sudeste;SAO JOSE DO RIO PRETO;NHANDEARA;-20.806;-49.964;True;7396;3792;3604;6447;3245;3202;949;547;402
3528205;Macedônia;SP;35;Sudeste;SAO JOSE DO RIO PRETO;FERNANDOPOLIS;-20.146;-50.194;True;3411;1697;1714;2515;1228;1287;896;469;427
3528304;Magda;SP;35;Sudeste;SAO JOSE DO RIO PRETO;AURIFLAMA;-20.644;-50.226;True;3154;1599;1547;2577;1300;1277;577;299;270
3528403;Mairinque;SP;35;Sudeste;MACRO METROPOLITANA PAULISTA;SOROCABA;-23.546;-47.183;True;41508;20177;20420;35875;17268;17769;5633;2909;2651
3528502;Mairiporã;SP;35;Sudeste;METROPOLITANA DE SAO PAULO;FRANCO DA ROCHA;-23.319;-46.587;True;71754;35107;34895;58226;28164;28479;13528;6943;6416
3528601;Manduri;SP;35;Sudeste;ASSIS;OURINHOS;-23.003;-49.322;True;8651;4330;4227;7428;3707;3718;1223;623;509
3528700;Marabá Paulista;SP;35;Sudeste;PRESIDENTE PRUDENTE;PRESIDENTE PRUDENTE;-22.108;-51.963;True;5193;2926;1834;2319;1105;1083;2874;1821;751
3528809;Maracaí;SP;35;Sudeste;ASSIS;ASSIS;-22.611;-50.667;True;13163;6631;6497;11630;5822;5773;1533;809;724
3528858;Marapoama;SP;35;Sudeste;SAO JOSE DO RIO PRETO;NOVO HORIZONTE;-21.259;-49.129;True;2556;1310;1246;2075;1066;1009;481;244;237
3528908;Mariápolis;SP;35;Sudeste;PRESIDENTE PRUDENTE;ADAMANTINA;-21.799;-51.181;True;3786;1937;1849;2996;1510;1486;790;427;363
3529005;Marília;SP;35;Sudeste;MARILIA;MARILIA;-22.214;-49.946;True;218113;;;;;;;;
3529104;Marinópolis;SP;35;Sudeste;SAO JOSE DO RIO PRETO;JALES;-20.441;-50.823;True;2114;1070;1044;1645;814;831;469;256;213
3529203;Martinópolis;SP;35;Sudeste;PRESIDENTE PRUDENTE;PRESIDENTE PRUDENTE;-22.146;-51.171;True;23983;12389;11423;19797;9670;10124;4186;2719;1299
3529302;Matão;SP;35;Sudeste;ARARAQUARA;ARARAQUARA;-21.603;-48.366;True;74407;36756;37184;72894;35977;36492;1513;779;692
3529401;Mauá;SP;35;Sudeste;METROPOLITANA DE SAO PAULO;SAO PAULO;-23.668;-46.461;True;402643;;;;;;;;
3529500;Mendonça;SP;35;Sudeste;SAO JOSE DO RIO PRETO;SAO JOSE DO RIO PRETO;-21.167;-49.581;True;3980;2019;1957;3233;1634;1599;747;385;358
3529609;Meridiano;SP;35;Sudeste;SAO JOSE DO RIO PRETO;FERNANDOPOLIS;-20.359;-50.173;True;3857;1932;1904;2563;1260;1287;1294;672;617
3529658;Mesópolis;SP;35;Sudeste;SAO JOSE DO RIO PRETO;JALES;-19.966;-50.638;True;1768;895;873;1306;658;648;462;237;225
3529708;Miguelópolis;SP;35;Sudeste;RIBEIRAO PRETO;SAO JOAQUIM DA BARRA;-20.179;-48.032;True;19972;10157;9802;17898;9061;8830;2074;1096;972
3529807;Mineiros do Tietê;SP;35;Sudeste;BAURU;JAU;-22.409;-48.451;True;11760;5924;5836;11302;5680;5622;458;244;214
3529906;Miracatu;SP;35;Sudeste;LITORAL SUL PAULISTA;REGISTRO;-24.281;-47.46;True;22796;11630;11166;11169;5403;5766;11627;6227;5400
3530003;Mira Estrela;SP;35;Sudeste;SAO JOSE DO RIO PRETO;FERNANDOPOLIS;-19.979;-50.137;True;2576;1303;1265;1817;905;906;759;398;359
3530102;Mirandópolis;SP;35;Sudeste;ARACATUBA;ANDRADINA;-21.134;-51.102;True;25849;13422;12085;22578;11750;10528;3271;1672;1557
3530201;Mirante do Paranapanema;SP;35;Sudeste;PRESIDENTE PRUDENTE;PRESIDENTE PRUDENTE;-22.292;-51.906;True;17128;8746;8372;9603;4680;4923;7525;4066;3449
3530300;Mirassol;SP;35;Sudeste;SAO JOSE DO RIO PRETO;SAO JOSE DO RIO PRETO;-20.819;-49.521;True;51660;25259;26105;50103;24436;25380;1557;823;725
3530409;Mirassolândia;SP;35;Sudeste;SAO JOSE DO RIO PRETO;SAO JOSE DO RIO PRETO;-20.617;-49.464;True;4099;2089;2010;3306;1651;1655;793;438;355
3530508;Mococa;SP;35;Sudeste;CAMPINAS;SAO JOAO DA BOA VISTA;-21.468;-47.005;True;66086;32968;32986;61081;30382;30679;5005;2586;2307
3530607;Moji das Cruzes;SP;35;Sudeste;METROPOLITANA DE SAO PAULO;MOJI DAS CRUZES;-23.523;-46.188;True;362991;;;;;;;;
3530706;Mogi Guaçu;SP;35;Sudeste;CAMPINAS;MOJI-MIRIM;-22.372;-46.942;True;131870;65745;66065;123600;61410;62150;8270;4335;3915
3530805;Moji-Mirim;SP;35;Sudeste;CAMPINAS;MOJI-MIRIM;-22.432;-46.958;True;84176;41359;42527;78561;38379;39950;5615;2980;2577
3530904;Mombuca;SP;35;Sudeste;PIRACICABA;PIRACICABA;-22.929;-47.566;True;3280;1636;1578;2682;1318;1309;598;318;269
3531001;MonçõEs;SP;35;Sudeste;SAO JOSE DO RIO PRETO;NHANDEARA;-20.85;-50.092;True;2054;1031;945;1721;897;824;333;134;121
3531100;Mongaguá;SP;35;Sudeste;LITORAL SUL PAULISTA;ITANHAEM;-24.087;-46.629;True;40423;19164;19045;40294;19084;18996;129;80;49
3531209;Monte Alegre do Sul;SP;35;Sudeste;CAMPINAS;AMPARO;-22.682;-46.681;True;6957;3450;3489;3575;1743;1814;3382;1707;1675
3531308;Monte Alto;SP;35;Sudeste;RIBEIRAO PRETO;JABOTICABAL;-21.261;-48.496;True;44085;21799;22272;42471;20966;21498;1614;833;774
3531407;Monte Aprazível;SP;35;Sudeste;SAO JOSE DO RIO PRETO;NHANDEARA;-20.773;-49.714;True;19745;9823;9922;17733;8750;8983;2012;1073;939
3531506;Monte Azul Paulista;SP;35;Sudeste;RIBEIRAO PRETO;JABOTICABAL;-20.907;-48.641;True;19187;9630;9557;17720;8876;8844;1467;754;713
3531605;Monte Castelo;SP;35;Sudeste;PRESIDENTE PRUDENTE;DRACENA;-21.299;-51.569;True;4014;1986;1973;3064;1468;1547;950;518;426
3531704;Monteiro Lobato;SP;35;Sudeste;VALE DO PARAIBA PAULISTA;CAMPOS DO JORDAO;-22.957;-45.84;True;3994;2056;1927;1652;820;830;2342;1236;1097
3531803;Monte Mor;SP;35;Sudeste;CAMPINAS;CAMPINAS;-22.947;-47.316;True;42824;20912;20991;38651;19067;19197;4173;1845;1794
3531902;Morro Agudo;SP;35;Sudeste;RIBEIRAO PRETO;SAO JOAQUIM DA BARRA;-20.731;-48.058;True;25390;12884;12369;23720;12025;11572;1670;859;797
3532009;Morungaba;SP;35;Sudeste;MACRO METROPOLITANA PAULISTA;BRAGANCA PAULISTA;-22.88;-46.792;True;12007;6043;5961;9954;4939;5012;2053;1104;949
3532058;Motuca;SP;35;Sudeste;ARARAQUARA;ARARAQUARA;-21.508;-48.151;True;4340;2230;2064;3104;1590;1511;1236;640;553
3532108;Murutinga do Sul;SP;35;Sudeste;ARACATUBA;ANDRADINA;-20.993;-51.278;True;4091;2068;2003;2737;1323;1397;1354;745;606
3532157;Nantes;SP;35;Sudeste;ASSIS;ASSIS;-22.621;-51.237;True;2483;1253;1230;2176;1092;1084;307;161;146
3532207;Narandiba;SP;35;Sudeste;PRESIDENTE PRUDENTE;PRESIDENTE PRUDENTE;-22.407;-51.524;True;3941;1990;1946;2776;1374;1397;1165;616;549
3532306;Natividade da Serra;SP;35;Sudeste;VALE DO PARAIBA PAULISTA;PARAIBUNA/PARAITINGA;-23.376;-45.442;True;7275;3818;3362;3271;1640;1596;4004;2178;1766
3532405;Nazaré Paulista;SP;35;Sudeste;MACRO METROPOLITANA PAULISTA;BRAGANCA PAULISTA;-23.181;-46.395;True;14613;7501;7020;12671;6465;6116;1942;1036;904
3532504;Neves Paulista;SP;35;Sudeste;SAO JOSE DO RIO PRETO;NHANDEARA;-20.846;-49.63;True;8825;4444;4381;7844;3913;3931;981;531;450
3532603;Nhandeara;SP;35;Sudeste;SAO JOSE DO RIO PRETO;NHANDEARA;-20.694;-50.038;True;10334;5080;5254;8351;4018;4333;1983;1062;921
3532702;Nipoã;SP;35;Sudeste;SAO JOSE DO RIO PRETO;NHANDEARA;-20.913;-49.778;True;3762;1972;1790;3321;1732;1589;441;240;201
3532801;Nova Aliança;SP;35;Sudeste;SAO JOSE DO RIO PRETO;SAO JOSE DO RIO PRETO;-21.016;-49.496;True;4905;2427;2461;4164;2029;2128;741;398;333
3532827;Nova Campina;SP;35;Sudeste;ITAPETININGA;ITAPEVA;-24.121;-48.904;True;8474;4376;4098;4102;2068;2034;4372;2308;2064
3532843;Nova Canaã Paulista;SP;35;Sudeste;SAO JOSE DO RIO PRETO;JALES;-20.386;-50.949;True;2205;1125;1080;837;417;420;1368;708;660
3532868;Nova Castilho;SP;35;Sudeste;SAO JOSE DO RIO PRETO;AURIFLAMA;-20.763;-50.343;True;1057;526;526;715;348;367;342;178;159
3532900;Nova Europa;SP;35;Sudeste;ARARAQUARA;ARARAQUARA;-21.778;-48.561;True;9047;4552;4457;8373;4178;4161;674;374;296
3533007;Nova Granada;SP;35;Sudeste;SAO JOSE DO RIO PRETO;SAO JOSE DO RIO PRETO;-20.534;-49.314;True;17739;8870;8787;16281;8094;8105;1458;776;682
3533106;Nova Guataporanga;SP;35;Sudeste;PRESIDENTE PRUDENTE;DRACENA;-21.334;-51.644;True;2101;1053;1048;1816;903;913;285;150;135
3533205;Nova Independência;SP;35;Sudeste;ARACATUBA;ANDRADINA;-21.104;-51.49;True;2480;1238;1232;1698;848;840;782;390;392
3533254;Novais;SP;35;Sudeste;SAO JOSE DO RIO PRETO;CATANDUVA;-20.992;-48.919;True;3661;1916;1745;3227;1679;1548;434;237;197
3533304;Nova Luzitânia;SP;35;Sudeste;SAO JOSE DO RIO PRETO;AURIFLAMA;-20.856;-50.262;True;3403;1817;1573;3076;1641;1422;327;176;151
3533403;Nova Odessa;SP;35;Sudeste;CAMPINAS;CAMPINAS;-22.778;-47.296;True;45625;22417;22910;44714;21929;22510;911;488;400
3533502;Novo Horizonte;SP;35;Sudeste;SAO JOSE DO RIO PRETO;NOVO HORIZONTE;-21.468;-49.221;True;34264;17064;17178;31765;15742;16012;2499;1322;1166
3533601;Nuporanga;SP;35;Sudeste;RIBEIRAO PRETO;SAO JOAQUIM DA BARRA;-20.73;-47.749;True;6629;3332;3232;5402;2707;2689;1227;625;543
3533700;Ocauçu;SP;35;Sudeste;MARILIA;MARILIA;-22.439;-49.923;True;4180;2178;2002;3069;1576;1493;1111;602;509
3533809;Óleo;SP;35;Sudeste;ASSIS;OURINHOS;-22.941;-49.342;True;2714;1399;1306;1725;884;841;989;515;465
3533908;Olímpia;SP;35;Sudeste;SAO JOSE DO RIO PRETO;SAO JOSE DO RIO PRETO;-20.737;-48.915;True;48020;23676;24344;45256;22209;23047;2764;1467;1297
3534005;Onda Verde;SP;35;Sudeste;SAO JOSE DO RIO PRETO;SAO JOSE DO RIO PRETO;-20.614;-49.299;True;3736;1917;1819;2903;1497;1406;833;420;413
3534104;Oriente;SP;35;Sudeste;MARILIA;MARILIA;-22.153;-50.091;True;6079;2953;3105;5549;2672;2862;530;281;243
3534203;Orindiúva;SP;35;Sudeste;SAO JOSE DO RIO PRETO;SAO JOSE DO RIO PRETO;-20.182;-49.351;True;4916;2543;2373;4541;2352;2189;375;191;184
3534302;Orlândia;SP;35;Sudeste;RIBEIRAO PRETO;SAO JOAQUIM DA BARRA;-20.72;-47.887;True;36149;17801;18345;35521;17469;18049;628;332;296
3534401;Osasco;SP;35;Sudeste;METROPOLITANA DE SAO PAULO;OSASCO;-23.533;-46.792;True;701012;;;;;;;;
3534500;Oscar Bressane;SP;35;Sudeste;MARILIA;MARILIA;-22.318;-50.281;True;2476;1218;1249;2019;982;1037;457;236;212
3534609;Osvaldo Cruz;SP;35;Sudeste;PRESIDENTE PRUDENTE;ADAMANTINA;-21.797;-50.89;True;30150;15281;14869;26817;12880;13937;3333;2401;932
3534708;Ourinhos;SP;35;Sudeste;ASSIS;OURINHOS;-22.979;-49.871;True;98868;48072;50550;96217;46653;49321;2651;1419;1229
3534757;Ouroeste;SP;35;Sudeste;SAO JOSE DO RIO PRETO;FERNANDOPOLIS;-20.001;-50.372;True;7035;3495;3520;5874;2889;2965;1161;606;555
3534807;Ouro Verde;SP;35;Sudeste;PRESIDENTE PRUDENTE;DRACENA;-21.489;-51.7;True;7668;3835;3827;7053;3506;3542;615;329;285
3534906;Pacaembu;SP;35;Sudeste;PRESIDENTE PRUDENTE;ADAMANTINA;-21.562;-51.261;True;13072;7522;5550;9616;4730;4886;3456;2792;664
3535002;Palestina;SP;35;Sudeste;SAO JOSE DO RIO PRETO;SAO JOSE DO RIO PRETO;-20.39;-49.433;True;10428;5329;5093;8727;4424;4297;1701;905;796
3535101;Palmares Paulista;SP;35;Sudeste;SAO JOSE DO RIO PRETO;CATANDUVA;-21.083;-48.801;True;10508;5659;4845;10236;5519;4713;272;140;132
3535200;Palmeira D'Oeste;SP;35;Sudeste;SAO JOSE DO RIO PRETO;JALES;-20.416;-50.762;True;9634;4831;4803;7186;3541;3645;2448;1290;1158
3535309;Palmital;SP;35;Sudeste;ASSIS;ASSIS;-22.789;-50.218;True;21298;10352;10729;19272;9291;9811;2026;1061;918
3535408;Panorama;SP;35;Sudeste;PRESIDENTE PRUDENTE;DRACENA;-21.356;-51.86;True;13944;6779;6880;13378;6460;6636;566;319;244
3535507;Paraguaçu Paulista;SP;35;Sudeste;ASSIS;ASSIS;-22.413;-50.576;True;42117;20965;20416;38020;18344;19072;4097;2621;1344
3535606;Paraibuna;SP;35;Sudeste;VALE DO PARAIBA PAULISTA;PARAIBUNA/PARAITINGA;-23.386;-45.662;True;16456;8360;8080;5065;2427;2632;11391;5933;5448
3535705;Paraíso;SP;35;Sudeste;SAO JOSE DO RIO PRETO;CATANDUVA;-21.016;-48.774;True;5559;2842;2717;4817;2461;2356;742;381;361
3535804;Paranapanema;SP;35;Sudeste;BAURU;AVARE;-23.389;-48.723;True;16667;8464;8194;13295;6708;6587;3372;1756;1607
3535903;Paranapuã;SP;35;Sudeste;SAO JOSE DO RIO PRETO;JALES;-20.103;-50.586;True;3614;1859;1755;3210;1651;1559;404;208;196
3536000;Parapuã;SP;35;Sudeste;PRESIDENTE PRUDENTE;ADAMANTINA;-21.783;-50.793;True;11029;5608;5420;9001;4510;4491;2028;1098;929
3536109;Pardinho;SP;35;Sudeste;BAURU;BOTUCATU;-23.081;-48.374;True;5030;2585;2444;3844;1947;1896;1186;638;548
3536208;Pariquera-Açu;SP;35;Sudeste;LITORAL SUL PAULISTA;REGISTRO;-24.715;-47.881;True;18079;9067;9008;12607;6177;6428;5472;2890;2580
3536257;Parisi;SP;35;Sudeste;SAO JOSE DO RIO PRETO;VOTUPORANGA;-20.304;-50.015;True;2038;1068;970;1650;854;796;388;214;174
3536307;Patrocínio Paulista;SP;35;Sudeste;RIBEIRAO PRETO;FRANCA;-20.639;-47.282;True;12183;6220;5961;10022;5049;4973;2161;1171;988
3536406;Paulicéia;SP;35;Sudeste;PRESIDENTE PRUDENTE;DRACENA;-21.318;-51.831;True;5506;2816;2620;4354;2241;2113;1152;575;507
3536505;Paulínia;SP;35;Sudeste;CAMPINAS;CAMPINAS;-22.761;-47.154;True;73014;35809;36621;72897;35757;36556;117;52;65
3536570;Paulistânia;SP;35;Sudeste;BAURU;BAURU;-22.578;-49.403;True;1824;945;868;1131;589;542;693;356;326
3536604;Paulo de Faria;SP;35;Sudeste;SAO JOSE DO RIO PRETO;SAO JOSE DO RIO PRETO;-20.031;-49.383;True;8942;4494;4414;8124;4035;4058;818;459;356
3536703;Pederneiras;SP;35;Sudeste;BAURU;JAU;-22.352;-48.775;True;40270;20353;19908;37095;18641;18450;3175;1712;1458
3536802;Pedra Bela;SP;35;Sudeste;CAMPINAS;AMPARO;-22.793;-46.443;True;5835;3064;2760;1321;665;656;4514;2399;2104
3536901;Pedranópolis;SP;35;Sudeste;SAO JOSE DO RIO PRETO;FERNANDOPOLIS;-20.248;-50.11;True;2734;1295;1235;1590;776;784;1144;519;451
3537008;Pedregulho;SP;35;Sudeste;RIBEIRAO PRETO;FRANCA;-20.257;-47.477;True;15156;7735;7421;10859;5437;5422;4297;2298;1999
3537107;Pedreira;SP;35;Sudeste;CAMPINAS;CAMPINAS;-22.742;-46.901;True;38152;18848;19175;37296;18394;18776;856;454;399
3537156;Pedrinhas Paulista;SP;35;Sudeste;ASSIS;ASSIS;-22.815;-50.794;True;2834;1415;1412;2381;1175;1202;453;240;210
3537206;Pedro de Toledo;SP;35;Sudeste;LITORAL SUL PAULISTA;ITANHAEM;-24.275;-47.233;True;9692;4911;4774;6542;3228;3307;3150;1683;1467
3537305;Penápolis;SP;35;Sudeste;ARACATUBA;BIRIGUI;-21.42;-50.078;True;56681;27676;29001;53764;26107;27655;2917;1569;1346
3537404;Pereira Barreto;SP;35;Sudeste;ARACATUBA;ANDRADINA;-20.638;-51.109;True;24220;11885;12335;22709;11098;11611;1511;787;724
3537503;Pereiras;SP;35;Sudeste;ITAPETININGA;TATUI;-23.076;-47.976;True;7347;3737;3585;4810;2375;2427;2537;1362;1158
3537602;Peruíbe;SP;35;Sudeste;LITORAL SUL PAULISTA;ITANHAEM;-24.32;-46.998;False;54457;26698;27714;53448;26169;27271;1009;529;443
3537701;Piacatu;SP;35;Sudeste;ARACATUBA;BIRIGUI;-21.592;-50.599;True;5093;2582;2511;4554;2288;2266;539;294;245
3537800;Piedade;SP;35;Sudeste;MACRO METROPOLITANA PAULISTA;PIEDADE;-23.712;-47.428;True;48430;24733;23504;21483;10505;10941;26947;14228;12563
3537909;Pilar do Sul;SP;35;Sudeste;MACRO METROPOLITANA PAULISTA;PIEDADE;-23.813;-47.716;True;26457;13490;12948;20554;10406;10146;5903;3084;2802
3538006;Pindamonhangaba;SP;35;Sudeste;VALE DO PARAIBA PAULISTA;SAO JOSE DOS CAMPOS;-22.924;-45.462;True;135682;66083;67557;129930;63170;64900;5752;2913;2657
3538105;Pindorama;SP;35;Sudeste;SAO JOSE DO RIO PRETO;CATANDUVA;-21.186;-48.907;True;14345;7303;7038;13503;6855;6648;842;448;390
3538204;Pinhalzinho;SP;35;Sudeste;CAMPINAS;AMPARO;-22.779;-46.591;True;11817;6075;5715;5866;2906;2947;5951;3169;2768
3538303;Piquerobi;SP;35;Sudeste;PRESIDENTE PRUDENTE;PRESIDENTE PRUDENTE;-21.868;-51.729;True;3599;1794;1791;2638;1264;1374;961;530;417
3538501;Piquete;SP;35;Sudeste;VALE DO PARAIBA PAULISTA;GUARATINGUETA;-22.614;-45.176;True;14475;7027;7443;13609;6559;7045;866;468;398
3538600;Piracaia;SP;35;Sudeste;MACRO METROPOLITANA PAULISTA;BRAGANCA PAULISTA;-23.054;-46.358;True;22335;11213;11075;22335;11213;11075;;;
3538709;Piracicaba;SP;35;Sudeste;PIRACICABA;PIRACICABA;-22.725;-47.649;True;358108;;;;;;;;
3538808;Piraju;SP;35;Sudeste;ASSIS;OURINHOS;-23.194;-49.384;True;28228;13671;14448;25248;12144;13081;2980;1527;1367
3538907;Pirajuí;SP;35;Sudeste;BAURU;BAURU;-21.999;-49.457;True;21035;11481;9448;16730;8075;8565;4305;3406;883
3539004;Pirangi;SP;35;Sudeste;RIBEIRAO PRETO;JABOTICABAL;-21.091;-48.658;True;10315;5257;5055;9252;4692;4557;1063;565;498
3539103;Pirapora do Bom Jesus;SP;35;Sudeste;METROPOLITANA DE SAO PAULO;OSASCO;-23.397;-47.002;True;14370;7066;7144;14346;7052;7134;24;14;10
3539202;Pirapozinho;SP;35;Sudeste;PRESIDENTE PRUDENTE;PRESIDENTE PRUDENTE;-22.275;-51.5;True;23709;11635;12046;22542;10988;11526;1167;647;520
3539301;Pirassununga;SP;35;Sudeste;CAMPINAS;PIRASSUNUNGA;-21.996;-47.426;True;67787;33235;34394;61452;29890;31430;6335;3345;2964
3539400;Piratininga;SP;35;Sudeste;BAURU;BAURU;-22.413;-49.135;True;11287;5598;5689;9616;4690;4926;1671;908;763
3539509;Pitangueiras;SP;35;Sudeste;RIBEIRAO PRETO;JABOTICABAL;-21.009;-48.222;True;33329;16892;16423;31865;16140;15720;1464;752;703
3539608;Planalto;SP;35;Sudeste;SAO JOSE DO RIO PRETO;SAO JOSE DO RIO PRETO;-21.034;-49.929;True;4014;2025;1984;3200;1584;1616;814;441;368
3539707;Platina;SP;35;Sudeste;ASSIS;ASSIS;-22.638;-50.204;True;3167;1676;1491;2471;1295;1176;696;381;315
3539806;Poá;SP;35;Sudeste;METROPOLITANA DE SAO PAULO;MOJI DAS CRUZES;-23.528;-46.345;True;104904;50038;53125;103332;49268;52341;1572;770;784
3539905;Poloni;SP;35;Sudeste;SAO JOSE DO RIO PRETO;NHANDEARA;-20.785;-49.824;True;4878;2383;2495;4362;2116;2246;516;267;249
3540002;Pompéia;SP;35;Sudeste;MARILIA;MARILIA;-22.109;-50.172;True;19091;9210;9559;17985;8614;9049;1106;596;510
3540101;Pongaí;SP;35;Sudeste;BAURU;BAURU;-21.736;-49.367;True;3473;1786;1683;2869;1469;1396;604;317;287
3540200;Pontal;SP;35;Sudeste;RIBEIRAO PRETO;RIBEIRAO PRETO;-21.023;-48.037;True;35560;18439;16979;34875;18099;16710;685;340;269
3540259;Pontalinda;SP;35;Sudeste;SAO JOSE DO RIO PRETO;JALES;-20.441;-50.523;True;3906;2037;1869;3191;1655;1536;715;382;333
3540309;Pontes Gestal;SP;35;Sudeste;SAO JOSE DO RIO PRETO;VOTUPORANGA;-20.167;-49.703;True;2487;1255;1232;2065;1040;1025;422;215;207
3540408;Populina;SP;35;Sudeste;SAO JOSE DO RIO PRETO;JALES;-19.954;-50.538;True;4201;2137;2064;3331;1672;1659;870;465;405
3540507;Porangaba;SP;35;Sudeste;ITAPETININGA;TATUI;-23.176;-48.125;True;8069;4101;3850;4026;1950;1993;4043;2151;1857
3540606;Porto Feliz;SP;35;Sudeste;MACRO METROPOLITANA PAULISTA;SOROCABA;-23.215;-47.524;True;46054;23105;22893;38981;19305;19655;7073;3800;3238
3540705;Porto Ferreira;SP;35;Sudeste;CAMPINAS;PIRASSUNUNGA;-21.854;-47.479;True;48760;23991;24197;47219;23159;23488;1541;832;709
3540754;Potim;SP;35;Sudeste;VALE DO PARAIBA PAULISTA;GUARATINGUETA;-22.843;-45.251;True;18143;10331;7641;13965;6978;6843;4178;3353;798
3540804;Potirendaba;SP;35;Sudeste;SAO JOSE DO RIO PRETO;SAO JOSE DO RIO PRETO;-21.043;-49.377;True;14327;7292;7027;12837;6500;6331;1490;792;696
3540853;Pracinha;SP;35;Sudeste;PRESIDENTE PRUDENTE;ADAMANTINA;-21.851;-51.087;True;2667;1902;765;1342;667;675;1325;1235;90
3540903;Pradópolis;SP;35;Sudeste;RIBEIRAO PRETO;RIBEIRAO PRETO;-21.359;-48.066;True;15148;7711;7437;13947;7069;6878;1201;642;559
3541000;Praia Grande;SP;35;Sudeste;METROPOLITANA DE SAO PAULO;SANTOS;-24.006;-46.403;True;233806;;;;;;;;
3541059;Pratânia;SP;35;Sudeste;BAURU;BOTUCATU;-22.808;-48.666;True;4309;2222;2087;3198;1631;1567;1111;591;520
3541109;Presidente Alves;SP;35;Sudeste;BAURU;BAURU;-22.1;-49.438;True;4346;2181;2157;3390;1683;1707;956;498;450
3541208;Presidente Bernardes;SP;35;Sudeste;PRESIDENTE PRUDENTE;PRESIDENTE PRUDENTE;-22.006;-51.553;True;14788;7834;6887;10575;5100;5440;4213;2734;1447
3541307;Presidente Epitácio;SP;35;Sudeste;PRESIDENTE PRUDENTE;PRESIDENTE PRUDENTE;-21.763;-52.116;True;39403;19175;19948;36792;17778;18746;2611;1397;1202
3541406;Presidente Prudente;SP;35;Sudeste;PRESIDENTE PRUDENTE;PRESIDENTE PRUDENTE;-22.126;-51.389;True;202789;;;;;;;;
3541505;Presidente Venceslau;SP;35;Sudeste;PRESIDENTE PRUDENTE;PRESIDENTE PRUDENTE;-21.876;-51.844;True;37155;18384;18675;35394;17427;17890;1761;957;785
3541604;Promissão;SP;35;Sudeste;BAURU;LINS;-21.537;-49.858;True;34786;17370;17292;29229;14418;14756;5557;2952;2536
3541653;Quadra;SP;35;Sudeste;ITAPETININGA;TATUI;-23.299;-48.055;True;2679;1412;1240;840;419;421;1839;993;819
3541703;Quatá;SP;35;Sudeste;ASSIS;ASSIS;-22.248;-50.698;True;11971;5952;5825;11156;5488;5492;815;464;333
3541802;Queiroz;SP;35;Sudeste;MARILIA;TUPA;-21.799;-50.24;True;2603;1323;1280;2267;1143;1124;336;180;156
3541901;Queluz;SP;35;Sudeste;VALE DO PARAIBA PAULISTA;GUARATINGUETA;-22.537;-44.774;True;10323;5114;5195;9344;4605;4734;979;509;461
3542008;Quintana;SP;35;Sudeste;MARILIA;TUPA;-22.073;-50.308;True;5654;2833;2821;5222;2600;2622;432;233;199
3542107;Rafard;SP;35;Sudeste;PIRACICABA;PIRACICABA;-23.012;-47.527;True;8151;4044;4090;7127;3515;3600;1024;529;490
3542206;Rancharia;SP;35;Sudeste;PRESIDENTE PRUDENTE;PRESIDENTE PRUDENTE;-22.229;-50.893;True;28303;13637;14161;25118;11971;12666;3185;1666;1495
3542305;Redenção da Serra;SP;35;Sudeste;VALE DO PARAIBA PAULISTA;PARAIBUNA/PARAITINGA;-23.267;-45.537;True;4081;2163;1894;2034;1033;1001;2047;1130;893
3542404;Regente Feijó;SP;35;Sudeste;PRESIDENTE PRUDENTE;PRESIDENTE PRUDENTE;-22.221;-51.303;True;17070;8465;8599;15675;7723;7946;1395;742;653
3542503;Reginópolis;SP;35;Sudeste;BAURU;BAURU;-21.888;-49.225;True;6993;4491;2461;4301;2120;2156;2692;2371;305
3542602;Registro;SP;35;Sudeste;LITORAL SUL PAULISTA;REGISTRO;-24.488;-47.844;True;53369;26452;26914;46506;22798;23705;6863;3654;3209
3542701;Restinga;SP;35;Sudeste;RIBEIRAO PRETO;FRANCA;-20.603;-47.483;True;6350;3192;3158;4810;2390;2420;1540;802;738
3542800;Ribeira;SP;35;Sudeste;ITAPETININGA;CAPAO BONITO;-24.657;-49.009;True;3444;1735;1649;1249;599;641;2195;1136;1008
3542909;Ribeirão Bonito;SP;35;Sudeste;ARARAQUARA;SAO CARLOS;-22.067;-48.176;True;11383;5675;5552;10535;5229;5164;848;446;388
3543006;Ribeirão Branco;SP;35;Sudeste;ITAPETININGA;CAPAO BONITO;-24.221;-48.766;True;18879;9580;8968;9766;4902;4817;9113;4678;4151
3543105;Ribeirão Corrente;SP;35;Sudeste;RIBEIRAO PRETO;FRANCA;-20.457;-47.59;True;4014;2090;1924;3116;1579;1537;898;511;387
3543204;Ribeirão do Sul;SP;35;Sudeste;ASSIS;OURINHOS;-22.784;-49.934;True;4497;2287;2201;2960;1478;1482;1537;809;719
3543238;Ribeirão dos Índios;SP;35;Sudeste;PRESIDENTE PRUDENTE;PRESIDENTE PRUDENTE;-21.837;-51.604;True;2231;1097;1132;1877;914;961;354;183;171
3543253;Ribeirão Grande;SP;35;Sudeste;ITAPETININGA;CAPAO BONITO;-24.099;-48.365;True;6928;3572;3336;1886;950;921;5042;2622;2415
3543303;Ribeirão Pires;SP;35;Sudeste;METROPOLITANA DE SAO PAULO;SAO PAULO;-23.711;-46.413;True;107046;51791;53930;107046;51791;53930;;;
3543402;Ribeirão Preto;SP;35;Sudeste;RIBEIRAO PRETO;RIBEIRAO PRETO;-21.178;-47.81;True;547417;;;;;;;;
3543501;Riversul;SP;35;Sudeste;ITAPETININGA;ITAPEVA;-23.828;-49.429;True;6545;3287;3258;4630;2264;2366;1915;1023;892
3543600;Rifaina;SP;35;Sudeste;RIBEIRAO PRETO;FRANCA;-20.081;-47.421;True;3587;1849;1736;2782;1414;1368;805;435;368
3543709;Rincão;SP;35;Sudeste;ARARAQUARA;ARARAQUARA;-21.587;-48.071;True;10425;5240;5168;8769;4368;4397;1656;872;771
3543808;Rinópolis;SP;35;Sudeste;PRESIDENTE PRUDENTE;ADAMANTINA;-21.726;-50.722;True;9393;4797;4596;8062;4083;3979;1331;714;617
3543907;Rio Claro;SP;35;Sudeste;PIRACICABA;RIO CLARO;-22.411;-47.561;True;185421;;;;;;;;
3544004;Rio das Pedras;SP;35;Sudeste;PIRACICABA;PIRACICABA;-22.843;-47.606;True;26344;12752;12354;25088;12130;11792;1256;622;562
3544103;Rio Grande da Serra;SP;35;Sudeste;METROPOLITANA DE SAO PAULO;SAO PAULO;-23.744;-46.398;True;39270;19446;19654;39270;19446;19654;;;
3544202;Riolândia;SP;35;Sudeste;SAO JOSE DO RIO PRETO;VOTUPORANGA;-19.99;-49.681;True;9713;5555;4144;7689;3944;3734;2024;1611;410
3544251;Rosana;SP;35;Sudeste;PRESIDENTE PRUDENTE;PRESIDENTE PRUDENTE;-22.58;-53.059;True;19943;10034;9909;15528;7663;7865;4415;2371;2044
3544301;Roseira;SP;35;Sudeste;VALE DO PARAIBA PAULISTA;GUARATINGUETA;-22.898;-45.305;True;9016;4510;4489;8410;4187;4209;606;323;280
3544400;Rubiácea;SP;35;Sudeste;ARACATUBA;ARACATUBA;-21.301;-50.727;True;2501;1270;1225;1352;658;694;1149;612;531
3544509;Rubinéia;SP;35;Sudeste;SAO JOSE DO RIO PRETO;JALES;-20.179;-51.002;True;2546;1251;1295;2102;1029;1073;444;222;222
3544608;Sabino;SP;35;Sudeste;BAURU;LINS;-21.46;-49.578;True;5150;2567;2568;4387;2175;2212;763;392;356
3544707;Sagres;SP;35;Sudeste;PRESIDENTE PRUDENTE;ADAMANTINA;-21.884;-50.956;True;2307;1134;1172;1728;847;881;579;287;291
3544806;Sales;SP;35;Sudeste;SAO JOSE DO RIO PRETO;NOVO HORIZONTE;-21.341;-49.485;True;5025;2530;2487;4319;2158;2153;706;372;334
3544905;Sales Oliveira;SP;35;Sudeste;RIBEIRAO PRETO;SAO JOAQUIM DA BARRA;-20.772;-47.838;True;8187;4062;4078;7680;3791;3842;507;271;236
3545001;Salesópolis;SP;35;Sudeste;METROPOLITANA DE SAO PAULO;MOJI DAS CRUZES;-23.532;-45.846;True;15157;7420;7236;9440;4510;4583;5717;2910;2653
3545100;Salmourão;SP;35;Sudeste;PRESIDENTE PRUDENTE;ADAMANTINA;-21.624;-50.861;True;4551;2343;2208;4151;2133;2018;400;210;190
3545159;Saltinho;SP;35;Sudeste;PIRACICABA;PIRACICABA;-22.847;-47.677;True;6586;3183;3134;5491;2627;2637;1095;556;497
3545209;Salto;SP;35;Sudeste;MACRO METROPOLITANA PAULISTA;SOROCABA;-23.201;-47.287;True;102405;50643;51478;101461;50141;51036;944;502;442
3545308;Salto de Pirapora;SP;35;Sudeste;MACRO METROPOLITANA PAULISTA;SOROCABA;-23.649;-47.573;True;37324;17970;18161;30147;14480;14725;7177;3490;3436
3545407;Salto Grande;SP;35;Sudeste;ASSIS;OURINHOS;-22.893;-49.986;True;8592;4301;4291;7749;3843;3906;843;458;385
3545506;Sandovalina;SP;35;Sudeste;PRESIDENTE PRUDENTE;PRESIDENTE PRUDENTE;-22.456;-51.763;True;3217;1613;1594;2114;1036;1068;1103;577;526
3545605;Santa Adélia;SP;35;Sudeste;SAO JOSE DO RIO PRETO;CATANDUVA;-21.243;-48.804;True;13861;6974;6859;13018;6522;6480;843;452;379
3545704;Santa Albertina;SP;35;Sudeste;SAO JOSE DO RIO PRETO;JALES;-20.032;-50.728;True;5034;2473;2561;4181;2013;2168;853;460;393
3545803;Santa Bárbara D'Oeste;SP;35;Sudeste;CAMPINAS;CAMPINAS;-22.754;-47.414;True;184318;;;;;;;;
3546009;Santa Branca;SP;35;Sudeste;VALE DO PARAIBA PAULISTA;SAO JOSE DOS CAMPOS;-23.397;-45.884;True;13282;6415;6341;11925;5720;5724;1357;695;617
3546108;Santa Clara D'Oeste;SP;35;Sudeste;SAO JOSE DO RIO PRETO;JALES;-20.089;-50.954;True;2081;1067;1014;1524;768;756;557;299;258
3546207;Santa Cruz da Conceição;SP;35;Sudeste;PIRACICABA;LIMEIRA;-22.14;-47.452;True;3872;1929;1917;2481;1219;1258;1391;710;659
3546256;Santa Cruz da Esperança;SP;35;Sudeste;RIBEIRAO PRETO;BATATAIS;-21.291;-47.43;True;1707;820;825;1151;529;560;556;291;265
3546306;Santa Cruz das Palmeiras;SP;35;Sudeste;CAMPINAS;PIRASSUNUNGA;-21.827;-47.249;True;30458;15911;14522;29371;15341;14005;1087;570;517
3546405;Santa Cruz do Rio Pardo;SP;35;Sudeste;ASSIS;OURINHOS;-22.899;-49.633;True;41655;20475;21091;37839;18497;19308;3816;1978;1783
3546504;Santa Ernestina;SP;35;Sudeste;RIBEIRAO PRETO;JABOTICABAL;-21.463;-48.391;True;5510;2865;2645;5038;2606;2432;472;259;213
3546603;Santa Fé do Sul;SP;35;Sudeste;SAO JOSE DO RIO PRETO;JALES;-20.211;-50.926;True;27693;13365;14315;26459;12728;13731;1234;637;584
3546702;Santa Gertrudes;SP;35;Sudeste;PIRACICABA;LIMEIRA;-22.457;-47.53;True;19044;9769;9269;18672;9579;9090;372;190;179
3546801;Santa Isabel;SP;35;Sudeste;METROPOLITANA DE SAO PAULO;GUARULHOS;-23.316;-46.221;True;44817;22529;21920;34175;16788;17122;10642;5741;4798
3546900;Santa Lúcia;SP;35;Sudeste;ARARAQUARA;ARARAQUARA;-21.685;-48.084;True;7862;3962;3877;7327;3691;3613;535;271;264
3547007;Santa Maria da Serra;SP;35;Sudeste;PIRACICABA;PIRACICABA;-22.567;-48.161;True;5417;2726;2556;4787;2392;2266;630;334;290
3547106;Santa Mercedes;SP;35;Sudeste;PRESIDENTE PRUDENTE;DRACENA;-21.351;-51.755;True;2589;1294;1295;2225;1099;1126;364;195;169
3547205;Santana da Ponte Pensa;SP;35;Sudeste;SAO JOSE DO RIO PRETO;JALES;-20.253;-50.797;True;1654;856;798;1105;553;552;549;303;246
3547304;Santana de Parnaíba;SP;35;Sudeste;METROPOLITANA DE SAO PAULO;OSASCO;-23.444;-46.918;True;100236;48920;49945;100236;48920;49945;;;
3547403;Santa Rita D'Oeste;SP;35;Sudeste;SAO JOSE DO RIO PRETO;JALES;-20.143;-50.833;True;2493;1231;1246;1670;802;857;823;429;389
3547502;Santa Rita do Passa Quatro;SP;35;Sudeste;RIBEIRAO PRETO;RIBEIRAO PRETO;-21.71;-47.478;True;26456;12479;13315;23575;11057;11907;2881;1422;1408
3547601;Santa Rosa de Viterbo;SP;35;Sudeste;RIBEIRAO PRETO;RIBEIRAO PRETO;-21.473;-47.363;True;22699;11172;11487;21680;10630;11010;1019;542;477
3547650;Santa Salete;SP;35;Sudeste;SAO JOSE DO RIO PRETO;JALES;-20.245;-50.688;True;1390;724;666;732;381;351;658;343;315
3547700;Santo Anastácio;SP;35;Sudeste;PRESIDENTE PRUDENTE;PRESIDENTE PRUDENTE;-21.977;-51.652;True;20550;9933;10466;19102;9164;9787;1448;769;679
3547809;Santo André;SP;35;Sudeste;METROPOLITANA DE SAO PAULO;SAO PAULO;-23.664;-46.538;True;667891;;;;;;;;
3547908;Santo Antônio da Alegria;SP;35;Sudeste;RIBEIRAO PRETO;BATATAIS;-21.087;-47.151;True;6020;3158;2850;4451;2279;2172;1569;879;678
3548005;Santo Antônio de Posse;SP;35;Sudeste;CAMPINAS;MOJI-MIRIM;-22.606;-46.919;True;19824;10040;9758;15902;7990;7912;3922;2050;1846
3548054;Santo Antônio do Aracanguá;SP;35;Sudeste;ARACATUBA;ARACATUBA;-20.937;-50.496;True;7034;3543;3425;5207;2596;2595;1827;947;830
3548104;Santo Antônio do Jardim;SP;35;Sudeste;CAMPINAS;SAO JOAO DA BOA VISTA;-22.116;-46.68;True;5743;2942;2801;3414;1696;1718;2329;1246;1083
3548203;Santo Antônio do Pinhal;SP;35;Sudeste;VALE DO PARAIBA PAULISTA;CAMPOS DO JORDAO;-22.827;-45.663;True;6560;3296;3171;3523;1752;1715;3037;1544;1456
3548302;Santo Expedito;SP;35;Sudeste;PRESIDENTE PRUDENTE;PRESIDENTE PRUDENTE;-21.851;-51.392;True;2759;1375;1356;2368;1158;1182;391;217;174
3548401;Santópolis do Aguapeí;SP;35;Sudeste;ARACATUBA;BIRIGUI;-21.638;-50.5;True;4008;2054;1952;3844;1970;1874;164;84;78
3548500;Santos;SP;35;Sudeste;METROPOLITANA DE SAO PAULO;SANTOS;-23.961;-46.334;True;418288;;;;;;;;
3548609;São Bento do Sapucaí;SP;35;Sudeste;VALE DO PARAIBA PAULISTA;CAMPOS DO JORDAO;-22.689;-45.731;True;10515;5314;5167;5073;2502;2571;5442;2812;2596
3548708;São Bernardo do Campo;SP;35;Sudeste;METROPOLITANA DE SAO PAULO;SAO PAULO;-23.694;-46.565;True;781390;;;;;;;;
3548807;São Caetano do Sul;SP;35;Sudeste;METROPOLITANA DE SAO PAULO;SAO PAULO;-23.623;-46.551;True;144857;66730;77181;144857;66730;77181;;;
3548906;São Carlos;SP;35;Sudeste;ARARAQUARA;SAO CARLOS;-22.018;-47.891;True;212956;;;;;;;;
3549003;São Francisco;SP;35;Sudeste;SAO JOSE DO RIO PRETO;JALES;-20.359;-50.697;True;2812;1429;1379;2137;1074;1059;675;355;320
3549102;São João da Boa Vista;SP;35;Sudeste;CAMPINAS;SAO JOAO DA BOA VISTA;-21.969;-46.798;True;79935;38682;40835;75052;36186;38640;4883;2496;2195
3549201;São João das Duas Pontes;SP;35;Sudeste;SAO JOSE DO RIO PRETO;FERNANDOPOLIS;-20.389;-50.378;True;2571;1302;1269;2041;1012;1029;530;290;240
3549250;São João de Iracema;SP;35;Sudeste;SAO JOSE DO RIO PRETO;AURIFLAMA;-20.513;-50.352;True;1725;880;845;1322;669;653;403;211;192
3549300;São João do Pau D'Alho;SP;35;Sudeste;PRESIDENTE PRUDENTE;DRACENA;-21.268;-51.666;True;2132;1083;1049;1621;799;822;511;284;227
3549409;São Joaquim da Barra;SP;35;Sudeste;RIBEIRAO PRETO;SAO JOAQUIM DA BARRA;-20.581;-47.855;True;43703;21536;22161;43041;21200;21841;662;336;320
3549508;São José da Bela Vista;SP;35;Sudeste;RIBEIRAO PRETO;FRANCA;-20.593;-47.64;True;8173;4159;4014;7238;3652;3586;935;507;428
3549607;São José do Barreiro;SP;35;Sudeste;VALE DO PARAIBA PAULISTA;BANANAL;-22.645;-44.578;True;4278;2153;2089;2881;1384;1464;1397;769;625
3549706;São José do Rio Pardo;SP;35;Sudeste;CAMPINAS;SAO JOAO DA BOA VISTA;-21.596;-46.889;True;51023;25102;25800;44359;21648;22602;6664;3454;3198
3549805;São José do Rio Preto;SP;35;Sudeste;SAO JOSE DO RIO PRETO;SAO JOSE DO RIO PRETO;-20.82;-49.379;True;402770;;;;;;;;
3549904;São José dos Campos;SP;35;Sudeste;VALE DO PARAIBA PAULISTA;SAO JOSE DOS CAMPOS;-23.179;-45.887;True;594948;;;;;;;;
3549953;São Lourenço da Serra;SP;35;Sudeste;METROPOLITANA DE SAO PAULO;ITAPECERICA DA SERRA;-23.853;-46.943;True;16121;7810;7505;14808;7071;6949;1313;739;556
3550001;São Luís do Paraitinga;SP;35;Sudeste;VALE DO PARAIBA PAULISTA;PARAIBUNA/PARAITINGA;-23.222;-45.31;True;10496;5295;4948;6512;3169;3202;3984;2126;1746
3550100;São Manuel;SP;35;Sudeste;BAURU;BOTUCATU;-22.731;-48.571;True;37797;18599;19137;36142;17731;18359;1655;868;778
3550209;São Miguel Arcanjo;SP;35;Sudeste;MACRO METROPOLITANA PAULISTA;PIEDADE;-23.878;-47.997;True;30384;15463;14909;19443;9652;9779;10941;5811;5130
3550308;São Paulo;SP;35;Sudeste;METROPOLITANA DE SAO PAULO;SAO PAULO;-23.548;-46.636;True;10886518;;;;;;;;
3550407;São Pedro;SP;35;Sudeste;PIRACICABA;PIRACICABA;-22.549;-47.914;True;29733;14106;14644;25121;11718;12487;4612;2388;2157
3550506;São Pedro do Turvo;SP;35;Sudeste;ASSIS;OURINHOS;-22.747;-49.74;True;7094;3617;3466;4657;2314;2339;2437;1303;1127
3550605;São Roque;SP;35;Sudeste;MACRO METROPOLITANA PAULISTA;SOROCABA;-23.529;-47.135;True;65693;32154;32857;48028;23176;24407;17665;8978;8450
3550704;São Sebastião;SP;35;Sudeste;VALE DO PARAIBA PAULISTA;CARAGUATATUBA;-23.76;-45.41;False;67348;33841;33488;66239;33277;32943;1109;564;545
3550803;São Sebastião da Grama;SP;35;Sudeste;CAMPINAS;SAO JOAO DA BOA VISTA;-21.711;-46.821;True;12509;6353;6156;8314;4096;4218;4195;2257;1938
3550902;São Simão;SP;35;Sudeste;RIBEIRAO PRETO;RIBEIRAO PRETO;-21.479;-47.551;True;13781;6810;6968;12248;5991;6257;1533;819;711
3551009;São Vicente;SP;35;Sudeste;METROPOLITANA DE SAO PAULO;SANTOS;-23.963;-46.392;True;323599;;;;;;;;
3551108;Sarapuí;SP;35;Sudeste;MACRO METROPOLITANA PAULISTA;SOROCABA;-23.641;-47.825;True;8158;4141;3939;5681;2849;2790;2477;1292;1149
3551207;Sarutaiá;SP;35;Sudeste;ASSIS;OURINHOS;-23.273;-49.48;True;3680;1846;1834;2959;1447;1512;721;399;322
3551306;Sebastianópolis do Sul;SP;35;Sudeste;SAO JOSE DO RIO PRETO;NHANDEARA;-20.655;-49.921;True;2871;1479;1392;2111;1063;1048;760;416;344
3551405;Serra Azul;SP;35;Sudeste;RIBEIRAO PRETO;RIBEIRAO PRETO;-21.311;-47.566;True;9107;5177;3911;7164;3547;3617;1943;1630;294
3551504;Serrana;SP;35;Sudeste;RIBEIRAO PRETO;RIBEIRAO PRETO;-21.211;-47.596;True;36596;18382;18194;36166;18163;17983;430;219;211
3551603;Serra Negra;SP;35;Sudeste;CAMPINAS;AMPARO;-22.612;-46.701;True;24671;12069;12564;21343;10299;11006;3328;1770;1558
3551702;Sertãozinho;SP;35;Sudeste;RIBEIRAO PRETO;RIBEIRAO PRETO;-21.138;-47.99;True;103558;51559;51891;100715;50069;50544;2843;1490;1347
3551801;Sete Barras;SP;35;Sudeste;LITORAL SUL PAULISTA;REGISTRO;-24.388;-47.926;True;12975;6639;6308;6383;3124;3259;6592;3515;3049
3551900;Severínia;SP;35;Sudeste;SAO JOSE DO RIO PRETO;CATANDUVA;-20.809;-48.803;True;14713;7654;7059;13954;7254;6700;759;400;359
3552007;Silveiras;SP;35;Sudeste;VALE DO PARAIBA PAULISTA;BANANAL;-22.664;-44.853;True;5562;2844;2707;2495;1218;1277;3067;1626;1430
3552106;Socorro;SP;35;Sudeste;CAMPINAS;AMPARO;-22.591;-46.529;True;33080;16213;16611;21798;10391;11293;11282;5822;5318
3552205;Sorocaba;SP;35;Sudeste;MACRO METROPOLITANA PAULISTA;SOROCABA;-23.502;-47.458;True;559157;;;;;;;;
3552304;Sud Mennucci;SP;35;Sudeste;ARACATUBA;ANDRADINA;-20.691;-50.924;True;7714;3884;3803;6743;3395;3327;971;489;476
3552403;Sumaré;SP;35;Sudeste;CAMPINAS;CAMPINAS;-22.822;-47.267;True;228696;;;;;;;;
3552502;Suzano;SP;35;Sudeste;METROPOLITANA DE SAO PAULO;MOJI DAS CRUZES;-23.543;-46.311;True;268777;;;;;;;;
3552551;Suzanápolis;SP;35;Sudeste;ARACATUBA;ANDRADINA;-20.501;-51.025;True;3421;1773;1648;2264;1129;1135;1157;644;513
3552601;Tabapuã;SP;35;Sudeste;SAO JOSE DO RIO PRETO;CATANDUVA;-20.964;-49.032;True;11255;5754;5491;10272;5242;5026;983;512;465
3552700;Tabatinga;SP;35;Sudeste;ARARAQUARA;ARARAQUARA;-21.717;-48.688;True;13965;7003;6959;11670;5808;5862;2295;1195;1097
3552809;Taboão da Serra;SP;35;Sudeste;METROPOLITANA DE SAO PAULO;ITAPECERICA DA SERRA;-23.602;-46.753;True;219200;;;;;;;;
3552908;Taciba;SP;35;Sudeste;PRESIDENTE PRUDENTE;PRESIDENTE PRUDENTE;-22.39;-51.285;True;5402;2684;2699;4506;2217;2289;896;467;410
3553005;Taguaí;SP;35;Sudeste;ASSIS;OURINHOS;-23.452;-49.409;True;9616;4816;4785;7490;3691;3789;2126;1125;996
3553104;Taiaçu;SP;35;Sudeste;RIBEIRAO PRETO;JABOTICABAL;-21.144;-48.513;True;5804;2917;2887;5172;2591;2581;632;326;306
3553203;Taiúva;SP;35;Sudeste;RIBEIRAO PRETO;JABOTICABAL;-21.124;-48.452;True;5366;2662;2704;4834;2377;2457;532;285;247
3553302;Tambaú;SP;35;Sudeste;CAMPINAS;SAO JOAO DA BOA VISTA;-21.705;-47.274;True;21913;10882;10974;19287;9517;9743;2626;1365;1231
3553401;Tanabi;SP;35;Sudeste;SAO JOSE DO RIO PRETO;SAO JOSE DO RIO PRETO;-20.626;-49.649;True;23400;11659;11741;20199;9980;10219;3201;1679;1522
3553500;Tapiraí;SP;35;Sudeste;MACRO METROPOLITANA PAULISTA;PIEDADE;-23.964;-47.507;True;7953;3968;3949;5609;2731;2844;2344;1237;1105
3553609;Tapiratiba;SP;35;Sudeste;CAMPINAS;SAO JOAO DA BOA VISTA;-21.468;-46.749;True;12246;6084;6156;9963;4888;5071;2283;1196;1085
3553658;Taquaral;SP;35;Sudeste;RIBEIRAO PRETO;JABOTICABAL;-21.072;-48.41;True;2827;1426;1401;2649;1325;1324;178;101;77
3553708;Taquaritinga;SP;35;Sudeste;RIBEIRAO PRETO;JABOTICABAL;-21.406;-48.505;True;53232;26585;26552;50530;25097;25357;2702;1488;1195
3553807;Taquarituba;SP;35;Sudeste;ITAPETININGA;ITAPEVA;-23.533;-49.244;True;22170;11081;11089;19202;9536;9666;2968;1545;1423
3553856;Taquarivaí;SP;35;Sudeste;ITAPETININGA;ITAPEVA;-23.924;-48.693;True;5098;2583;2515;2624;1296;1328;2474;1287;1187
3553906;Tarabai;SP;35;Sudeste;PRESIDENTE PRUDENTE;PRESIDENTE PRUDENTE;-22.303;-51.559;True;6108;3041;3067;5694;2822;2872;414;219;195
3553955;Tarumã;SP;35;Sudeste;ASSIS;ASSIS;-22.747;-50.577;True;12298;6277;6021;11473;5847;5626;825;430;395
3554003;Tatuí;SP;35;Sudeste;ITAPETININGA;TATUI;-23.356;-47.857;True;101838;50290;51090;91990;45182;46362;9848;5108;4728
3554102;Taubaté;SP;35;Sudeste;VALE DO PARAIBA PAULISTA;SAO JOSE DOS CAMPOS;-23.026;-45.555;True;265514;;;;;;;;
3554201;Tejupá;SP;35;Sudeste;ASSIS;OURINHOS;-23.343;-49.376;True;5015;2591;2421;3061;1586;1475;1954;1005;946
3554300;Teodoro Sampaio;SP;35;Sudeste;PRESIDENTE PRUDENTE;PRESIDENTE PRUDENTE;-22.533;-52.168;True;20325;10071;10216;15824;7665;8143;4501;2406;2073
3554409;Terra Roxa;SP;35;Sudeste;RIBEIRAO PRETO;JABOTICABAL;-20.789;-48.33;True;8155;4136;4019;7712;3905;3807;443;231;212
3554508;Tietê;SP;35;Sudeste;PIRACICABA;PIRACICABA;-23.102;-47.715;True;34018;16775;17028;31149;15312;15666;2869;1463;1362
3554607;Timburi;SP;35;Sudeste;ASSIS;OURINHOS;-23.205;-49.607;True;2535;1290;1222;1775;879;896;760;411;326
3554656;Torre de Pedra;SP;35;Sudeste;ITAPETININGA;TATUI;-23.244;-48.195;True;2784;1426;1356;1791;904;887;993;522;469
3554706;Torrinha;SP;35;Sudeste;PIRACICABA;RIO CLARO;-22.426;-48.169;True;8918;4466;4452;7742;3836;3906;1176;630;546
3554755;Trabiju;SP;35;Sudeste;ARARAQUARA;ARARAQUARA;-22.042;-48.336;True;1441;746;695;1350;698;652;91;48;43
3554805;Tremembé;SP;35;Sudeste;VALE DO PARAIBA PAULISTA;SAO JOSE DOS CAMPOS;-22.958;-45.549;True;38321;19969;17629;33533;16897;15984;4788;3072;1645
3554904;Três Fronteiras;SP;35;Sudeste;SAO JOSE DO RIO PRETO;JALES;-20.235;-50.89;True;5031;2524;2491;4211;2083;2112;820;441;379
3554953;Tuiuti;SP;35;Sudeste;MACRO METROPOLITANA PAULISTA;BRAGANCA PAULISTA;-22.816;-46.694;True;5749;2977;2772;2721;1391;1330;3028;1586;1442
3555000;Tupã;SP;35;Sudeste;MARILIA;TUPA;-21.935;-50.514;True;62256;30057;32195;59679;28677;31002;2577;1380;1193
3555109;Tupi Paulista;SP;35;Sudeste;PRESIDENTE PRUDENTE;DRACENA;-21.381;-51.571;True;13712;7190;6515;10800;5204;5596;2912;1986;919
3555208;Turiúba;SP;35;Sudeste;ARACATUBA;BIRIGUI;-20.933;-50.108;True;1947;988;955;1596;799;793;351;189;162
3555307;Turmalina;SP;35;Sudeste;SAO JOSE DO RIO PRETO;FERNANDOPOLIS;-20.052;-50.476;True;2024;1005;1019;1411;694;717;613;311;302
3555356;Ubarana;SP;35;Sudeste;SAO JOSE DO RIO PRETO;SAO JOSE DO RIO PRETO;-21.166;-49.718;True;4552;2342;2210;4193;2152;2041;359;190;169
3555406;Ubatuba;SP;35;Sudeste;VALE DO PARAIBA PAULISTA;CARAGUATATUBA;-23.434;-45.071;False;75008;37558;37407;72571;36254;36274;2437;1304;1133
3555505;Ubirajara;SP;35;Sudeste;BAURU;BAURU;-22.527;-49.663;True;4269;2189;2072;3204;1627;1574;1065;562;498
3555604;Uchoa;SP;35;Sudeste;SAO JOSE DO RIO PRETO;SAO JOSE DO RIO PRETO;-20.953;-49.175;True;9348;4639;4626;8558;4264;4263;790;375;363
3555703;União Paulista;SP;35;Sudeste;SAO JOSE DO RIO PRETO;NHANDEARA;-20.887;-49.897;True;1436;774;662;1073;572;501;363;202;161
3555802;Urânia;SP;35;Sudeste;SAO JOSE DO RIO PRETO;JALES;-20.246;-50.643;True;8727;4331;4396;7273;3574;3699;1454;757;697
3555901;Uru;SP;35;Sudeste;BAURU;BAURU;-21.784;-49.281;True;1362;701;659;1043;528;513;319;173;146
3556008;Urupês;SP;35;Sudeste;SAO JOSE DO RIO PRETO;NOVO HORIZONTE;-21.202;-49.29;True;11917;5926;5921;10472;5181;5291;1445;745;630
3556107;Valentim Gentil;SP;35;Sudeste;SAO JOSE DO RIO PRETO;VOTUPORANGA;-20.422;-50.088;True;9408;4710;4681;8568;4278;4275;840;432;406
3556206;Valinhos;SP;35;Sudeste;CAMPINAS;CAMPINAS;-22.971;-46.996;True;97814;47357;48158;92714;44703;45736;5100;2654;2422
3556305;Valparaíso;SP;35;Sudeste;ARACATUBA;ARACATUBA;-21.228;-50.868;True;20827;11497;9323;17339;8694;8641;3488;2803;682
3556354;Vargem;SP;35;Sudeste;MACRO METROPOLITANA PAULISTA;BRAGANCA PAULISTA;-22.889;-46.414;True;6883;3463;3294;3586;1810;1773;3297;1653;1521
3556404;Vargem Grande do Sul;SP;35;Sudeste;CAMPINAS;SAO JOAO DA BOA VISTA;-21.832;-46.894;True;37357;18429;18673;34969;17208;17567;2388;1221;1106
3556453;Vargem Grande Paulista;SP;35;Sudeste;METROPOLITANA DE SAO PAULO;ITAPECERICA DA SERRA;-23.603;-47.026;True;40200;19470;19808;40200;19470;19808;;;
3556503;Várzea Paulista;SP;35;Sudeste;MACRO METROPOLITANA PAULISTA;JUNDIAI;-23.211;-46.828;True;100411;49976;49912;99912;49730;49664;499;246;248
3556602;Vera Cruz;SP;35;Sudeste;MARILIA;MARILIA;-22.22;-49.819;True;10020;4933;5086;8582;4161;4421;1438;772;665
3556701;Vinhedo;SP;35;Sudeste;CAMPINAS;CAMPINAS;-23.03;-46.975;True;57435;28021;28173;56435;27510;27684;1000;511;489
3556800;Viradouro;SP;35;Sudeste;RIBEIRAO PRETO;JABOTICABAL;-20.873;-48.297;True;17043;8694;8349;16415;8347;8068;628;347;281
3556909;Vista Alegre do Alto;SP;35;Sudeste;RIBEIRAO PRETO;JABOTICABAL;-21.171;-48.629;True;6100;3074;3024;5506;2762;2742;594;312;282
3556958;Vitória Brasil;SP;35;Sudeste;SAO JOSE DO RIO PRETO;JALES;-20.197;-50.484;True;1624;836;788;1294;660;634;330;176;154
3557006;Votorantim;SP;35;Sudeste;MACRO METROPOLITANA PAULISTA;SOROCABA;-23.547;-47.438;True;99901;48906;49671;95513;46707;47600;4388;2199;2071
3557105;Votuporanga;SP;35;Sudeste;SAO JOSE DO RIO PRETO;VOTUPORANGA;-20.423;-49.973;True;77622;37917;39669;75507;36802;38669;2115;1115;1000
3557154;Zacarias;SP;35;Sudeste;SAO JOSE DO RIO PRETO;SAO JOSE DO RIO PRETO;-21.052;-50.051;True;2229;1137;1092;1665;830;835;564;307;257
3557204;Chavantes;SP;35;Sudeste;ASSIS;OURINHOS;-23.039;-49.709;True;12226;6072;6154;10987;5401;5586;1239;671;568
3557303;Estiva Gerbi;SP;35;Sudeste;CAMPINAS;MOJI-MIRIM;-22.271;-46.945;True;9185;4682;4503;7624;3838;3786;1561;844;717
4100103;Abatiá;PR;41;Sul;NORTE PIONEIRO PARANAENSE;CORNELIO PROCOPIO;-23.304;-50.313;True;7791;3947;3844;5338;2641;2697;2453;1306;1147
4100202;Adrianópolis;PR;41;Sul;METROPOLITANA DE CURITIBA;CERRO AZUL;-24.657;-48.991;True;6709;3490;3120;1327;673;654;5382;2817;2466
4100301;Agudos do Sul;PR;41;Sul;METROPOLITANA DE CURITIBA;RIO NEGRO;-25.993;-49.335;True;8192;4257;3908;1727;876;851;6465;3381;3057
4100400;Almirante Tamandaré;PR;41;Sul;METROPOLITANA DE CURITIBA;CURITIBA;-25.325;-49.31;True;93055;46103;46656;89172;44124;44781;3883;1979;1875
4100459;Altamira do Paraná;PR;41;Sul;CENTRO OCIDENTAL PARANAENSE;GOIOERE;-24.798;-52.713;True;4369;2226;2136;1678;823;855;2691;1403;1281
4100509;Altônia;PR;41;Sul;NOROESTE PARANAENSE;UMUARAMA;-23.874;-53.902;True;19904;9845;9961;14106;6853;7244;5798;2992;2717
4100608;Alto Paraná;PR;41;Sul;NOROESTE PARANAENSE;PARANAVAI;-23.129;-52.319;True;12936;6389;6420;10565;5214;5346;2371;1175;1074
4100707;Alto Piquiri;PR;41;Sul;NOROESTE PARANAENSE;UMUARAMA;-24.028;-53.441;True;10210;5052;5158;8513;4159;4354;1697;893;804
4100806;Alvorada do Sul;PR;41;Sul;NORTE CENTRAL PARANAENSE;PORECATU;-22.78;-51.231;True;9014;4562;4452;6916;3424;3492;2098;1138;960
4100905;Amaporã;PR;41;Sul;NOROESTE PARANAENSE;PARANAVAI;-23.096;-52.788;True;5140;2611;2520;3971;1961;2001;1169;650;519
4101002;Ampére;PR;41;Sul;SUDOESTE PARANAENSE;CAPANEMA;-25.915;-53.473;True;17067;8495;8521;11628;5609;6013;5439;2886;2508
4101051;Anahy;PR;41;Sul;OESTE PARANAENSE;CASCAVEL;-24.644;-53.135;True;2868;1443;1423;1969;965;1004;899;478;419
4101101;Andirá;PR;41;Sul;NORTE PIONEIRO PARANAENSE;CORNELIO PROCOPIO;-23.051;-50.229;True;21330;10481;10849;19847;9698;10149;1483;783;700
4101150;Ângulo;PR;41;Sul;NORTE CENTRAL PARANAENSE;ASTORGA;-23.195;-51.915;True;2807;1405;1399;2208;1091;1117;599;314;282
4101200;Antonina;PR;41;Sul;METROPOLITANA DE CURITIBA;PARANAGUA;-25.429;-48.712;True;17581;8781;8752;14688;7264;7380;2893;1517;1372
4101309;Antônio Olinto;PR;41;Sul;SUDESTE PARANAENSE;SAO MATEUS DO SUL;-25.986;-50.197;True;7477;3921;3527;631;321;310;6846;3600;3217
4101408;Apucarana;PR;41;Sul;NORTE CENTRAL PARANAENSE;APUCARANA;-23.551;-51.461;True;115323;56101;58954;108498;52458;55782;6825;3643;3172
4101507;Arapongas;PR;41;Sul;NORTE CENTRAL PARANAENSE;APUCARANA;-23.419;-51.424;True;96669;47521;49050;93717;45969;47673;2952;1552;1377
4101606;Arapoti;PR;41;Sul;CENTRO ORIENTAL PARANAENSE;JAGUARIAIVA;-24.158;-49.827;True;25645;12938;12690;18548;9244;9299;7097;3694;3391
4101655;Arapuã;PR;41;Sul;NORTE CENTRAL PARANAENSE;IVAIPORA;-24.316;-51.787;True;3945;2013;1918;1239;613;626;2706;1400;1292
4101705;Araruna;PR;41;Sul;CENTRO OCIDENTAL PARANAENSE;CAMPO MOURAO;-23.932;-52.496;True;12650;6240;6081;9538;4632;4670;3112;1608;1411
4101804;Araucária;PR;41;Sul;METROPOLITANA DE CURITIBA;CURITIBA;-25.593;-49.41;True;109943;54592;54647;101380;50216;50575;8563;4376;4072
4101853;Ariranha do Ivaí;PR;41;Sul;NORTE CENTRAL PARANAENSE;IVAIPORA;-24.386;-51.585;True;2540;1310;1216;836;419;414;1704;891;802
4101903;Assaí;PR;41;Sul;NORTE PIONEIRO PARANAENSE;ASSAI;-23.373;-50.841;True;16098;7875;8217;13043;6266;6777;3055;1609;1440
4102000;Assis Chateaubriand;PR;41;Sul;OESTE PARANAENSE;TOLEDO;-24.42;-53.521;True;32226;15833;16374;27791;13570;14208;4435;2263;2166
4102109;Astorga;PR;41;Sul;NORTE CENTRAL PARANAENSE;ASTORGA;-23.233;-51.666;True;24191;11808;12210;21236;10296;10823;2955;1512;1387
4102208;Atalaia;PR;41;Sul;NORTE CENTRAL PARANAENSE;ASTORGA;-23.151;-52.054;True;3627;1826;1801;3024;1492;1532;603;334;269
4102307;Balsa Nova;PR;41;Sul;METROPOLITANA DE CURITIBA;CURITIBA;-25.584;-49.636;True;10639;5417;5222;3944;1987;1957;6695;3430;3265
4102406;Bandeirantes;PR;41;Sul;NORTE PIONEIRO PARANAENSE;CORNELIO PROCOPIO;-23.11;-50.368;True;32290;15703;16367;27785;13367;14231;4505;2336;2136
4102505;Barbosa Ferraz;PR;41;Sul;CENTRO OCIDENTAL PARANAENSE;CAMPO MOURAO;-24.03;-52.012;True;13655;6888;6743;10106;4974;5124;3549;1914;1619
4102604;Barracão;PR;41;Sul;SUDOESTE PARANAENSE;FRANCISCO BELTRAO;-26.254;-53.633;True;9027;4443;4534;6346;3070;3276;2681;1373;1258
4102703;Barra do Jacaré;PR;41;Sul;NORTE PIONEIRO PARANAENSE;JACAREZINHO;-23.115;-50.181;True;2757;1394;1363;1825;909;916;932;485;447
4102752;Bela Vista da Caroba;PR;41;Sul;SUDOESTE PARANAENSE;CAPANEMA;-25.881;-53.665;True;4136;2108;2028;804;393;411;3332;1715;1617
4102802;Bela Vista do Paraíso;PR;41;Sul;NORTE CENTRAL PARANAENSE;PORECATU;-22.997;-51.191;True;14996;7293;7649;13747;6653;7042;1249;640;607
4102901;Bituruna;PR;41;Sul;SUDESTE PARANAENSE;UNIAO DA VITORIA;-26.161;-51.553;True;16142;8292;7784;7466;3737;3709;8676;4555;4075
4103008;Boa Esperança;PR;41;Sul;CENTRO OCIDENTAL PARANAENSE;GOIOERE;-24.242;-52.789;True;4706;2356;2348;2453;1204;1247;2253;1152;1101
4103024;Boa Esperança do Iguaçu;PR;41;Sul;SUDOESTE PARANAENSE;FRANCISCO BELTRAO;-25.636;-53.212;True;2866;1452;1414;867;423;444;1999;1029;970
4103040;Boa Ventura de São Roque;PR;41;Sul;CENTRO-SUL PARANAENSE;PITANGA;-24.869;-51.628;True;6744;3446;3239;1359;658;701;5385;2788;2538
4103057;Boa Vista da Aparecida;PR;41;Sul;OESTE PARANAENSE;CASCAVEL;-25.436;-53.408;True;7818;3917;3891;4541;2230;2311;3277;1687;1580
4103107;Bocaiúva do Sul;PR;41;Sul;METROPOLITANA DE CURITIBA;CURITIBA;-25.206;-49.115;True;9533;4924;4600;4402;2189;2213;5131;2735;2387
4103156;Bom Jesus do Sul;PR;41;Sul;SUDOESTE PARANAENSE;FRANCISCO BELTRAO;-26.193;-53.597;True;3835;1966;1835;542;259;276;3293;1707;1559
4103206;Bom Sucesso;PR;41;Sul;NORTE CENTRAL PARANAENSE;FAXINAL;-23.71;-51.764;True;6397;3154;3241;5239;2542;2697;1158;612;544
4103222;Bom Sucesso do Sul;PR;41;Sul;SUDOESTE PARANAENSE;PATO BRANCO;-26.076;-52.834;True;3061;1527;1529;1329;628;701;1732;899;828
4103305;Borrazópolis;PR;41;Sul;NORTE CENTRAL PARANAENSE;FAXINAL;-23.941;-51.588;True;8275;4060;4094;5855;2819;2938;2420;1241;1156
4103354;Braganey;PR;41;Sul;OESTE PARANAENSE;CASCAVEL;-24.816;-53.122;True;6044;3108;2886;3156;1587;1545;2888;1521;1341
4103370;Brasilândia do Sul;PR;41;Sul;NOROESTE PARANAENSE;UMUARAMA;-24.197;-53.525;True;3306;1661;1643;2243;1125;1118;1063;536;525
4103404;Cafeara;PR;41;Sul;NORTE CENTRAL PARANAENSE;ASTORGA;-22.793;-51.716;True;2702;1391;1311;2059;1052;1007;643;339;304
4103453;Cafelândia;PR;41;Sul;OESTE PARANAENSE;CASCAVEL;-24.618;-53.32;True;13065;6596;6460;10711;5385;5326;2354;1211;1134
4103479;Cafezal do Sul;PR;41;Sul;NOROESTE PARANAENSE;UMUARAMA;-23.902;-53.513;True;4271;2167;2094;3149;1566;1583;1122;601;511
4103503;Califórnia;PR;41;Sul;NORTE CENTRAL PARANAENSE;APUCARANA;-23.65;-51.355;True;7546;3750;3775;5641;2770;2858;1905;980;917
4103602;Cambará;PR;41;Sul;NORTE PIONEIRO PARANAENSE;JACAREZINHO;-23.046;-50.074;True;23956;11700;12256;19371;9370;10001;4585;2330;2255
4103701;Cambé;PR;41;Sul;NORTE CENTRAL PARANAENSE;LONDRINA;-23.276;-51.278;True;92888;44076;45921;89365;42268;44227;3523;1808;1694
4103800;Cambira;PR;41;Sul;NORTE CENTRAL PARANAENSE;APUCARANA;-23.583;-51.578;True;6862;3497;3361;4919;2448;2471;1943;1049;890
4103909;Campina da Lagoa;PR;41;Sul;CENTRO OCIDENTAL PARANAENSE;GOIOERE;-24.592;-52.799;True;15983;7944;8034;12752;6226;6523;3231;1718;1511
4103958;Campina do Simão;PR;41;Sul;CENTRO-SUL PARANAENSE;GUARAPUAVA;-25.079;-51.827;True;4180;2209;1970;1412;719;693;2768;1490;1277
4104006;Campina Grande do Sul;PR;41;Sul;METROPOLITANA DE CURITIBA;CURITIBA;-25.306;-49.055;True;35396;17710;17622;27281;13527;13720;8115;4183;3902
4104055;Campo Bonito;PR;41;Sul;OESTE PARANAENSE;CASCAVEL;-25.031;-52.993;True;4426;2265;2161;2425;1210;1215;2001;1055;946
4104105;Campo do Tenente;PR;41;Sul;METROPOLITANA DE CURITIBA;RIO NEGRO;-25.978;-49.683;True;6461;3328;3122;3871;1959;1905;2590;1369;1217
4104204;Campo Largo;PR;41;Sul;METROPOLITANA DE CURITIBA;CURITIBA;-25.459;-49.528;True;105492;51315;51778;87912;42357;43503;17580;8958;8275
4104253;Campo Magro;PR;41;Sul;METROPOLITANA DE CURITIBA;CURITIBA;-25.369;-49.451;True;22325;11022;10591;17812;8739;8567;4513;2283;2024
4104303;Campo Mourão;PR;41;Sul;CENTRO OCIDENTAL PARANAENSE;CAMPO MOURAO;-24.046;-52.383;True;82530;39537;42749;77796;37098;40471;4734;2439;2278
4104402;Cândido de Abreu;PR;41;Sul;NORTE CENTRAL PARANAENSE;IVAIPORA;-24.567;-51.333;True;17775;9108;8396;4634;2272;2343;13141;6836;6053
4104428;Candói;PR;41;Sul;CENTRO-SUL PARANAENSE;GUARAPUAVA;-25.663;-52.126;True;15412;7726;7442;6542;3116;3321;8870;4610;4121
4104451;Cantagalo;PR;41;Sul;CENTRO-SUL PARANAENSE;GUARAPUAVA;-25.374;-52.126;True;12418;6277;6119;7891;3896;3984;4527;2381;2135
4104501;Capanema;PR;41;Sul;SUDOESTE PARANAENSE;CAPANEMA;-25.672;-53.809;True;18103;8888;8961;10074;4841;5233;8029;4047;3728
4104600;Capitão Leônidas Marques;PR;41;Sul;OESTE PARANAENSE;CASCAVEL;-25.479;-53.614;True;13616;6731;6864;9892;4829;5059;3724;1902;1805
4104659;Carambeí;PR;41;Sul;CENTRO ORIENTAL PARANAENSE;PONTA GROSSA;-24.918;-50.097;True;16521;8183;7988;12609;6209;6117;3912;1974;1871
4104709;Carlópolis;PR;41;Sul;NORTE PIONEIRO PARANAENSE;WENCESLAU BRAZ;-23.425;-49.721;True;13170;6700;6470;8635;4234;4401;4535;2466;2069
4104808;Cascavel;PR;41;Sul;OESTE PARANAENSE;CASCAVEL;-24.956;-53.455;True;285784;;;;;;;;
4104907;Castro;PR;41;Sul;CENTRO ORIENTAL PARANAENSE;PONTA GROSSA;-24.791;-50.012;True;65363;32255;32611;47294;22947;24096;18069;9308;8515
4105003;Catanduvas;PR;41;Sul;OESTE PARANAENSE;CASCAVEL;-25.203;-53.157;True;9578;4882;4681;5070;2511;2559;4508;2371;2122
4105102;Centenário do Sul;PR;41;Sul;NORTE CENTRAL PARANAENSE;ASTORGA;-22.821;-51.595;True;11247;5568;5655;9229;4526;4700;2018;1042;955
4105201;Cerro Azul;PR;41;Sul;METROPOLITANA DE CURITIBA;CERRO AZUL;-24.824;-49.261;True;17693;9072;8604;5733;2794;2932;11960;6278;5672
4105300;Céu Azul;PR;41;Sul;OESTE PARANAENSE;FOZ DO IGUACU;-25.147;-53.849;True;10914;5366;5541;7958;3847;4111;2956;1519;1430
4105409;Chopinzinho;PR;41;Sul;SUDOESTE PARANAENSE;PATO BRANCO;-25.856;-52.523;True;19224;9472;9583;11040;5257;5702;8184;4215;3881
4105508;Cianorte;PR;41;Sul;NOROESTE PARANAENSE;CIANORTE;-23.663;-52.605;True;64498;31322;32888;57321;27616;29460;7177;3706;3428
4105607;Cidade Gaúcha;PR;41;Sul;NOROESTE PARANAENSE;CIANORTE;-23.38;-52.945;True;10468;5222;5238;8586;4231;4355;1882;991;883
4105706;Clevelândia;PR;41;Sul;CENTRO-SUL PARANAENSE;PALMAS;-26.396;-52.471;True;17599;8646;8953;14694;7120;7574;2905;1526;1379
4105805;Colombo;PR;41;Sul;METROPOLITANA DE CURITIBA;CURITIBA;-25.292;-49.224;True;233916;;;;;;;;
4105904;Colorado;PR;41;Sul;NORTE CENTRAL PARANAENSE;ASTORGA;-22.838;-51.973;True;21049;10400;10610;19319;9496;9798;1730;904;812
4106001;Congonhinhas;PR;41;Sul;NORTE PIONEIRO PARANAENSE;CORNELIO PROCOPIO;-23.551;-50.554;True;8552;4431;4110;4811;2354;2446;3741;2077;1664
4106100;Conselheiro Mairinck;PR;41;Sul;NORTE PIONEIRO PARANAENSE;IBAITI;-23.63;-50.169;True;3554;1821;1733;2471;1256;1215;1083;565;518
4106209;Contenda;PR;41;Sul;METROPOLITANA DE CURITIBA;CURITIBA;-25.676;-49.535;True;14800;7495;7290;7983;3978;4001;6817;3517;3289
4106308;Corbélia;PR;41;Sul;OESTE PARANAENSE;CASCAVEL;-24.799;-53.307;True;15428;7632;7791;13069;6420;6649;2359;1212;1142
4106407;Cornélio Procópio;PR;41;Sul;NORTE PIONEIRO PARANAENSE;CORNELIO PROCOPIO;-23.181;-50.647;True;46931;22802;24121;43865;21181;22676;3066;1621;1445
4106456;Coronel Domingos Soares;PR;41;Sul;CENTRO-SUL PARANAENSE;PALMAS;-26.228;-52.032;True;7480;3853;3482;1440;725;715;6040;3128;2767
4106506;Coronel Vivida;PR;41;Sul;SUDOESTE PARANAENSE;PATO BRANCO;-25.98;-52.568;True;21571;10644;10898;14794;7123;7660;6777;3521;3238
4106555;Corumbataí do Sul;PR;41;Sul;CENTRO OCIDENTAL PARANAENSE;CAMPO MOURAO;-24.101;-52.12;True;4262;2194;2044;2151;1077;1074;2111;1117;970
4106571;Cruzeiro do Iguaçu;PR;41;Sul;SUDOESTE PARANAENSE;FRANCISCO BELTRAO;-25.616;-53.128;True;4150;2060;2052;2352;1132;1191;1798;928;861
4106605;Cruzeiro do Oeste;PR;41;Sul;NOROESTE PARANAENSE;UMUARAMA;-23.785;-53.073;True;20182;9903;10070;17153;8393;8749;3029;1510;1321
4106704;Cruzeiro do Sul;PR;41;Sul;NOROESTE PARANAENSE;PARANAVAI;-22.962;-52.161;True;4493;2240;2237;2834;1397;1431;1659;843;806
4106803;Cruz Machado;PR;41;Sul;SUDESTE PARANAENSE;UNIAO DA VITORIA;-26.017;-51.347;True;18329;9477;8801;4037;1963;2074;14292;7514;6727
4106852;Cruzmaltina;PR;41;Sul;NORTE CENTRAL PARANAENSE;FAXINAL;-24.013;-51.459;True;3116;1616;1500;1242;615;627;1874;1001;873
4106902;Curitiba;PR;41;Sul;METROPOLITANA DE CURITIBA;CURITIBA;-25.428;-49.273;True;1797408;;;;;;;;
4107009;Curiúva;PR;41;Sul;NORTE PIONEIRO PARANAENSE;IBAITI;-24.033;-50.458;True;14338;7088;6730;9202;4563;4549;5136;2525;2181
4107108;Diamante do Norte;PR;41;Sul;NOROESTE PARANAENSE;PARANAVAI;-22.656;-52.86;True;5611;2727;2798;4544;2214;2330;1067;513;468
4107124;Diamante do Sul;PR;41;Sul;OESTE PARANAENSE;CASCAVEL;-25.043;-52.68;True;3665;1882;1776;1380;700;680;2285;1182;1096
4107157;Diamante D'Oeste;PR;41;Sul;OESTE PARANAENSE;TOLEDO;-24.943;-54.103;True;4944;2536;2408;2318;1134;1184;2626;1402;1224
4107207;Dois Vizinhos;PR;41;Sul;SUDOESTE PARANAENSE;FRANCISCO BELTRAO;-25.734;-53.057;True;34001;16859;17120;25142;12270;12862;8859;4589;4258
4107256;Douradina;PR;41;Sul;NOROESTE PARANAENSE;UMUARAMA;-23.381;-53.292;True;6530;3295;3215;4013;1964;2029;2517;1331;1186
4107306;Doutor Camargo;PR;41;Sul;NORTE CENTRAL PARANAENSE;FLORAI;-23.556;-52.218;True;5609;2751;2839;4781;2325;2440;828;426;399
4107405;Enéas Marques;PR;41;Sul;SUDOESTE PARANAENSE;FRANCISCO BELTRAO;-25.942;-53.164;True;5974;3052;2922;1547;738;809;4427;2314;2113
4107504;Engenheiro Beltrão;PR;41;Sul;CENTRO OCIDENTAL PARANAENSE;CAMPO MOURAO;-23.797;-52.269;True;13867;6860;6921;11451;5614;5821;2416;1246;1100
4107520;Esperança Nova;PR;41;Sul;NOROESTE PARANAENSE;UMUARAMA;-23.724;-53.811;True;1887;928;959;696;331;365;1191;597;594
4107538;Entre Rios do Oeste;PR;41;Sul;OESTE PARANAENSE;TOLEDO;-24.704;-54.234;True;3842;1879;1905;2299;1128;1171;1543;751;734
4107546;Espigão Alto do Iguaçu;PR;41;Sul;CENTRO-SUL PARANAENSE;GUARAPUAVA;-25.424;-52.836;True;5104;2617;2477;1753;872;881;3351;1745;1596
4107553;Farol;PR;41;Sul;CENTRO OCIDENTAL PARANAENSE;CAMPO MOURAO;-24.1;-52.623;True;3394;1714;1662;2070;1033;1037;1324;681;625
4107603;Faxinal;PR;41;Sul;NORTE CENTRAL PARANAENSE;FAXINAL;-24.001;-51.32;True;15527;7535;7801;11318;5369;5825;4209;2166;1976
4107652;Fazenda Rio Grande;PR;41;Sul;METROPOLITANA DE CURITIBA;CURITIBA;-25.658;-49.308;True;75006;37458;37548;69781;34752;35029;5225;2706;2519
4107702;Fênix;PR;41;Sul;CENTRO OCIDENTAL PARANAENSE;CAMPO MOURAO;-23.916;-51.979;True;4871;2391;2473;3965;1922;2038;906;469;435
4107736;Fernandes Pinheiro;PR;41;Sul;SUDESTE PARANAENSE;PRUDENTOPOLIS;-25.413;-50.548;True;5688;2930;2755;1917;974;943;3771;1956;1812
4107751;Figueira;PR;41;Sul;NORTE PIONEIRO PARANAENSE;IBAITI;-23.849;-50.403;True;8380;4121;4125;7067;3463;3521;1313;658;604
4107801;Floraí;PR;41;Sul;NORTE CENTRAL PARANAENSE;FLORAI;-23.317;-52.304;True;5051;2495;2529;4471;2186;2258;580;309;271
4107850;Flor da Serra do Sul;PR;41;Sul;SUDOESTE PARANAENSE;FRANCISCO BELTRAO;-26.257;-53.307;True;4685;2371;2290;1228;588;638;3457;1783;1652
4107900;Floresta;PR;41;Sul;NORTE CENTRAL PARANAENSE;FLORAI;-23.599;-52.081;True;5215;2577;2635;4014;1960;2054;1201;617;581
4108007;Florestópolis;PR;41;Sul;NORTE CENTRAL PARANAENSE;PORECATU;-22.863;-51.387;True;11571;5911;5657;10374;5279;5095;1197;632;562
4108106;Flórida;PR;41;Sul;NORTE CENTRAL PARANAENSE;ASTORGA;-23.087;-51.954;True;2448;1235;1213;2060;1039;1021;388;196;192
4108205;Formosa do Oeste;PR;41;Sul;OESTE PARANAENSE;TOLEDO;-24.293;-53.313;True;7532;3782;3746;4741;2313;2428;2791;1469;1318
4108304;Foz do Iguaçu;PR;41;Sul;OESTE PARANAENSE;FOZ DO IGUACU;-25.548;-54.588;True;311336;;;;;;;;
4108320;Francisco Alves;PR;41;Sul;NOROESTE PARANAENSE;UMUARAMA;-24.066;-53.848;True;6342;3201;3137;4050;1983;2067;2292;1218;1070
4108403;Francisco Beltrão;PR;41;Sul;SUDOESTE PARANAENSE;FRANCISCO BELTRAO;-26.081;-53.055;True;72409;35284;37068;60798;29225;31536;11611;6059;5532
4108452;Foz do Jordão;PR;41;Sul;CENTRO-SUL PARANAENSE;GUARAPUAVA;-25.737;-52.119;True;5832;2932;2896;4071;2010;2057;1761;922;839
4108502;General Carneiro;PR;41;Sul;SUDESTE PARANAENSE;UNIAO DA VITORIA;-26.428;-51.316;True;14591;7328;7242;9954;4935;5019;4637;2393;2223
4108551;Godoy Moreira;PR;41;Sul;NORTE CENTRAL PARANAENSE;IVAIPORA;-24.177;-51.924;True;3568;1780;1720;1577;770;807;1991;1010;913
4108601;Goioerê;PR;41;Sul;CENTRO OCIDENTAL PARANAENSE;GOIOERE;-24.185;-53.028;True;28941;14039;14898;24991;12023;12964;3950;2016;1934
4108650;Goioxim;PR;41;Sul;CENTRO-SUL PARANAENSE;GUARAPUAVA;-25.195;-51.993;True;7993;4186;3777;2345;1210;1135;5648;2976;2642
4108700;Grandes Rios;PR;41;Sul;NORTE CENTRAL PARANAENSE;IVAIPORA;-24.146;-51.506;True;7641;4013;3582;3764;1900;1864;3877;2113;1718
4108809;Guaíra;PR;41;Sul;OESTE PARANAENSE;TOLEDO;-24.08;-54.256;True;28683;14047;14633;25607;12420;13184;3076;1627;1449
4108908;Guairaçá;PR;41;Sul;NOROESTE PARANAENSE;PARANAVAI;-22.934;-52.686;True;5721;2849;2860;4534;2230;2292;1187;619;568
4108957;Guamiranga;PR;41;Sul;SUDESTE PARANAENSE;PRUDENTOPOLIS;-25.191;-50.805;True;7548;3839;3709;1550;755;795;5998;3084;2914
4109005;Guapirama;PR;41;Sul;NORTE PIONEIRO PARANAENSE;WENCESLAU BRAZ;-23.516;-50.04;True;3639;1814;1825;2654;1308;1346;985;506;479
4109104;Guaporema;PR;41;Sul;NOROESTE PARANAENSE;CIANORTE;-23.343;-52.779;True;2190;1123;1067;1187;593;594;1003;530;473
4109203;Guaraci;PR;41;Sul;NORTE CENTRAL PARANAENSE;ASTORGA;-22.973;-51.65;True;4993;2384;2446;4015;1890;1991;978;494;455
4109302;Guaraniaçu;PR;41;Sul;OESTE PARANAENSE;CASCAVEL;-25.101;-52.878;True;15959;8036;7879;7946;3782;4164;8013;4254;3715
4109401;Guarapuava;PR;41;Sul;CENTRO-SUL PARANAENSE;GUARAPUAVA;-25.395;-51.458;True;164567;79879;83421;150157;72558;76752;14410;7321;6669
4109500;Guaraqueçaba;PR;41;Sul;METROPOLITANA DE CURITIBA;PARANAGUA;-25.307;-48.329;True;7732;4045;3590;2625;1302;1305;5107;2743;2285
4109609;Guaratuba;PR;41;Sul;METROPOLITANA DE CURITIBA;PARANAGUA;-25.883;-48.575;True;30793;15144;15180;27156;13392;13653;3637;1752;1527
4109658;Honório Serpa;PR;41;Sul;CENTRO-SUL PARANAENSE;PALMAS;-26.141;-52.387;True;6169;3189;2977;1352;652;700;4817;2537;2277
4109708;Ibaiti;PR;41;Sul;NORTE PIONEIRO PARANAENSE;IBAITI;-23.849;-50.188;True;28050;14194;13748;21966;10919;11000;6084;3275;2748
4109757;Ibema;PR;41;Sul;OESTE PARANAENSE;CASCAVEL;-25.106;-53.012;True;5927;2968;2959;4706;2321;2385;1221;647;574
4109807;Ibiporã;PR;41;Sul;NORTE CENTRAL PARANAENSE;LONDRINA;-23.269;-51.048;True;45158;22081;23032;42454;20636;21782;2704;1445;1250
4109906;Icaraíma;PR;41;Sul;NOROESTE PARANAENSE;UMUARAMA;-23.396;-53.614;True;9212;4619;4545;6383;3093;3245;2829;1526;1300
4110003;Iguaraçu;PR;41;Sul;NORTE CENTRAL PARANAENSE;ASTORGA;-23.197;-51.828;True;3741;1883;1819;3103;1528;1554;638;355;265
4110052;Iguatu;PR;41;Sul;OESTE PARANAENSE;CASCAVEL;-24.717;-53.084;True;2286;1159;1123;1369;666;703;917;493;420
4110078;Imbaú;PR;41;Sul;CENTRO ORIENTAL PARANAENSE;TELEMACO BORBA;-24.445;-50.761;True;11191;5759;5395;6929;3525;3385;4262;2234;2010
4110102;Imbituva;PR;41;Sul;SUDESTE PARANAENSE;PRUDENTOPOLIS;-25.23;-50.604;True;27044;13707;13337;16868;8494;8374;10176;5213;4963
4110201;Inácio Martins;PR;41;Sul;CENTRO-SUL PARANAENSE;GUARAPUAVA;-25.571;-51.079;True;11036;5705;5290;6049;3068;2965;4987;2637;2325
4110300;Inajá;PR;41;Sul;NOROESTE PARANAENSE;PARANAVAI;-22.749;-52.198;True;2810;1460;1344;2273;1175;1092;537;285;252
4110409;Indianópolis;PR;41;Sul;NOROESTE PARANAENSE;CIANORTE;-23.476;-52.696;True;4138;2066;2071;2527;1234;1293;1611;832;778
4110508;Ipiranga;PR;41;Sul;SUDESTE PARANAENSE;PRUDENTOPOLIS;-25.024;-50.584;True;13993;7210;6624;4724;2344;2362;9269;4866;4262
4110607;Iporã;PR;41;Sul;NOROESTE PARANAENSE;UMUARAMA;-24.003;-53.704;True;15086;7451;7635;11554;5629;5925;3532;1822;1710
4110656;Iracema do Oeste;PR;41;Sul;OESTE PARANAENSE;TOLEDO;-24.428;-53.355;True;2580;1311;1269;1943;962;981;637;349;288
4110706;Irati;PR;41;Sul;SUDESTE PARANAENSE;IRATI;-25.467;-50.651;True;54151;26682;27410;42196;20422;21743;11955;6260;5667
4110805;Iretama;PR;41;Sul;CENTRO OCIDENTAL PARANAENSE;CAMPO MOURAO;-24.424;-52.106;True;11174;5704;5373;5795;2883;2894;5379;2821;2479
4110904;Itaguajé;PR;41;Sul;NORTE CENTRAL PARANAENSE;ASTORGA;-22.618;-51.966;True;4508;2255;2253;3408;1683;1725;1100;572;528
4110953;Itaipulândia;PR;41;Sul;OESTE PARANAENSE;FOZ DO IGUACU;-25.137;-54.302;True;8581;4339;4240;4478;2218;2260;4103;2121;1980
4111001;Itambaracá;PR;41;Sul;NORTE PIONEIRO PARANAENSE;CORNELIO PROCOPIO;-23.018;-50.406;True;6935;3512;3423;5110;2563;2547;1825;949;876
4111100;Itambé;PR;41;Sul;NORTE CENTRAL PARANAENSE;FLORAI;-23.661;-51.99;True;5897;2895;2904;5266;2583;2630;631;312;274
4111209;Itapejara D'Oeste;PR;41;Sul;SUDOESTE PARANAENSE;PATO BRANCO;-25.965;-52.816;True;10537;5279;5247;6563;3210;3350;3974;2069;1897
4111258;Itaperuçu;PR;41;Sul;METROPOLITANA DE CURITIBA;CURITIBA;-25.22;-49.348;True;22021;11027;10821;17988;8960;8984;4033;2067;1837
4111308;Itaúna do Sul;PR;41;Sul;NOROESTE PARANAENSE;PARANAVAI;-22.731;-52.887;True;3699;1900;1797;2492;1262;1230;1207;638;567
4111407;Ivaí;PR;41;Sul;SUDESTE PARANAENSE;PRUDENTOPOLIS;-25.011;-50.859;True;12840;6656;6107;4432;2215;2195;8408;4441;3912
4111506;Ivaiporã;PR;41;Sul;NORTE CENTRAL PARANAENSE;IVAIPORA;-24.248;-51.685;True;31344;15182;15965;26397;12670;13646;4947;2512;2319
4111555;Ivaté;PR;41;Sul;NOROESTE PARANAENSE;UMUARAMA;-23.409;-53.369;True;7792;3889;3838;5158;2571;2587;2634;1318;1251
4111605;Ivatuba;PR;41;Sul;NORTE CENTRAL PARANAENSE;FLORAI;-23.619;-52.221;True;2715;1324;1391;2105;1028;1077;610;296;314
4111704;Jaboti;PR;41;Sul;NORTE PIONEIRO PARANAENSE;IBAITI;-23.743;-50.076;True;5019;2450;2337;3050;1436;1479;1969;1014;858
4111803;Jacarezinho;PR;41;Sul;NORTE PIONEIRO PARANAENSE;JACAREZINHO;-23.161;-49.969;True;39327;19288;20004;34667;16837;17821;4660;2451;2183
4111902;Jaguapitã;PR;41;Sul;NORTE CENTRAL PARANAENSE;ASTORGA;-23.113;-51.532;True;11782;5912;5867;9968;4952;5013;1814;960;854
4112009;Jaguariaíva;PR;41;Sul;CENTRO ORIENTAL PARANAENSE;JAGUARIAIVA;-24.251;-49.706;True;31865;15821;16028;27633;13612;14017;4232;2209;2011
4112108;Jandaia do Sul;PR;41;Sul;NORTE CENTRAL PARANAENSE;APUCARANA;-23.603;-51.643;True;19534;9550;9947;17449;8443;8993;2085;1107;954
4112207;Janiópolis;PR;41;Sul;CENTRO OCIDENTAL PARANAENSE;GOIOERE;-24.142;-52.782;True;7032;3533;3499;4246;2072;2174;2786;1461;1325
4112306;Japira;PR;41;Sul;NORTE PIONEIRO PARANAENSE;IBAITI;-23.813;-50.139;True;4694;2355;2255;2653;1284;1294;2041;1071;961
4112405;Japurá;PR;41;Sul;NOROESTE PARANAENSE;CIANORTE;-23.47;-52.553;True;8248;4170;4077;6436;3219;3217;1812;951;860
4112504;Jardim Alegre;PR;41;Sul;NORTE CENTRAL PARANAENSE;IVAIPORA;-24.179;-51.692;True;14315;7140;7054;7621;3661;3909;6694;3479;3145
4112603;Jardim Olinda;PR;41;Sul;NOROESTE PARANAENSE;PARANAVAI;-22.549;-52.061;True;1461;707;751;1030;499;531;431;208;220
4112702;Jataizinho;PR;41;Sul;NORTE PIONEIRO PARANAENSE;ASSAI;-23.254;-50.98;True;11244;5526;5683;10517;5131;5370;727;395;313
4112751;Jesuítas;PR;41;Sul;OESTE PARANAENSE;TOLEDO;-24.385;-53.388;True;8825;4399;4426;5507;2683;2824;3318;1716;1602
4112801;Joaquim Távora;PR;41;Sul;NORTE PIONEIRO PARANAENSE;WENCESLAU BRAZ;-23.499;-49.905;True;10247;5132;5111;7695;3769;3922;2552;1363;1189
4112900;Jundiaí do Sul;PR;41;Sul;NORTE PIONEIRO PARANAENSE;JACAREZINHO;-23.437;-50.248;True;3654;1858;1796;2063;1017;1046;1591;841;750
4112959;Juranda;PR;41;Sul;CENTRO OCIDENTAL PARANAENSE;GOIOERE;-24.42;-52.843;True;7684;3861;3823;5747;2838;2909;1937;1023;914
4113007;Jussara;PR;41;Sul;NOROESTE PARANAENSE;CIANORTE;-23.621;-52.469;True;6090;3037;3047;5241;2596;2645;849;441;402
4113106;Kaloré;PR;41;Sul;NORTE CENTRAL PARANAENSE;FAXINAL;-23.817;-51.668;True;4664;2361;2282;3110;1562;1539;1554;799;743
4113205;Lapa;PR;41;Sul;METROPOLITANA DE CURITIBA;LAPA;-25.77;-49.716;True;41679;20841;20604;24847;12075;12651;16832;8766;7953
4113254;Laranjal;PR;41;Sul;CENTRO-SUL PARANAENSE;PITANGA;-24.887;-52.469;True;6322;3256;3052;1788;908;880;4534;2348;2172
4113304;Laranjeiras do Sul;PR;41;Sul;CENTRO-SUL PARANAENSE;GUARAPUAVA;-25.408;-52.416;True;30481;14904;15541;24256;11622;12625;6225;3282;2916
4113403;Leópolis;PR;41;Sul;NORTE PIONEIRO PARANAENSE;CORNELIO PROCOPIO;-23.08;-50.751;True;4230;2099;2131;2414;1186;1228;1816;913;903
4113429;Lidianópolis;PR;41;Sul;NORTE CENTRAL PARANAENSE;IVAIPORA;-24.109;-51.653;True;4123;2033;2045;1970;946;1024;2153;1087;1021
4113452;Lindoeste;PR;41;Sul;OESTE PARANAENSE;CASCAVEL;-25.26;-53.576;True;5446;2858;2588;2352;1168;1184;3094;1690;1404
4113502;Loanda;PR;41;Sul;NOROESTE PARANAENSE;PARANAVAI;-22.923;-53.137;True;19464;9556;9824;17234;8364;8843;2230;1192;981
4113601;Lobato;PR;41;Sul;NORTE CENTRAL PARANAENSE;ASTORGA;-23.008;-51.951;True;4219;2135;2060;3492;1755;1737;727;380;323
4113700;Londrina;PR;41;Sul;NORTE CENTRAL PARANAENSE;LONDRINA;-23.31;-51.163;True;497833;;;;;;;;
4113734;Luiziana;PR;41;Sul;CENTRO OCIDENTAL PARANAENSE;CAMPO MOURAO;-24.286;-52.276;True;7204;3702;3483;4350;2201;2147;2854;1501;1336
4113759;Lunardelli;PR;41;Sul;NORTE CENTRAL PARANAENSE;IVAIPORA;-24.079;-51.738;True;5082;2534;2521;3435;1676;1735;1647;858;786
4113809;Lupionópolis;PR;41;Sul;NORTE CENTRAL PARANAENSE;ASTORGA;-22.755;-51.657;True;4375;2157;2218;3583;1735;1848;792;422;370
4113908;Mallet;PR;41;Sul;SUDESTE PARANAENSE;IRATI;-25.878;-50.821;True;12414;6400;6013;7158;3531;3627;5256;2869;2386
4114005;Mamborê;PR;41;Sul;CENTRO OCIDENTAL PARANAENSE;CAMPO MOURAO;-24.319;-52.53;True;14132;7039;7040;8990;4386;4596;5142;2653;2444
4114104;Mandaguaçu;PR;41;Sul;NORTE CENTRAL PARANAENSE;ASTORGA;-23.347;-52.095;True;18259;8962;9018;15773;7681;7842;2486;1281;1176
4114203;Mandaguari;PR;41;Sul;NORTE CENTRAL PARANAENSE;MARINGA;-23.548;-51.671;True;31890;15734;16112;29691;14558;15093;2199;1176;1019
4114302;Mandirituba;PR;41;Sul;METROPOLITANA DE CURITIBA;CURITIBA;-25.779;-49.326;True;20408;10568;9825;6804;3457;3336;13604;7111;6489
4114351;Manfrinópolis;PR;41;Sul;SUDOESTE PARANAENSE;FRANCISCO BELTRAO;-26.144;-53.311;True;3306;1769;1533;616;318;294;2690;1451;1239
4114401;Mangueirinha;PR;41;Sul;CENTRO-SUL PARANAENSE;PALMAS;-25.941;-52.176;True;17119;8531;8579;7180;3453;3727;9939;5078;4852
4114500;Manoel Ribas;PR;41;Sul;NORTE CENTRAL PARANAENSE;IVAIPORA;-24.516;-51.668;True;12762;6452;6310;6412;3149;3263;6350;3303;3047
4114609;Marechal Cândido Rondon;PR;41;Sul;OESTE PARANAENSE;TOLEDO;-24.556;-54.057;True;44562;21723;22736;35451;17042;18312;9111;4681;4424
4114708;Maria Helena;PR;41;Sul;NOROESTE PARANAENSE;UMUARAMA;-23.616;-53.205;True;6012;3029;2983;2923;1439;1484;3089;1590;1499
4114807;Marialva;PR;41;Sul;NORTE CENTRAL PARANAENSE;MARINGA;-23.485;-51.792;True;30017;14847;15055;24134;11818;12299;5883;3029;2756
4114906;Marilândia do Sul;PR;41;Sul;NORTE CENTRAL PARANAENSE;APUCARANA;-23.745;-51.308;True;8932;4457;4332;6216;3099;3105;2716;1358;1227
4115002;Marilena;PR;41;Sul;NOROESTE PARANAENSE;PARANAVAI;-22.736;-53.04;True;6541;3399;3142;4054;2059;1995;2487;1340;1147
4115101;Mariluz;PR;41;Sul;NOROESTE PARANAENSE;UMUARAMA;-24.002;-53.146;True;10461;5230;5226;8539;4216;4323;1922;1014;903
4115200;Maringá;PR;41;Sul;NORTE CENTRAL PARANAENSE;MARINGA;-23.425;-51.939;True;325968;;;;;;;;
4115309;Mariópolis;PR;41;Sul;SUDOESTE PARANAENSE;PATO BRANCO;-26.355;-52.559;True;5805;2871;2900;4105;2006;2088;1700;865;812
4115358;Maripá;PR;41;Sul;OESTE PARANAENSE;TOLEDO;-24.418;-53.83;True;5571;2744;2827;3025;1466;1559;2546;1278;1268
4115408;Marmeleiro;PR;41;Sul;SUDOESTE PARANAENSE;FRANCISCO BELTRAO;-26.149;-53.026;True;13156;6562;6594;7741;3734;4007;5415;2828;2587
4115457;Marquinho;PR;41;Sul;CENTRO-SUL PARANAENSE;GUARAPUAVA;-25.113;-52.254;True;5205;2718;2487;1028;510;518;4177;2208;1969
4115507;Marumbi;PR;41;Sul;NORTE CENTRAL PARANAENSE;FAXINAL;-23.706;-51.639;True;4142;2061;2066;3004;1472;1517;1138;589;549
4115606;Matelândia;PR;41;Sul;OESTE PARANAENSE;FOZ DO IGUACU;-25.241;-53.996;True;15404;7619;7785;11025;5305;5720;4379;2314;2065
4115705;Matinhos;PR;41;Sul;METROPOLITANA DE CURITIBA;PARANAGUA;-25.818;-48.543;True;23357;11399;11906;23204;11319;11833;153;80;73
4115739;Mato Rico;PR;41;Sul;CENTRO-SUL PARANAENSE;PITANGA;-24.705;-52.146;True;4156;2132;1869;1017;459;449;3139;1673;1420
4115754;Mauá da Serra;PR;41;Sul;NORTE CENTRAL PARANAENSE;APUCARANA;-23.901;-51.229;True;7814;3979;3822;6426;3253;3170;1388;726;652
4115804;Medianeira;PR;41;Sul;OESTE PARANAENSE;FOZ DO IGUACU;-25.295;-54.094;True;38397;18871;19521;34138;16672;17466;4259;2199;2055
4115853;Mercedes;PR;41;Sul;OESTE PARANAENSE;TOLEDO;-24.454;-54.162;True;4713;2320;2349;1864;887;961;2849;1433;1388
4115903;Mirador;PR;41;Sul;NOROESTE PARANAENSE;PARANAVAI;-23.258;-52.776;True;2336;1162;1165;1590;774;813;746;388;352
4116000;Miraselva;PR;41;Sul;NORTE CENTRAL PARANAENSE;PORECATU;-22.966;-51.455;True;1899;939;958;1352;657;695;547;282;263
4116059;Missal;PR;41;Sul;OESTE PARANAENSE;FOZ DO IGUACU;-25.092;-54.248;True;10412;5252;5126;5301;2614;2675;5111;2638;2451
4116109;Moreira Sales;PR;41;Sul;CENTRO OCIDENTAL PARANAENSE;GOIOERE;-24.062;-53.007;True;12926;6502;6424;9710;4826;4884;3216;1676;1540
4116208;Morretes;PR;41;Sul;METROPOLITANA DE CURITIBA;PARANAGUA;-25.477;-48.834;True;16198;8268;7894;7559;3752;3803;8639;4516;4091
4116307;Munhoz de Melo;PR;41;Sul;NORTE CENTRAL PARANAENSE;ASTORGA;-23.148;-51.774;True;3552;1769;1775;2771;1373;1392;781;396;383
4116406;Nossa Senhora das Graças;PR;41;Sul;NORTE CENTRAL PARANAENSE;ASTORGA;-22.914;-51.794;True;3903;2005;1885;2775;1396;1366;1128;609;519
4116505;Nova Aliança do Ivaí;PR;41;Sul;NOROESTE PARANAENSE;PARANAVAI;-23.177;-52.602;True;1377;684;689;968;483;485;409;201;204
4116604;Nova América da Colina;PR;41;Sul;NORTE PIONEIRO PARANAENSE;CORNELIO PROCOPIO;-23.331;-50.718;True;3298;1674;1619;2394;1208;1181;904;466;438
4116703;Nova Aurora;PR;41;Sul;OESTE PARANAENSE;CASCAVEL;-24.529;-53.256;True;11753;5849;5903;8726;4300;4426;3027;1549;1477
4116802;Nova Cantu;PR;41;Sul;CENTRO OCIDENTAL PARANAENSE;GOIOERE;-24.673;-52.569;True;7795;3947;3815;3578;1752;1806;4217;2195;2009
4116901;Nova Esperança;PR;41;Sul;NORTE CENTRAL PARANAENSE;ASTORGA;-23.184;-52.205;True;25719;12495;13125;22682;10932;11677;3037;1563;1448
4116950;Nova Esperança do Sudoeste;PR;41;Sul;SUDOESTE PARANAENSE;FRANCISCO BELTRAO;-25.907;-53.263;True;5182;2695;2481;1125;575;548;4057;2120;1933
4117008;Nova Fátima;PR;41;Sul;NORTE PIONEIRO PARANAENSE;CORNELIO PROCOPIO;-23.432;-50.564;True;8054;4009;4039;6291;3100;3189;1763;909;850
4117057;Nova Laranjeiras;PR;41;Sul;CENTRO-SUL PARANAENSE;GUARAPUAVA;-25.307;-52.541;True;11302;5654;5404;2030;988;1021;9272;4666;4383
4117107;Nova Londrina;PR;41;Sul;NOROESTE PARANAENSE;PARANAVAI;-22.766;-52.985;True;12619;6262;6343;10963;5422;5534;1656;840;809
4117206;Nova Olímpia;PR;41;Sul;NOROESTE PARANAENSE;UMUARAMA;-23.472;-53.089;True;5227;2535;2679;4390;2116;2266;837;419;413
4117214;Nova Santa Bárbara;PR;41;Sul;NORTE PIONEIRO PARANAENSE;ASSAI;-23.597;-50.724;True;3802;1838;1954;2998;1420;1573;804;418;381
4117222;Nova Santa Rosa;PR;41;Sul;OESTE PARANAENSE;TOLEDO;-24.466;-53.953;True;7582;3761;3821;4179;2046;2133;3403;1715;1688
4117255;Nova Prata do Iguaçu;PR;41;Sul;SUDOESTE PARANAENSE;FRANCISCO BELTRAO;-25.633;-53.347;True;10452;5242;5192;5950;2885;3065;4502;2357;2127
4117271;Nova Tebas;PR;41;Sul;NORTE CENTRAL PARANAENSE;IVAIPORA;-24.438;-51.945;True;8317;4232;3991;3123;1524;1587;5194;2708;2404
4117297;Novo Itacolomi;PR;41;Sul;NORTE CENTRAL PARANAENSE;APUCARANA;-23.764;-51.507;True;2747;1440;1303;1438;756;678;1309;684;625
4117305;Ortigueira;PR;41;Sul;CENTRO ORIENTAL PARANAENSE;TELEMACO BORBA;-24.208;-50.949;True;24397;12463;11474;8807;4316;4449;15590;8147;7025
4117404;Ourizona;PR;41;Sul;NORTE CENTRAL PARANAENSE;FLORAI;-23.405;-52.199;True;3296;1653;1642;2836;1407;1428;460;246;214
4117453;Ouro Verde do Oeste;PR;41;Sul;OESTE PARANAENSE;TOLEDO;-24.805;-53.903;True;5465;2757;2663;3747;1858;1886;1718;899;777
4117503;Paiçandu;PR;41;Sul;NORTE CENTRAL PARANAENSE;MARINGA;-23.458;-52.049;True;34640;17134;17353;34076;16874;17120;564;260;233
4117602;Palmas;PR;41;Sul;CENTRO-SUL PARANAENSE;PALMAS;-26.484;-51.991;True;40485;19999;20441;36528;17859;18646;3957;2140;1795
4117701;Palmeira;PR;41;Sul;CENTRO ORIENTAL PARANAENSE;PONTA GROSSA;-25.429;-50.006;True;31234;15575;15519;18480;8972;9469;12754;6603;6050
4117800;Palmital;PR;41;Sul;CENTRO-SUL PARANAENSE;PITANGA;-24.893;-52.203;True;15454;7770;7629;7225;3461;3764;8229;4309;3865
4117909;Palotina;PR;41;Sul;OESTE PARANAENSE;TOLEDO;-24.284;-53.84;True;27545;13487;14056;23086;11242;11842;4459;2245;2214
4118006;Paraíso do Norte;PR;41;Sul;NOROESTE PARANAENSE;PARANAVAI;-23.281;-52.602;True;11169;5616;5530;9473;4733;4738;1696;883;792
4118105;Paranacity;PR;41;Sul;NOROESTE PARANAENSE;PARANAVAI;-22.93;-52.151;True;9513;4723;4757;8026;3954;4072;1487;769;685
4118204;Paranaguá;PR;41;Sul;METROPOLITANA DE CURITIBA;PARANAGUA;-25.52;-48.509;True;133559;66045;66935;128254;63270;64519;5305;2775;2416
4118303;Paranapoema;PR;41;Sul;NOROESTE PARANAENSE;PARANAVAI;-22.634;-52.098;True;2656;1315;1341;2356;1154;1202;300;161;139
4118402;Paranavaí;PR;41;Sul;NOROESTE PARANAENSE;PARANAVAI;-23.073;-52.465;True;79110;37858;41105;73463;34957;38362;5647;2901;2743
4118451;Pato Bragado;PR;41;Sul;OESTE PARANAENSE;TOLEDO;-24.626;-54.225;True;4631;2289;2340;2995;1451;1542;1636;838;798
4118501;Pato Branco;PR;41;Sul;SUDOESTE PARANAENSE;PATO BRANCO;-26.229;-52.671;True;66680;32131;34528;61984;29696;32270;4696;2435;2258
4118600;Paula Freitas;PR;41;Sul;SUDESTE PARANAENSE;UNIAO DA VITORIA;-26.208;-50.938;True;5457;2840;2601;2520;1267;1250;2937;1573;1351
4118709;Paulo Frontin;PR;41;Sul;SUDESTE PARANAENSE;UNIAO DA VITORIA;-26.04;-50.836;True;7032;3579;3238;1983;925;998;5049;2654;2240
4118808;Peabiru;PR;41;Sul;CENTRO OCIDENTAL PARANAENSE;CAMPO MOURAO;-23.913;-52.343;True;13029;6416;6610;10773;5211;5559;2256;1205;1051
4118857;Perobal;PR;41;Sul;NOROESTE PARANAENSE;UMUARAMA;-23.896;-53.41;True;5055;2569;2486;2788;1369;1419;2267;1200;1067
4118907;Pérola;PR;41;Sul;NOROESTE PARANAENSE;UMUARAMA;-23.805;-53.684;True;9334;4609;4718;7157;3483;3670;2177;1126;1048
4119004;Pérola D'Oeste;PR;41;Sul;SUDOESTE PARANAENSE;CAPANEMA;-25.824;-53.74;True;7046;3480;3395;2934;1342;1457;4112;2138;1938
4119103;Piên;PR;41;Sul;METROPOLITANA DE CURITIBA;RIO NEGRO;-26.098;-49.429;True;11083;5735;5323;3473;1787;1676;7610;3948;3647
4119152;Pinhais;PR;41;Sul;METROPOLITANA DE CURITIBA;CURITIBA;-25.445;-49.193;True;112038;54809;57214;112038;54809;57214;;;
4119202;Pinhalão;PR;41;Sul;NORTE PIONEIRO PARANAENSE;IBAITI;-23.793;-50.056;True;5893;2997;2896;3853;1901;1952;2040;1096;944
4119251;Pinhal de São Bento;PR;41;Sul;SUDOESTE PARANAENSE;FRANCISCO BELTRAO;-26.03;-53.483;True;2524;1319;1202;857;431;423;1667;888;779
4119301;Pinhão;PR;41;Sul;CENTRO-SUL PARANAENSE;GUARAPUAVA;-25.696;-51.66;True;29113;14509;14476;14346;6951;7395;14767;7558;7081
4119400;Piraí do Sul;PR;41;Sul;CENTRO ORIENTAL PARANAENSE;JAGUARIAIVA;-24.526;-49.949;True;23170;11483;11532;16087;7844;8238;7083;3639;3294
4119509;Piraquara;PR;41;Sul;METROPOLITANA DE CURITIBA;CURITIBA;-25.442;-49.063;True;82006;42431;39281;37579;18375;19028;44427;24056;20253
4119608;Pitanga;PR;41;Sul;CENTRO-SUL PARANAENSE;PITANGA;-24.757;-51.761;True;34310;17046;16846;18865;9020;9550;15445;8026;7296
4119657;Pitangueiras;PR;41;Sul;NORTE CENTRAL PARANAENSE;LONDRINA;-23.231;-51.586;True;2664;1322;1319;1903;952;948;761;370;371
4119707;Planaltina do Paraná;PR;41;Sul;NOROESTE PARANAENSE;PARANAVAI;-23.007;-52.914;True;3791;1892;1882;2539;1238;1288;1252;654;594
4119806;Planalto;PR;41;Sul;SUDOESTE PARANAENSE;CAPANEMA;-25.716;-53.766;True;13649;6873;6756;5276;2491;2785;8373;4382;3971
4119905;Ponta Grossa;PR;41;Sul;CENTRO ORIENTAL PARANAENSE;PONTA GROSSA;-25.095;-50.162;True;306351;;;;;;;;
4119954;Pontal do Paraná;PR;41;Sul;METROPOLITANA DE CURITIBA;PARANAGUA;-25.674;-48.511;True;16625;8243;8288;16455;8166;8195;170;77;93
4120002;Porecatu;PR;41;Sul;NORTE CENTRAL PARANAENSE;PORECATU;-22.756;-51.379;True;14174;6669;6971;11286;5417;5756;2888;1252;1215
4120101;Porto Amazonas;PR;41;Sul;METROPOLITANA DE CURITIBA;LAPA;-25.545;-49.89;True;4212;2088;2091;2808;1382;1396;1404;706;695
4120150;Porto Barreiro;PR;41;Sul;CENTRO-SUL PARANAENSE;GUARAPUAVA;-25.547;-52.408;True;3761;1944;1813;700;333;367;3061;1611;1446
4120200;Porto Rico;PR;41;Sul;NOROESTE PARANAENSE;PARANAVAI;-22.772;-53.267;True;2462;1252;1201;1662;820;842;800;432;359
4120309;Porto Vitória;PR;41;Sul;SUDESTE PARANAENSE;UNIAO DA VITORIA;-26.161;-51.232;True;3779;1930;1812;2149;1088;1055;1630;842;757
4120333;Prado Ferreira;PR;41;Sul;NORTE CENTRAL PARANAENSE;PORECATU;-23.039;-51.442;True;3344;1666;1678;2862;1423;1439;482;243;239
4120358;Pranchita;PR;41;Sul;SUDOESTE PARANAENSE;CAPANEMA;-26.02;-53.74;True;5811;2868;2874;3494;1674;1761;2317;1194;1113
4120408;Presidente Castelo Branco;PR;41;Sul;NORTE CENTRAL PARANAENSE;ASTORGA;-23.278;-52.152;True;4674;2402;2253;3533;1777;1737;1141;625;516
4120507;Primeiro de Maio;PR;41;Sul;NORTE CENTRAL PARANAENSE;PORECATU;-22.851;-51.028;True;10753;5329;5384;9762;4801;4921;991;528;463
4120606;Prudentópolis;PR;41;Sul;SUDESTE PARANAENSE;PRUDENTOPOLIS;-25.213;-50.978;True;48708;24812;23403;21661;10446;11063;27047;14366;12340
4120655;Quarto Centenário;PR;41;Sul;CENTRO OCIDENTAL PARANAENSE;GOIOERE;-24.279;-53.076;True;4848;2438;2409;2803;1395;1408;2045;1043;1001
4120705;Quatiguá;PR;41;Sul;NORTE PIONEIRO PARANAENSE;WENCESLAU BRAZ;-23.567;-49.914;True;6877;3380;3486;6124;3004;3117;753;376;369
4120804;Quatro Barras;PR;41;Sul;METROPOLITANA DE CURITIBA;CURITIBA;-25.366;-49.077;True;18125;9058;9036;16208;8045;8132;1917;1013;904
4120853;Quatro Pontes;PR;41;Sul;OESTE PARANAENSE;TOLEDO;-24.575;-53.977;True;3669;1802;1855;2091;984;1095;1578;818;760
4120903;Quedas do Iguaçu;PR;41;Sul;CENTRO-SUL PARANAENSE;GUARAPUAVA;-25.45;-52.908;True;30181;15305;14802;19973;9845;10110;10208;5460;4692
4121000;Querência do Norte;PR;41;Sul;NOROESTE PARANAENSE;PARANAVAI;-23.084;-53.484;True;11804;5975;5734;7156;3519;3583;4648;2456;2151
4121109;Quinta do Sol;PR;41;Sul;CENTRO OCIDENTAL PARANAENSE;CAMPO MOURAO;-23.852;-52.13;True;5173;2566;2560;3712;1811;1887;1461;755;673
4121208;Quitandinha;PR;41;Sul;METROPOLITANA DE CURITIBA;RIO NEGRO;-25.872;-49.498;True;15897;8107;7547;3335;1647;1673;12562;6460;5874
4121257;Ramilândia;PR;41;Sul;OESTE PARANAENSE;FOZ DO IGUACU;-25.12;-54.025;True;4147;2145;1990;1992;981;999;2155;1164;991
4121307;Rancho Alegre;PR;41;Sul;NORTE PIONEIRO PARANAENSE;ASSAI;-23.07;-50.913;True;4001;1959;1993;3549;1745;1791;452;214;202
4121356;Rancho Alegre D'Oeste;PR;41;Sul;CENTRO OCIDENTAL PARANAENSE;GOIOERE;-24.307;-52.954;True;2928;1467;1461;2184;1104;1080;744;363;381
4121406;Realeza;PR;41;Sul;SUDOESTE PARANAENSE;CAPANEMA;-25.767;-53.527;True;15809;7762;8027;10603;5096;5503;5206;2666;2524
4121505;Rebouças;PR;41;Sul;SUDESTE PARANAENSE;IRATI;-25.621;-50.693;True;14053;7122;6846;7298;3604;3694;6755;3518;3152
4121604;Renascença;PR;41;Sul;SUDOESTE PARANAENSE;FRANCISCO BELTRAO;-26.158;-52.969;True;6762;3369;3342;3179;1524;1652;3583;1845;1690
4121703;Reserva;PR;41;Sul;CENTRO ORIENTAL PARANAENSE;TELEMACO BORBA;-24.65;-50.851;True;24249;12328;11701;10785;5203;5450;13464;7125;6251
4121752;Reserva do Iguaçu;PR;41;Sul;CENTRO-SUL PARANAENSE;GUARAPUAVA;-25.839;-52.028;True;7094;3608;3430;3652;1810;1809;3442;1798;1621
4121802;Ribeirão Claro;PR;41;Sul;NORTE PIONEIRO PARANAENSE;JACAREZINHO;-23.194;-49.758;True;10882;5418;5463;7087;3415;3672;3795;2003;1791
4121901;Ribeirão do Pinhal;PR;41;Sul;NORTE PIONEIRO PARANAENSE;CORNELIO PROCOPIO;-23.408;-50.357;True;13389;6627;6722;10907;5329;5549;2482;1298;1173
4122008;Rio Azul;PR;41;Sul;SUDESTE PARANAENSE;IRATI;-25.733;-50.796;True;13248;6922;6321;4316;2098;2217;8932;4824;4104
4122107;Rio Bom;PR;41;Sul;NORTE CENTRAL PARANAENSE;FAXINAL;-23.762;-51.411;True;3260;1691;1569;1918;963;955;1342;728;614
4122156;Rio Bonito do Iguaçu;PR;41;Sul;CENTRO-SUL PARANAENSE;GUARAPUAVA;-25.491;-52.526;True;14450;7520;6788;2985;1406;1477;11465;6114;5311
4122172;Rio Branco do Ivaí;PR;41;Sul;NORTE CENTRAL PARANAENSE;IVAIPORA;-24.324;-51.313;True;3850;1840;1868;1286;605;654;2564;1235;1214
4122206;Rio Branco do Sul;PR;41;Sul;METROPOLITANA DE CURITIBA;CURITIBA;-25.19;-49.314;True;31486;15813;15220;21356;10484;10567;10130;5329;4653
4122305;Rio Negro;PR;41;Sul;METROPOLITANA DE CURITIBA;RIO NEGRO;-26.106;-49.798;True;29862;14876;14978;23258;11373;11883;6604;3503;3095
4122404;Rolândia;PR;41;Sul;NORTE CENTRAL PARANAENSE;LONDRINA;-23.31;-51.369;True;53437;26141;27004;50185;24443;25468;3252;1698;1536
4122503;Roncador;PR;41;Sul;CENTRO OCIDENTAL PARANAENSE;CAMPO MOURAO;-24.603;-52.275;True;12265;6215;5988;7159;3513;3616;5106;2702;2372
4122602;Rondon;PR;41;Sul;NOROESTE PARANAENSE;CIANORTE;-23.411;-52.761;True;9023;4534;4462;6797;3356;3438;2226;1178;1024
4122651;Rosário do Ivaí;PR;41;Sul;NORTE CENTRAL PARANAENSE;IVAIPORA;-24.278;-51.275;True;5823;2960;2812;2698;1344;1346;3125;1616;1466
4122701;Sabáudia;PR;41;Sul;NORTE CENTRAL PARANAENSE;APUCARANA;-23.318;-51.553;True;5447;2752;2652;4292;2161;2122;1155;591;530
4122800;Salgado Filho;PR;41;Sul;SUDOESTE PARANAENSE;FRANCISCO BELTRAO;-26.17;-53.361;True;4666;2414;2233;2121;1076;1037;2545;1338;1196
4122909;Salto do Itararé;PR;41;Sul;NORTE PIONEIRO PARANAENSE;WENCESLAU BRAZ;-23.601;-49.626;True;5087;2582;2487;3441;1707;1719;1646;875;768
4123006;Salto do Lontra;PR;41;Sul;SUDOESTE PARANAENSE;FRANCISCO BELTRAO;-25.784;-53.309;True;12480;6301;6172;6063;2938;3125;6417;3363;3047
4123105;Santa Amélia;PR;41;Sul;NORTE PIONEIRO PARANAENSE;CORNELIO PROCOPIO;-23.266;-50.424;True;4062;2048;1992;2936;1452;1466;1126;596;526
4123204;Santa Cecília do Pavão;PR;41;Sul;NORTE PIONEIRO PARANAENSE;ASSAI;-23.517;-50.784;True;3676;1833;1843;2978;1437;1541;698;396;302
4123303;Santa Cruz de Monte Castelo;PR;41;Sul;NOROESTE PARANAENSE;PARANAVAI;-22.953;-53.297;True;7924;3929;3939;5278;2553;2687;2646;1376;1252
4123402;Santa Fé;PR;41;Sul;NORTE CENTRAL PARANAENSE;ASTORGA;-23.038;-51.805;True;9774;4824;4950;8047;3930;4117;1727;894;833
4123501;Santa Helena;PR;41;Sul;OESTE PARANAENSE;TOLEDO;-24.86;-54.333;True;22794;11301;11493;10344;4974;5370;12450;6327;6123
4123600;Santa Inês;PR;41;Sul;NORTE CENTRAL PARANAENSE;ASTORGA;-22.638;-51.903;True;1878;955;913;1190;602;578;688;353;335
4123709;Santa Isabel do Ivaí;PR;41;Sul;NOROESTE PARANAENSE;PARANAVAI;-23.003;-53.197;True;8509;4283;4210;6656;3284;3360;1853;999;850
4123808;Santa Izabel do Oeste;PR;41;Sul;SUDOESTE PARANAENSE;CAPANEMA;-25.821;-53.484;True;11434;5630;5734;6344;3038;3269;5090;2592;2465
4123824;Santa Lúcia;PR;41;Sul;OESTE PARANAENSE;CASCAVEL;-25.407;-53.566;True;3725;1877;1848;2165;1049;1116;1560;828;732
4123857;Santa Maria do Oeste;PR;41;Sul;CENTRO-SUL PARANAENSE;PITANGA;-24.939;-51.863;True;11548;5941;5591;2875;1419;1456;8673;4522;4135
4123907;Santa Mariana;PR;41;Sul;NORTE PIONEIRO PARANAENSE;CORNELIO PROCOPIO;-23.151;-50.519;True;11992;5833;5863;7981;3840;4022;4011;1993;1841
4123956;Santa Mônica;PR;41;Sul;NOROESTE PARANAENSE;PARANAVAI;-23.108;-53.109;True;3453;1778;1675;1437;734;703;2016;1044;972
4124004;Santana do Itararé;PR;41;Sul;NORTE PIONEIRO PARANAENSE;WENCESLAU BRAZ;-23.755;-49.629;True;5537;2814;2723;3546;1744;1802;1991;1070;921
4124020;Santa Tereza do Oeste;PR;41;Sul;OESTE PARANAENSE;CASCAVEL;-25.052;-53.633;True;9378;4695;4683;7049;3485;3564;2329;1210;1119
4124053;Santa Terezinha de Itaipu;PR;41;Sul;OESTE PARANAENSE;FOZ DO IGUACU;-25.447;-54.401;True;19552;9579;9963;17100;8326;8764;2452;1253;1199
4124103;Santo Antônio da Platina;PR;41;Sul;NORTE PIONEIRO PARANAENSE;JACAREZINHO;-23.295;-50.077;True;40480;19822;20585;34194;16557;17601;6286;3265;2984
4124202;Santo Antônio do Caiuá;PR;41;Sul;NOROESTE PARANAENSE;PARANAVAI;-22.735;-52.342;True;2692;1332;1354;1911;918;987;781;414;367
4124301;Santo Antônio do Paraíso;PR;41;Sul;NORTE PIONEIRO PARANAENSE;CORNELIO PROCOPIO;-23.494;-50.646;True;2354;1162;1179;1765;856;896;589;306;283
4124400;Santo Antônio do Sudoeste;PR;41;Sul;SUDOESTE PARANAENSE;FRANCISCO BELTRAO;-26.07;-53.723;True;18565;9146;9385;12186;5863;6293;6379;3283;3092
4124509;Santo Inácio;PR;41;Sul;NORTE CENTRAL PARANAENSE;ASTORGA;-22.698;-51.794;True;4876;2457;2419;4029;2016;2013;847;441;406
4124608;São Carlos do Ivaí;PR;41;Sul;NOROESTE PARANAENSE;PARANAVAI;-23.315;-52.476;True;5817;2988;2827;5173;2647;2524;644;341;303
4124707;São Jerônimo da Serra;PR;41;Sul;NORTE PIONEIRO PARANAENSE;ASSAI;-23.728;-50.741;True;11563;5798;5361;5871;2799;2828;5692;2999;2533
4124806;São João;PR;41;Sul;SUDOESTE PARANAENSE;PATO BRANCO;-25.828;-52.725;True;10900;5395;5422;6380;3088;3289;4520;2307;2133
4124905;São João do Caiuá;PR;41;Sul;NOROESTE PARANAENSE;PARANAVAI;-22.852;-52.337;True;5979;2956;2987;5009;2455;2518;970;501;469
4125001;São João do Ivaí;PR;41;Sul;NORTE CENTRAL PARANAENSE;IVAIPORA;-23.98;-51.818;True;11854;5826;5941;9000;4353;4615;2854;1473;1326
4125100;São João do Triunfo;PR;41;Sul;SUDESTE PARANAENSE;SAO MATEUS DO SUL;-25.683;-50.297;True;13611;7207;6386;3815;1904;1911;9796;5303;4475
4125209;São Jorge D'Oeste;PR;41;Sul;SUDOESTE PARANAENSE;FRANCISCO BELTRAO;-25.706;-52.918;True;8979;4394;4432;4820;2279;2483;4159;2115;1949
4125308;São Jorge do Ivaí;PR;41;Sul;NORTE CENTRAL PARANAENSE;FLORAI;-23.433;-52.293;True;5286;2589;2666;4239;2028;2190;1047;561;476
4125357;São Jorge do Patrocínio;PR;41;Sul;NOROESTE PARANAENSE;UMUARAMA;-23.741;-53.927;True;6031;3055;2963;3464;1725;1739;2567;1330;1224
4125407;São José da Boa Vista;PR;41;Sul;NORTE PIONEIRO PARANAENSE;WENCESLAU BRAZ;-23.916;-49.652;True;6293;3249;3018;3512;1761;1745;2781;1488;1273
4125456;São José das Palmeiras;PR;41;Sul;OESTE PARANAENSE;TOLEDO;-24.838;-54.064;True;3873;1954;1919;2284;1113;1171;1589;841;748
4125506;São José dos Pinhais;PR;41;Sul;METROPOLITANA DE CURITIBA;CURITIBA;-25.535;-49.206;True;263622;;;;;;;;
4125555;São Manoel do Paraná;PR;41;Sul;NOROESTE PARANAENSE;CIANORTE;-23.403;-52.644;True;2093;1069;1024;1119;562;557;974;507;467
4125605;São Mateus do Sul;PR;41;Sul;SUDESTE PARANAENSE;SAO MATEUS DO SUL;-25.874;-50.383;True;39152;19661;19344;24028;11783;12239;15124;7878;7105
4125704;São Miguel do Iguaçu;PR;41;Sul;OESTE PARANAENSE;FOZ DO IGUACU;-25.348;-54.238;True;25341;12689;12608;14823;7314;7509;10518;5375;5099
4125753;São Pedro do Iguaçu;PR;41;Sul;OESTE PARANAENSE;TOLEDO;-24.936;-53.855;True;6540;3383;3128;3862;1967;1895;2678;1416;1233
4125803;São Pedro do Ivaí;PR;41;Sul;NORTE CENTRAL PARANAENSE;IVAIPORA;-23.865;-51.856;True;9569;4843;4721;7886;3954;3932;1683;889;789
4125902;São Pedro do Paraná;PR;41;Sul;NOROESTE PARANAENSE;PARANAVAI;-22.824;-53.22;True;2532;1280;1241;1486;736;750;1046;544;491
4126009;São Sebastião da Amoreira;PR;41;Sul;NORTE PIONEIRO PARANAENSE;ASSAI;-23.465;-50.761;True;8681;4218;4433;7510;3623;3881;1171;595;552
4126108;São Tomé;PR;41;Sul;NOROESTE PARANAENSE;CIANORTE;-23.538;-52.591;True;5279;2661;2615;3898;1947;1951;1381;714;664
4126207;Sapopema;PR;41;Sul;NORTE PIONEIRO PARANAENSE;IBAITI;-23.911;-50.58;True;6638;3428;3117;3399;1725;1674;3239;1703;1443
4126256;Sarandi;PR;41;Sul;NORTE CENTRAL PARANAENSE;MARINGA;-23.444;-51.874;True;79686;39119;40079;78040;38307;39336;1646;812;743
4126272;Saudade do Iguaçu;PR;41;Sul;SUDOESTE PARANAENSE;PATO BRANCO;-25.694;-52.619;True;4931;2493;2399;2316;1145;1163;2615;1348;1236
4126306;Sengés;PR;41;Sul;CENTRO ORIENTAL PARANAENSE;JAGUARIAIVA;-24.113;-49.464;True;19356;9845;9265;14954;7520;7271;4402;2325;1994
4126355;Serranópolis do Iguaçu;PR;41;Sul;OESTE PARANAENSE;FOZ DO IGUACU;-25.38;-54.052;True;4327;2124;2203;2030;971;1059;2297;1153;1144
4126405;Sertaneja;PR;41;Sul;NORTE PIONEIRO PARANAENSE;CORNELIO PROCOPIO;-23.037;-50.838;True;5894;2915;2974;5068;2480;2588;826;435;386
4126504;Sertanópolis;PR;41;Sul;NORTE CENTRAL PARANAENSE;PORECATU;-23.059;-51.036;True;15485;7599;7752;13510;6579;6816;1975;1020;936
4126603;Siqueira Campos;PR;41;Sul;NORTE PIONEIRO PARANAENSE;WENCESLAU BRAZ;-23.689;-49.834;True;16663;8261;8356;12135;5925;6190;4528;2336;2166
4126652;Sulina;PR;41;Sul;SUDOESTE PARANAENSE;PATO BRANCO;-25.702;-52.722;True;3445;1757;1684;1319;646;669;2126;1111;1015
4126678;Tamarana;PR;41;Sul;NORTE CENTRAL PARANAENSE;LONDRINA;-23.723;-51.097;True;10887;5589;5291;5338;2691;2645;5549;2898;2646
4126702;Tamboara;PR;41;Sul;NOROESTE PARANAENSE;PARANAVAI;-23.2;-52.469;True;4564;2251;2309;3930;1929;2001;634;322;308
4126801;Tapejara;PR;41;Sul;NOROESTE PARANAENSE;CIANORTE;-23.733;-52.873;True;14498;7328;7152;12594;6340;6245;1904;988;907
4126900;Tapira;PR;41;Sul;NOROESTE PARANAENSE;UMUARAMA;-23.323;-53.068;True;5829;2864;2945;3404;1633;1771;2425;1231;1174
4127007;Teixeira Soares;PR;41;Sul;SUDESTE PARANAENSE;PRUDENTOPOLIS;-25.368;-50.461;True;9781;4982;4728;4499;2270;2196;5282;2712;2532
4127106;Telêmaco Borba;PR;41;Sul;CENTRO ORIENTAL PARANAENSE;TELEMACO BORBA;-24.324;-50.616;True;65797;31723;32457;63544;30588;31349;2253;1135;1108
4127205;Terra Boa;PR;41;Sul;CENTRO OCIDENTAL PARANAENSE;CAMPO MOURAO;-23.768;-52.444;True;14588;7277;7307;12042;5927;6115;2546;1350;1192
4127304;Terra Rica;PR;41;Sul;NOROESTE PARANAENSE;PARANAVAI;-22.709;-52.617;True;14405;7209;7174;11394;5617;5758;3011;1592;1416
4127403;Terra Roxa;PR;41;Sul;OESTE PARANAENSE;TOLEDO;-24.157;-54.097;True;16208;8026;8169;12087;5864;6212;4121;2162;1957
4127502;Tibagi;PR;41;Sul;CENTRO ORIENTAL PARANAENSE;TELEMACO BORBA;-24.509;-50.414;True;18710;9521;9189;11197;5516;5681;7513;4005;3508
4127601;Tijucas do Sul;PR;41;Sul;METROPOLITANA DE CURITIBA;RIO NEGRO;-25.928;-49.199;True;13091;6822;6233;1803;914;889;11288;5908;5344
4127700;Toledo;PR;41;Sul;OESTE PARANAENSE;TOLEDO;-24.714;-53.743;True;109857;54118;55659;98606;48292;50237;11251;5826;5422
4127809;Tomazina;PR;41;Sul;NORTE PIONEIRO PARANAENSE;WENCESLAU BRAZ;-23.778;-49.95;True;8814;4543;4259;3868;1893;1967;4946;2650;2292
4127858;Três Barras do Paraná;PR;41;Sul;OESTE PARANAENSE;CASCAVEL;-25.419;-53.181;True;11718;5937;5719;5346;2625;2721;6372;3312;2998
4127882;Tunas do Paraná;PR;41;Sul;METROPOLITANA DE CURITIBA;CURITIBA;-24.974;-49.086;True;5921;3058;2855;2770;1391;1379;3151;1667;1476
4127908;Tuneiras do Oeste;PR;41;Sul;NOROESTE PARANAENSE;CIANORTE;-23.871;-52.876;True;8598;4381;4210;5602;2804;2798;2996;1577;1412
4127957;Tupãssi;PR;41;Sul;OESTE PARANAENSE;TOLEDO;-24.588;-53.512;True;7755;3900;3827;5576;2774;2800;2179;1126;1027
4127965;Turvo;PR;41;Sul;CENTRO-SUL PARANAENSE;GUARAPUAVA;-25.043;-51.53;True;14025;7136;6827;4733;2310;2417;9292;4826;4410
4128005;Ubiratã;PR;41;Sul;CENTRO OCIDENTAL PARANAENSE;GOIOERE;-24.545;-52.988;True;21214;10300;10896;17468;8384;9068;3746;1916;1828
4128104;Umuarama;PR;41;Sul;NOROESTE PARANAENSE;UMUARAMA;-23.766;-53.325;True;95153;46052;49079;88382;42509;45851;6771;3543;3228
4128203;União da Vitória;PR;41;Sul;SUDESTE PARANAENSE;UNIAO DA VITORIA;-26.23;-51.086;True;51043;25017;26005;48030;23355;24657;3013;1662;1348
4128302;Uniflor;PR;41;Sul;NORTE CENTRAL PARANAENSE;ASTORGA;-23.087;-52.157;True;2402;1216;1186;1691;850;841;711;366;345
4128401;Uraí;PR;41;Sul;NORTE PIONEIRO PARANAENSE;ASSAI;-23.198;-50.796;True;11489;5660;5709;9192;4472;4605;2297;1188;1104
4128500;Wenceslau Braz;PR;41;Sul;NORTE PIONEIRO PARANAENSE;WENCESLAU BRAZ;-23.874;-49.803;True;18691;9181;9357;14668;7057;7512;4023;2124;1845
4128534;Ventania;PR;41;Sul;CENTRO ORIENTAL PARANAENSE;TELEMACO BORBA;-24.246;-50.243;True;10275;5363;4892;6766;3500;3254;3509;1863;1638
4128559;Vera Cruz do Oeste;PR;41;Sul;OESTE PARANAENSE;FOZ DO IGUACU;-25.058;-53.877;True;9099;4496;4597;6816;3331;3482;2283;1165;1115
4128609;Verê;PR;41;Sul;SUDOESTE PARANAENSE;FRANCISCO BELTRAO;-25.881;-52.908;True;8002;4053;3914;3212;1595;1603;4790;2458;2311
4128625;Vila Alta;PR;41;Sul;NOROESTE PARANAENSE;UMUARAMA;-23.508;-53.728;True;3252;1640;1612;1774;886;888;1478;754;724
4128633;Doutor Ulysses;PR;41;Sul;METROPOLITANA DE CURITIBA;CERRO AZUL;-24.568;-49.42;True;5956;2800;2580;1077;493;498;4879;2307;2082
4128658;Virmond;PR;41;Sul;CENTRO-SUL PARANAENSE;GUARAPUAVA;-25.381;-52.199;True;4024;2054;1966;1773;884;889;2251;1170;1077
4128708;Vitorino;PR;41;Sul;SUDOESTE PARANAENSE;PATO BRANCO;-26.277;-52.784;True;6310;3149;3143;3455;1695;1760;2855;1454;1383
4128807;Xambrê;PR;41;Sul;NOROESTE PARANAENSE;UMUARAMA;-23.736;-53.49;True;5818;2896;2908;2010;973;1037;3808;1923;1871
4200051;Abdon Batista;SC;42;Sul;SERRANA;CURITIBANOS;-27.611;-51.023;True;2726;1371;1266;756;375;378;1970;996;888
4200101;Abelardo Luz;SC;42;Sul;OESTE CATARINENSE;XANXERE;-26.565;-52.328;True;16374;8346;8028;7747;3757;3990;8627;4589;4038
4200200;Agrolândia;SC;42;Sul;VALE DO ITAJAI;ITUPORANGA;-27.412;-49.826;True;9080;4459;4406;5662;2736;2840;3418;1723;1566
4200309;Agronômica;SC;42;Sul;VALE DO ITAJAI;RIO DO SUL;-27.265;-49.711;True;4677;2390;2275;1567;786;775;3110;1604;1500
4200408;Água Doce;SC;42;Sul;OESTE CATARINENSE;JOACABA;-26.998;-51.556;True;6756;3428;3264;3329;1614;1695;3427;1814;1569
4200507;Águas de Chapecó;SC;42;Sul;OESTE CATARINENSE;CHAPECO;-27.07;-52.987;True;6086;3057;2962;2971;1462;1494;3115;1595;1468
4200556;Águas Frias;SC;42;Sul;OESTE CATARINENSE;CHAPECO;-26.88;-52.859;True;2551;1305;1221;937;459;459;1614;846;762
4200606;Águas Mornas;SC;42;Sul;GRANDE FLORIANOPOLIS;TABULEIRO;-27.694;-48.824;True;4410;2227;2177;1924;973;951;2486;1254;1226
4200705;Alfredo Wagner;SC;42;Sul;GRANDE FLORIANOPOLIS;TABULEIRO;-27.7;-49.334;True;9754;5020;4724;2938;1442;1496;6816;3578;3228
4200754;Alto Bela Vista;SC;42;Sul;OESTE CATARINENSE;CONCORDIA;-27.458;-51.879;True;2021;1010;1005;549;272;277;1472;738;728
4200804;Anchieta;SC;42;Sul;OESTE CATARINENSE;SAO MIGUEL D'OESTE;-26.534;-53.331;True;6587;3325;3240;2629;1276;1334;3958;2049;1906
4200903;Angelina;SC;42;Sul;GRANDE FLORIANOPOLIS;TIJUCAS;-27.569;-48.985;True;5322;2794;2525;1043;510;533;4279;2284;1992
4201000;Anita Garibaldi;SC;42;Sul;SERRANA;CAMPOS DE LAGES;-27.689;-51.13;True;9141;4513;4503;4708;2266;2396;4433;2247;2107
4201109;Anitápolis;SC;42;Sul;GRANDE FLORIANOPOLIS;TABULEIRO;-27.902;-49.129;True;3175;1641;1473;1180;595;585;1995;1046;888
4201208;Antônio Carlos;SC;42;Sul;GRANDE FLORIANOPOLIS;FLORIANOPOLIS;-27.517;-48.768;True;7087;3567;3461;2072;1004;1049;5015;2563;2412
4201257;Apiúna;SC;42;Sul;VALE DO ITAJAI;BLUMENAU;-27.036;-49.39;True;10270;5443;4806;4033;1948;2085;6237;3495;2721
4201273;Arabutã;SC;42;Sul;OESTE CATARINENSE;CONCORDIA;-27.16;-52.142;True;3962;2043;1913;1090;540;547;2872;1503;1366
4201307;Araquari;SC;42;Sul;NORTE CATARINENSE;JOINVILLE;-26.37;-48.722;True;21278;10757;10472;19847;9990;9811;1431;767;661
4201406;Araranguá;SC;42;Sul;SUL CATARINENSE;ARARANGUA;-28.935;-49.486;True;57119;27974;29145;47441;23040;24401;9678;4934;4744
4201505;Armazém;SC;42;Sul;SUL CATARINENSE;TUBARAO;-28.262;-49.018;True;7312;3568;3472;2980;1423;1476;4332;2145;1996
4201604;Arroio Trinta;SC;42;Sul;OESTE CATARINENSE;JOACABA;-26.933;-51.339;True;3516;1753;1759;2416;1175;1237;1100;578;522
4201653;Arvoredo;SC;42;Sul;OESTE CATARINENSE;CONCORDIA;-27.074;-52.456;True;2193;1158;1000;451;229;200;1742;929;800
4201703;Ascurra;SC;42;Sul;VALE DO ITAJAI;BLUMENAU;-26.955;-49.376;True;6761;3333;3399;5934;2901;3010;827;432;389
4201802;Atalanta;SC;42;Sul;VALE DO ITAJAI;ITUPORANGA;-27.42;-49.781;True;3317;1707;1598;1222;603;614;2095;1104;984
4201901;Aurora;SC;42;Sul;VALE DO ITAJAI;RIO DO SUL;-27.315;-49.638;True;5399;2754;2615;1724;827;893;3675;1927;1722
4201950;Balneário Arroio do Silva;SC;42;Sul;SUL CATARINENSE;ARARANGUA;-28.984;-49.413;True;8089;3987;4066;7881;3877;3968;208;110;98
4202008;Balneário Camboriú;SC;42;Sul;VALE DO ITAJAI;ITAJAI;-26.991;-48.635;True;94344;44098;49168;94344;44098;49168;;;
4202057;Balneário Barra do Sul;SC;42;Sul;NORTE CATARINENSE;JOINVILLE;-26.456;-48.612;True;7278;3582;3671;7272;3578;3669;6;4;2
4202073;Balneário Gaivota;SC;42;Sul;SUL CATARINENSE;ARARANGUA;-29.157;-49.579;True;7307;3453;3420;5538;2536;2571;1769;917;849
4202081;Bandeirante;SC;42;Sul;OESTE CATARINENSE;SAO MIGUEL D'OESTE;-26.769;-53.638;True;3028;1554;1402;851;445;399;2177;1109;1003
4202099;Barra Bonita;SC;42;Sul;OESTE CATARINENSE;SAO MIGUEL D'OESTE;-26.654;-53.44;True;2064;1072;984;323;159;156;1741;913;828
4202107;Barra Velha;SC;42;Sul;VALE DO ITAJAI;ITAJAI;-26.632;-48.685;True;18575;9165;9392;17511;8612;8883;1064;553;509
4202131;Bela Vista do Toldo;SC;42;Sul;NORTE CATARINENSE;CANOINHAS;-26.273;-50.464;True;5909;3085;2820;645;329;316;5264;2756;2504
4202156;Belmonte;SC;42;Sul;OESTE CATARINENSE;SAO MIGUEL D'OESTE;-26.841;-53.576;True;2681;1380;1301;1253;631;622;1428;749;679
4202206;Benedito Novo;SC;42;Sul;VALE DO ITAJAI;BLUMENAU;-26.783;-49.364;True;9841;5073;4768;5330;2695;2635;4511;2378;2133
4202305;Biguaçu;SC;42;Sul;GRANDE FLORIANOPOLIS;FLORIANOPOLIS;-27.494;-48.656;True;53444;25643;26113;48039;22985;23529;5405;2658;2584
4202404;Blumenau;SC;42;Sul;VALE DO ITAJAI;BLUMENAU;-26.919;-49.066;True;292972;;;;;;;;
4202438;Bocaina do Sul;SC;42;Sul;SERRANA;CAMPOS DE LAGES;-27.744;-49.944;True;3047;1603;1442;864;434;430;2183;1169;1012
4202453;Bombinhas;SC;42;Sul;VALE DO ITAJAI;ITAJAI;-27.138;-48.517;True;12456;6259;6076;12456;6259;6076;;;
4202503;Bom Jardim da Serra;SC;42;Sul;SERRANA;CAMPOS DE LAGES;-28.337;-49.625;True;4214;2150;2049;2271;1113;1158;1943;1037;891
4202537;Bom Jesus;SC;42;Sul;OESTE CATARINENSE;XANXERE;-26.734;-52.394;True;2296;1148;1148;1276;621;655;1020;527;493
4202578;Bom Jesus do Oeste;SC;42;Sul;OESTE CATARINENSE;CHAPECO;-26.69;-53.098;True;2026;1020;995;600;287;313;1426;733;682
4202602;Bom Retiro;SC;42;Sul;SERRANA;CAMPOS DE LAGES;-27.797;-49.489;True;8258;4114;4107;5771;2822;2921;2487;1292;1186
4202701;Botuverá;SC;42;Sul;VALE DO ITAJAI;BLUMENAU;-27.199;-49.075;True;4127;2125;2002;1021;499;522;3106;1626;1480
4202800;Braço do Norte;SC;42;Sul;SUL CATARINENSE;TUBARAO;-28.275;-49.166;True;27730;13976;13736;22577;11260;11299;5153;2716;2437
4202859;Braço do Trombudo;SC;42;Sul;VALE DO ITAJAI;RIO DO SUL;-27.358;-49.886;True;3288;1654;1634;1856;929;927;1432;725;707
4202875;Brunópolis;SC;42;Sul;SERRANA;CURITIBANOS;-27.306;-50.868;True;2934;1515;1419;690;350;340;2244;1165;1079
4202909;Brusque;SC;42;Sul;VALE DO ITAJAI;BLUMENAU;-27.098;-48.918;True;94962;47094;47848;92203;45654;46534;2759;1440;1314
4203006;Caçador;SC;42;Sul;OESTE CATARINENSE;JOACABA;-26.775;-51.015;True;67556;33333;33972;61533;30174;31194;6023;3159;2778
4203105;Caibi;SC;42;Sul;OESTE CATARINENSE;CHAPECO;-27.072;-53.248;True;6217;3114;3090;3340;1602;1725;2877;1512;1365
4203154;Calmon;SC;42;Sul;OESTE CATARINENSE;JOACABA;-26.6;-51.097;True;4012;2087;1917;2055;1039;1016;1957;1048;901
4203204;Camboriú;SC;42;Sul;VALE DO ITAJAI;ITAJAI;-27.025;-48.654;True;53388;26353;26379;51101;25151;25303;2287;1202;1076
4203253;Capão Alto;SC;42;Sul;SERRANA;CAMPOS DE LAGES;-27.937;-50.512;True;3210;1682;1514;1000;508;492;2210;1174;1022
4203303;Campo Alegre;SC;42;Sul;NORTE CATARINENSE;SAO BENTO DO SUL;-26.193;-49.266;True;11391;5805;5546;6657;3332;3322;4734;2473;2224
4203402;Campo Belo do Sul;SC;42;Sul;SERRANA;CAMPOS DE LAGES;-27.899;-50.761;True;7968;4086;3783;4795;2421;2361;3173;1665;1422
4203501;Campo Erê;SC;42;Sul;OESTE CATARINENSE;CHAPECO;-26.394;-53.078;True;9590;4783;4807;6012;2916;3096;3578;1867;1711
4203600;Campos Novos;SC;42;Sul;SERRANA;CURITIBANOS;-27.402;-51.225;True;28447;14036;14265;22756;11038;11616;5691;2998;2649
4203709;Canelinha;SC;42;Sul;GRANDE FLORIANOPOLIS;TIJUCAS;-27.265;-48.768;True;9696;4931;4765;5672;2816;2856;4024;2115;1909
4203808;Canoinhas;SC;42;Sul;NORTE CATARINENSE;CANOINHAS;-26.177;-50.39;True;52677;26025;26585;39577;19145;20382;13100;6880;6203
4203907;Capinzal;SC;42;Sul;OESTE CATARINENSE;JOACABA;-27.344;-51.612;True;18465;8902;9245;15406;7350;7764;3059;1552;1481
4203956;Capivari de Baixo;SC;42;Sul;SUL CATARINENSE;TUBARAO;-28.445;-48.958;True;20064;9749;10272;18819;9132;9644;1245;617;628
4204004;Catanduvas;SC;42;Sul;OESTE CATARINENSE;JOACABA;-27.071;-51.662;True;8733;4254;4324;7423;3578;3707;1310;676;617
4204103;Caxambu do Sul;SC;42;Sul;OESTE CATARINENSE;CHAPECO;-27.161;-52.879;True;4885;2366;2327;2122;1020;1046;2763;1346;1281
4204152;Celso Ramos;SC;42;Sul;SERRANA;CAMPOS DE LAGES;-27.634;-51.336;True;2671;1358;1310;797;388;408;1874;970;902
4204178;Cerro Negro;SC;42;Sul;SERRANA;CAMPOS DE LAGES;-27.795;-50.876;True;3948;2042;1802;817;405;402;3131;1637;1400
4204194;Chapadão do Lageado;SC;42;Sul;VALE DO ITAJAI;ITUPORANGA;-27.591;-49.554;True;2749;1430;1319;387;189;198;2362;1241;1121
4204202;Chapecó;SC;42;Sul;OESTE CATARINENSE;CHAPECO;-27.096;-52.618;True;164803;80625;82553;151976;73584;76842;12827;7041;5711
4204251;Cocal do Sul;SC;42;Sul;SUL CATARINENSE;CRICIUMA;-28.601;-49.326;True;14563;7191;7338;12187;6001;6157;2376;1190;1181
4204301;Concórdia;SC;42;Sul;OESTE CATARINENSE;CONCORDIA;-27.234;-52.028;True;67249;33220;33920;50693;24704;25906;16556;8516;8014
4204350;Cordilheira Alta;SC;42;Sul;OESTE CATARINENSE;CHAPECO;-26.984;-52.607;True;3361;1667;1658;1039;515;518;2322;1152;1140
4204400;Coronel Freitas;SC;42;Sul;OESTE CATARINENSE;CHAPECO;-26.909;-52.703;True;10246;5207;5012;5146;2570;2576;5100;2637;2436
4204459;Coronel Martins;SC;42;Sul;OESTE CATARINENSE;XANXERE;-26.512;-52.669;True;2481;1283;1198;656;327;329;1825;956;869
4204509;Corupá;SC;42;Sul;NORTE CATARINENSE;JOINVILLE;-26.425;-49.243;True;12758;6476;6280;9637;4795;4840;3121;1681;1440
4204558;Correia Pinto;SC;42;Sul;SERRANA;CAMPOS DE LAGES;-27.585;-50.361;True;14838;7412;7335;12140;6042;6059;2698;1370;1276
4204608;Criciúma;SC;42;Sul;SUL CATARINENSE;CRICIUMA;-28.678;-49.37;True;185506;;;;;;;;
4204707;Cunha Porã;SC;42;Sul;OESTE CATARINENSE;CHAPECO;-26.894;-53.168;True;10638;5299;5319;6221;3009;3206;4417;2290;2113
4204756;Cunhataí;SC;42;Sul;OESTE CATARINENSE;CHAPECO;-26.969;-53.093;True;1874;999;875;536;284;252;1338;715;623
4204806;Curitibanos;SC;42;Sul;SERRANA;CURITIBANOS;-27.283;-50.584;True;37493;18473;19020;34310;16786;17524;3183;1687;1496
4204905;Descanso;SC;42;Sul;OESTE CATARINENSE;SAO MIGUEL D'OESTE;-26.826;-53.502;True;8705;4365;4323;4080;1969;2111;4625;2396;2212
4205001;Dionísio Cerqueira;SC;42;Sul;OESTE CATARINENSE;SAO MIGUEL D'OESTE;-26.255;-53.64;True;14792;7409;7340;9578;4664;4901;5214;2745;2439
4205100;Dona Emma;SC;42;Sul;VALE DO ITAJAI;RIO DO SUL;-26.985;-49.726;True;3441;1754;1687;1563;782;781;1878;972;906
4205159;Doutor Pedrinho;SC;42;Sul;VALE DO ITAJAI;BLUMENAU;-26.714;-49.483;True;3280;1643;1637;1845;902;943;1435;741;694
4205175;Entre Rios;SC;42;Sul;OESTE CATARINENSE;XANXERE;-26.724;-52.561;True;2979;1520;1438;783;391;382;2196;1129;1056
4205191;Ermo;SC;42;Sul;SUL CATARINENSE;ARARANGUA;-28.983;-49.644;True;1843;946;897;546;275;271;1297;671;626
4205209;Erval Velho;SC;42;Sul;OESTE CATARINENSE;JOACABA;-27.276;-51.442;True;4098;1927;1945;2393;1089;1201;1705;838;744
4205308;Faxinal dos Guedes;SC;42;Sul;OESTE CATARINENSE;XANXERE;-26.853;-52.26;True;10339;5225;5062;7255;3616;3592;3084;1609;1470
4205357;Flor do Sertão;SC;42;Sul;OESTE CATARINENSE;CHAPECO;-26.778;-53.347;True;1640;863;777;303;157;146;1337;706;631
4205407;Florianópolis;SC;42;Sul;GRANDE FLORIANOPOLIS;FLORIANOPOLIS;-27.597;-48.549;False;396723;;;;;;;;
4205431;Formosa do Sul;SC;42;Sul;OESTE CATARINENSE;CHAPECO;-26.647;-52.794;True;2620;1330;1290;1058;523;535;1562;807;755
4205456;Forquilhinha;SC;42;Sul;SUL CATARINENSE;CRICIUMA;-28.747;-49.472;True;20719;10405;10314;16799;8383;8416;3920;2022;1898
4205506;Fraiburgo;SC;42;Sul;OESTE CATARINENSE;JOACABA;-27.026;-50.921;True;34889;17458;17412;30078;14950;15118;4811;2508;2294
4205555;Frei Rogério;SC;42;Sul;SERRANA;CURITIBANOS;-27.175;-50.805;True;2655;1382;1273;450;227;223;2205;1155;1050
4205605;Galvão;SC;42;Sul;OESTE CATARINENSE;XANXERE;-26.455;-52.686;True;3493;1778;1715;2354;1196;1158;1139;582;557
4205704;Garopaba;SC;42;Sul;SUL CATARINENSE;TUBARAO;-28.023;-48.613;True;16399;8286;8107;13771;6910;6861;2628;1376;1246
4205803;Garuva;SC;42;Sul;NORTE CATARINENSE;JOINVILLE;-26.027;-48.855;True;13393;6879;6514;10118;5152;4966;3275;1727;1548
4205902;Gaspar;SC;42;Sul;VALE DO ITAJAI;BLUMENAU;-26.931;-48.959;True;52428;25976;26253;42359;20893;21331;10069;5083;4922
4206009;Governador Celso Ramos;SC;42;Sul;GRANDE FLORIANOPOLIS;FLORIANOPOLIS;-27.315;-48.559;True;12175;6009;5659;11587;5733;5410;588;276;249
4206108;Grão Pará;SC;42;Sul;SUL CATARINENSE;TUBARAO;-28.185;-49.215;True;6051;3099;2919;2863;1390;1457;3188;1709;1462
4206207;Gravatal;SC;42;Sul;SUL CATARINENSE;TUBARAO;-28.331;-49.035;True;10510;5212;5246;4408;2140;2242;6102;3072;3004
4206306;Guabiruba;SC;42;Sul;VALE DO ITAJAI;BLUMENAU;-27.086;-48.981;True;16095;8187;7905;15022;7639;7383;1073;548;522
4206405;Guaraciaba;SC;42;Sul;OESTE CATARINENSE;SAO MIGUEL D'OESTE;-26.599;-53.518;True;10604;5350;5209;4731;2305;2426;5873;3045;2783
4206504;Guaramirim;SC;42;Sul;NORTE CATARINENSE;JOINVILLE;-26.473;-49.003;True;29932;15149;14764;24195;12159;12032;5737;2990;2732
4206603;Guarujá do Sul;SC;42;Sul;OESTE CATARINENSE;SAO MIGUEL D'OESTE;-26.385;-53.528;True;4711;2331;2380;2516;1198;1318;2195;1133;1062
4206652;Guatambú;SC;42;Sul;OESTE CATARINENSE;CHAPECO;-27.132;-52.787;True;4505;2336;2125;1485;762;706;3020;1574;1419
4206702;Herval D'Oeste;SC;42;Sul;OESTE CATARINENSE;JOACABA;-27.194;-51.495;True;18942;9291;9455;16710;8132;8398;2232;1159;1057
4206751;Ibiam;SC;42;Sul;OESTE CATARINENSE;JOACABA;-27.181;-51.237;True;1987;993;979;622;306;308;1365;687;671
4206801;Ibicaré;SC;42;Sul;OESTE CATARINENSE;JOACABA;-27.092;-51.365;True;3390;1761;1629;1564;776;788;1826;985;841
4206900;Ibirama;SC;42;Sul;VALE DO ITAJAI;RIO DO SUL;-27.057;-49.518;True;16716;8330;8361;14062;6942;7098;2654;1388;1263
4207007;Içara;SC;42;Sul;SUL CATARINENSE;CRICIUMA;-28.713;-49.3;True;54107;26908;27088;49304;24440;24757;4803;2468;2331
4207106;Ilhota;SC;42;Sul;VALE DO ITAJAI;ITAJAI;-26.9;-48.827;True;11552;5778;5742;6949;3446;3485;4603;2332;2257
4207205;Imaruí;SC;42;Sul;SUL CATARINENSE;TUBARAO;-28.341;-48.82;True;11675;5938;5737;3524;1755;1769;8151;4183;3968
4207304;Imbituba;SC;42;Sul;SUL CATARINENSE;TUBARAO;-28.24;-48.67;True;36231;17855;18262;36231;17855;18262;;;
4207403;Imbuia;SC;42;Sul;VALE DO ITAJAI;ITUPORANGA;-27.493;-49.424;True;5501;2755;2641;2288;1117;1143;3213;1638;1498
4207502;Indaial;SC;42;Sul;VALE DO ITAJAI;BLUMENAU;-26.898;-49.232;True;47686;23726;23949;45807;22758;23038;1879;968;911
4207577;Iomerê;SC;42;Sul;OESTE CATARINENSE;JOACABA;-27.004;-51.242;True;2558;1229;1245;817;393;424;1741;836;821
4207601;Ipira;SC;42;Sul;OESTE CATARINENSE;CONCORDIA;-27.404;-51.773;True;4705;2367;2330;2264;1101;1163;2441;1266;1167
4207650;Iporã do Oeste;SC;42;Sul;OESTE CATARINENSE;SAO MIGUEL D'OESTE;-26.988;-53.535;True;8091;4092;3982;3606;1762;1833;4485;2330;2149
4207684;Ipuaçu;SC;42;Sul;OESTE CATARINENSE;XANXERE;-26.631;-52.455;True;6566;3362;3204;1205;582;623;5361;2780;2581
4207700;Ipumirim;SC;42;Sul;OESTE CATARINENSE;CONCORDIA;-27.077;-52.136;True;7118;3642;3472;2975;1491;1480;4143;2151;1992
4207759;Iraceminha;SC;42;Sul;OESTE CATARINENSE;CHAPECO;-26.823;-53.274;True;4261;2194;2047;1325;662;663;2936;1532;1384
4207809;Irani;SC;42;Sul;OESTE CATARINENSE;CONCORDIA;-27.025;-51.902;True;9313;4761;4552;5817;2893;2924;3496;1868;1628
4207858;Irati;SC;42;Sul;OESTE CATARINENSE;CHAPECO;-26.656;-52.892;True;2025;1049;976;402;193;209;1623;856;767
4207908;Irineópolis;SC;42;Sul;NORTE CATARINENSE;CANOINHAS;-26.239;-50.8;True;10287;5271;5013;3268;1569;1699;7019;3702;3314
4208005;Itá;SC;42;Sul;OESTE CATARINENSE;CONCORDIA;-27.291;-52.323;True;6417;3244;3173;3818;1894;1924;2599;1350;1249
4208104;Itaiópolis;SC;42;Sul;NORTE CATARINENSE;CANOINHAS;-26.336;-49.906;True;19752;10053;9625;9788;4792;4968;9964;5261;4657
4208203;Itajaí;SC;42;Sul;VALE DO ITAJAI;ITAJAI;-26.908;-48.662;True;163218;80046;82691;156931;76829;79668;6287;3217;3023
4208302;Itapema;SC;42;Sul;VALE DO ITAJAI;ITAJAI;-27.09;-48.611;True;33766;16048;16782;32408;15393;16089;1358;655;693
4208401;Itapiranga;SC;42;Sul;OESTE CATARINENSE;SAO MIGUEL D'OESTE;-27.169;-53.712;True;15238;7759;7466;7061;3457;3591;8177;4302;3875
4208450;Itapoá;SC;42;Sul;NORTE CATARINENSE;JOINVILLE;-26.117;-48.616;True;10719;5379;5324;10143;5085;5042;576;294;282
4208500;Ituporanga;SC;42;Sul;VALE DO ITAJAI;ITUPORANGA;-27.414;-49.601;True;20577;10268;10266;13082;6396;6661;7495;3872;3605
4208609;Jaborá;SC;42;Sul;OESTE CATARINENSE;JOACABA;-27.176;-51.734;True;4032;2027;1998;1526;723;796;2506;1304;1202
4208708;Jacinto Machado;SC;42;Sul;SUL CATARINENSE;ARARANGUA;-28.997;-49.764;True;10738;5308;5354;5090;2466;2583;5648;2842;2771
4208807;Jaguaruna;SC;42;Sul;SUL CATARINENSE;TUBARAO;-28.615;-49.026;True;15668;7675;7840;11508;5598;5772;4160;2077;2068
4208906;Jaraguá do Sul;SC;42;Sul;NORTE CATARINENSE;JOINVILLE;-26.486;-49.067;True;129973;65338;64536;121114;60699;60335;8859;4639;4201
4208955;Jardinópolis;SC;42;Sul;OESTE CATARINENSE;CHAPECO;-26.722;-52.86;True;1851;927;878;903;429;428;948;498;450
4209003;Joaçaba;SC;42;Sul;OESTE CATARINENSE;JOACABA;-27.178;-51.505;True;24435;11661;12501;22468;10662;11541;1967;999;960
4209102;Joinville;SC;42;Sul;NORTE CATARINENSE;JOINVILLE;-26.304;-48.846;True;487003;;;;;;;;
4209151;José Boiteux;SC;42;Sul;VALE DO ITAJAI;RIO DO SUL;-26.958;-49.628;True;4840;2485;2355;1459;711;748;3381;1774;1607
4209177;Jupiá;SC;42;Sul;OESTE CATARINENSE;XANXERE;-26.398;-52.728;True;2134;1095;1039;866;433;433;1268;662;606
4209201;Lacerdópolis;SC;42;Sul;OESTE CATARINENSE;JOACABA;-27.26;-51.556;True;2190;1077;1031;1098;517;519;1092;560;512
4209300;Lages;SC;42;Sul;SERRANA;CAMPOS DE LAGES;-27.816;-50.326;True;161583;78483;82683;158633;76906;81331;2950;1577;1352
4209409;Laguna;SC;42;Sul;SUL CATARINENSE;TUBARAO;-28.483;-48.781;True;50179;24384;25153;39834;19353;20014;10345;5031;5139
4209458;Lajeado Grande;SC;42;Sul;OESTE CATARINENSE;XANXERE;-26.858;-52.567;True;1461;751;698;593;287;294;868;464;404
4209508;Laurentino;SC;42;Sul;VALE DO ITAJAI;RIO DO SUL;-27.217;-49.733;True;5483;2744;2728;3949;1945;1995;1534;799;733
4209607;Lauro Muller;SC;42;Sul;SUL CATARINENSE;CRICIUMA;-28.393;-49.397;True;13700;6849;6851;10225;5073;5152;3475;1776;1699
4209706;Lebon Régis;SC;42;Sul;OESTE CATARINENSE;JOACABA;-26.929;-50.695;True;11735;5992;5726;7574;3772;3802;4161;2220;1924
4209805;Leoberto Leal;SC;42;Sul;GRANDE FLORIANOPOLIS;TIJUCAS;-27.507;-49.287;True;3589;1883;1703;509;244;262;3080;1639;1441
4209854;Lindóia do Sul;SC;42;Sul;OESTE CATARINENSE;CONCORDIA;-27.053;-52.067;True;4560;2373;2187;1728;879;849;2832;1494;1338
4209904;Lontras;SC;42;Sul;VALE DO ITAJAI;RIO DO SUL;-27.166;-49.542;True;9180;4591;4585;6210;3036;3174;2970;1555;1411
4210001;Luiz Alves;SC;42;Sul;VALE DO ITAJAI;BLUMENAU;-26.721;-48.933;True;8986;4612;4320;2639;1350;1261;6347;3262;3059
4210035;Luzerna;SC;42;Sul;OESTE CATARINENSE;JOACABA;-27.133;-51.467;True;5391;2603;2724;4048;1917;2072;1343;686;652
4210050;Macieira;SC;42;Sul;OESTE CATARINENSE;JOACABA;-26.856;-51.378;True;1760;897;837;450;223;227;1310;674;610
4210100;Mafra;SC;42;Sul;NORTE CATARINENSE;CANOINHAS;-26.111;-49.805;True;51014;25377;25569;39005;19007;19952;12009;6370;5617
4210209;Major Gercino;SC;42;Sul;GRANDE FLORIANOPOLIS;TIJUCAS;-27.418;-48.951;True;2842;1441;1391;795;386;409;2047;1055;982
4210308;Major Vieira;SC;42;Sul;NORTE CATARINENSE;CANOINHAS;-26.368;-50.328;True;7337;3755;3557;2703;1326;1362;4634;2429;2195
4210407;Maracajá;SC;42;Sul;SUL CATARINENSE;ARARANGUA;-28.847;-49.453;True;5909;2857;2793;3888;1862;1869;2021;995;924
4210506;Maravilha;SC;42;Sul;OESTE CATARINENSE;CHAPECO;-26.761;-53.173;True;21684;10684;10925;17517;8521;8949;4167;2163;1976
4210555;Marema;SC;42;Sul;OESTE CATARINENSE;XANXERE;-26.802;-52.625;True;2282;1170;1103;612;317;295;1670;853;808
4210605;Massaranduba;SC;42;Sul;NORTE CATARINENSE;JOINVILLE;-26.611;-49.008;True;13777;7006;6771;6449;3219;3230;7328;3787;3541
4210704;Matos Costa;SC;42;Sul;OESTE CATARINENSE;JOACABA;-26.473;-51.148;True;2818;1442;1367;1400;699;701;1418;743;666
4210803;Meleiro;SC;42;Sul;SUL CATARINENSE;ARARANGUA;-28.829;-49.636;True;6880;3416;3425;3440;1656;1751;3440;1760;1674
4210852;Mirim Doce;SC;42;Sul;VALE DO ITAJAI;RIO DO SUL;-27.196;-50.077;True;2545;1300;1245;1112;542;570;1433;758;675
4210902;Modelo;SC;42;Sul;OESTE CATARINENSE;CHAPECO;-26.778;-53.055;True;3772;1905;1829;2359;1168;1167;1413;737;662
4211009;Mondaí;SC;42;Sul;OESTE CATARINENSE;SAO MIGUEL D'OESTE;-27.103;-53.402;True;9126;4588;4527;5176;2510;2662;3950;2078;1865
4211058;Monte Carlo;SC;42;Sul;SERRANA;CURITIBANOS;-27.223;-50.98;True;8854;4435;4419;7767;3854;3913;1087;581;506
4211108;Monte Castelo;SC;42;Sul;NORTE CATARINENSE;CANOINHAS;-26.462;-50.231;True;8113;4152;3917;4577;2290;2273;3536;1862;1644
4211207;Morro da Fumaça;SC;42;Sul;SUL CATARINENSE;CRICIUMA;-28.651;-49.21;True;15426;7674;7730;12462;6168;6275;2964;1506;1455
4211256;Morro Grande;SC;42;Sul;SUL CATARINENSE;ARARANGUA;-28.801;-49.721;True;2727;1414;1290;731;371;360;1996;1043;930
4211306;Navegantes;SC;42;Sul;VALE DO ITAJAI;ITAJAI;-26.899;-48.654;True;52638;26053;26210;49874;24700;24886;2764;1353;1324
4211405;Nova Erechim;SC;42;Sul;OESTE CATARINENSE;CHAPECO;-26.903;-52.906;True;4118;2101;1997;2758;1400;1351;1360;701;646
4211454;Nova Itaberaba;SC;42;Sul;OESTE CATARINENSE;CHAPECO;-26.94;-52.812;True;4117;2128;1983;861;420;435;3256;1708;1548
4211504;Nova Trento;SC;42;Sul;GRANDE FLORIANOPOLIS;TIJUCAS;-27.286;-48.93;True;11325;5741;5561;8444;4225;4219;2881;1516;1342
4211603;Nova Veneza;SC;42;Sul;SUL CATARINENSE;CRICIUMA;-28.637;-49.498;True;12536;6383;6151;8414;4266;4146;4122;2117;2005
4211652;Novo Horizonte;SC;42;Sul;OESTE CATARINENSE;CHAPECO;-26.444;-52.834;True;2902;1524;1378;897;459;438;2005;1065;940
4211702;Orleans;SC;42;Sul;SUL CATARINENSE;TUBARAO;-28.359;-49.291;True;20859;10411;10383;14503;7109;7355;6356;3302;3028
4211751;Otacílio Costa;SC;42;Sul;SERRANA;CAMPOS DE LAGES;-27.483;-50.122;True;15693;7939;7726;14267;7177;7065;1426;762;661
4211801;Ouro;SC;42;Sul;OESTE CATARINENSE;JOACABA;-27.341;-51.618;True;7095;3541;3486;4247;2073;2128;2848;1468;1358
4211850;Ouro Verde;SC;42;Sul;OESTE CATARINENSE;XANXERE;-26.694;-52.312;True;2152;1102;1050;667;313;354;1485;789;696
4211876;Paial;SC;42;Sul;OESTE CATARINENSE;CONCORDIA;-27.252;-52.498;True;1821;964;857;291;138;153;1530;826;704
4211892;Painel;SC;42;Sul;SERRANA;CAMPOS DE LAGES;-27.929;-50.105;True;2297;1234;1063;923;460;463;1374;774;600
4211900;Palhoça;SC;42;Sul;GRANDE FLORIANOPOLIS;FLORIANOPOLIS;-27.645;-48.668;True;122471;61141;61012;116987;58225;58463;5484;2916;2549
4212007;Palma Sola;SC;42;Sul;OESTE CATARINENSE;SAO MIGUEL D'OESTE;-26.348;-53.278;True;7942;4070;3872;4244;2126;2118;3698;1944;1754
4212056;Palmeira;SC;42;Sul;SERRANA;CAMPOS DE LAGES;-27.583;-50.159;True;2334;1244;1068;867;443;424;1467;801;644
4212106;Palmitos;SC;42;Sul;OESTE CATARINENSE;CHAPECO;-27.068;-53.161;True;16061;8088;7961;9409;4573;4828;6652;3515;3133
4212205;Papanduva;SC;42;Sul;NORTE CATARINENSE;CANOINHAS;-26.37;-50.144;True;17056;8723;8268;8875;4387;4453;8181;4336;3815
4212239;Paraíso;SC;42;Sul;OESTE CATARINENSE;SAO MIGUEL D'OESTE;-26.614;-53.672;True;4195;2156;2003;1327;647;680;2868;1509;1323
4212254;Passo de Torres;SC;42;Sul;SUL CATARINENSE;ARARANGUA;-29.316;-49.724;True;5313;2677;2636;4510;2246;2264;803;431;372
4212270;Passos Maia;SC;42;Sul;OESTE CATARINENSE;XANXERE;-26.78;-52.059;True;4472;2328;2136;830;415;413;3642;1913;1723
4212304;Paulo Lopes;SC;42;Sul;GRANDE FLORIANOPOLIS;FLORIANOPOLIS;-27.962;-48.684;True;6830;3607;3223;4629;2380;2249;2201;1227;974
4212403;Pedras Grandes;SC;42;Sul;SUL CATARINENSE;TUBARAO;-28.436;-49.185;True;4817;2314;2265;1340;628;680;3477;1686;1585
4212502;Penha;SC;42;Sul;VALE DO ITAJAI;ITAJAI;-26.769;-48.646;True;20868;10332;10418;19029;9401;9532;1839;931;886
4212601;Peritiba;SC;42;Sul;OESTE CATARINENSE;CONCORDIA;-27.373;-51.904;True;2944;1485;1454;1326;652;669;1618;833;785
4212700;Petrolândia;SC;42;Sul;VALE DO ITAJAI;ITUPORANGA;-27.535;-49.698;True;6064;3137;2922;1906;947;959;4158;2190;1963
4212809;Piçarras;SC;42;Sul;VALE DO ITAJAI;ITAJAI;-26.764;-48.672;True;13760;6834;6825;12497;6166;6232;1263;668;593
4212908;Pinhalzinho;SC;42;Sul;OESTE CATARINENSE;CHAPECO;-26.848;-52.992;True;14691;7315;7350;11932;5856;6073;2759;1459;1277
4213005;Pinheiro Preto;SC;42;Sul;OESTE CATARINENSE;JOACABA;-27.051;-51.231;True;2912;1479;1431;1569;810;759;1343;669;672
4213104;Piratuba;SC;42;Sul;OESTE CATARINENSE;CONCORDIA;-27.42;-51.772;True;4570;2272;2298;2643;1268;1375;1927;1004;923
4213153;Planalto Alegre;SC;42;Sul;OESTE CATARINENSE;CHAPECO;-27.07;-52.866;True;2639;1374;1241;1017;508;490;1622;866;751
4213203;Pomerode;SC;42;Sul;VALE DO ITAJAI;BLUMENAU;-26.741;-49.177;True;25261;12558;12646;22001;10854;11102;3260;1704;1544
4213302;Ponte Alta;SC;42;Sul;SERRANA;CURITIBANOS;-27.484;-50.38;True;5080;2528;2552;3880;1917;1963;1200;611;589
4213351;Ponte Alta do Norte;SC;42;Sul;SERRANA;CURITIBANOS;-27.158;-50.464;True;3500;1755;1745;2818;1391;1427;682;364;318
4213401;Ponte Serrada;SC;42;Sul;OESTE CATARINENSE;XANXERE;-26.872;-52.016;True;11210;5643;5565;7745;3811;3934;3465;1832;1631
4213500;Porto Belo;SC;42;Sul;VALE DO ITAJAI;ITAJAI;-27.158;-48.553;True;13232;6630;6602;12409;6188;6221;823;442;381
4213609;Porto União;SC;42;Sul;NORTE CATARINENSE;CANOINHAS;-26.238;-51.078;True;32256;15712;16488;27440;13174;14232;4816;2538;2256
4213708;Pouso Redondo;SC;42;Sul;VALE DO ITAJAI;RIO DO SUL;-27.258;-49.934;True;13722;7000;6710;7916;3928;3982;5806;3072;2728
4213807;Praia Grande;SC;42;Sul;SUL CATARINENSE;ARARANGUA;-29.197;-49.95;True;7120;3466;3436;4144;1986;2078;2976;1480;1358
4213906;Presidente Castelo Branco;SC;42;Sul;OESTE CATARINENSE;CONCORDIA;-27.223;-51.807;True;1757;931;824;522;257;265;1235;674;559
4214003;Presidente Getúlio;SC;42;Sul;VALE DO ITAJAI;RIO DO SUL;-27.051;-49.623;True;13651;6792;6846;9154;4459;4687;4497;2333;2159
4214102;Presidente Nereu;SC;42;Sul;VALE DO ITAJAI;RIO DO SUL;-27.277;-49.39;True;2259;1151;1107;733;354;379;1526;797;728
4214151;Princesa;SC;42;Sul;OESTE CATARINENSE;SAO MIGUEL D'OESTE;-26.442;-53.598;True;2604;1339;1265;744;374;370;1860;965;895
4214201;Quilombo;SC;42;Sul;OESTE CATARINENSE;CHAPECO;-26.726;-52.721;True;10871;5500;5371;5584;2761;2823;5287;2739;2548
4214300;Rancho Queimado;SC;42;Sul;GRANDE FLORIANOPOLIS;TABULEIRO;-27.673;-49.022;True;2772;1453;1319;1232;625;607;1540;828;712
4214409;Rio das Antas;SC;42;Sul;OESTE CATARINENSE;JOACABA;-26.899;-51.074;True;6054;2937;2762;2362;1108;1136;3692;1829;1626
4214508;Rio do Campo;SC;42;Sul;VALE DO ITAJAI;RIO DO SUL;-26.949;-50.141;True;6042;3071;2971;2418;1202;1216;3624;1869;1755
4214607;Rio do Oeste;SC;42;Sul;VALE DO ITAJAI;RIO DO SUL;-27.193;-49.797;True;6795;3498;3297;3049;1519;1530;3746;1979;1767
4214706;Rio dos Cedros;SC;42;Sul;VALE DO ITAJAI;BLUMENAU;-26.738;-49.274;True;9685;4931;4754;4536;2236;2300;5149;2695;2454
4214805;Rio do Sul;SC;42;Sul;VALE DO ITAJAI;RIO DO SUL;-27.214;-49.643;True;56919;27772;29080;53248;25880;27304;3671;1892;1776
4214904;Rio Fortuna;SC;42;Sul;SUL CATARINENSE;TUBARAO;-28.131;-49.105;True;4468;2287;2148;1507;728;779;2961;1559;1369
4215000;Rio Negrinho;SC;42;Sul;NORTE CATARINENSE;SAO BENTO DO SUL;-26.254;-49.518;True;42237;21305;20879;37947;18984;18913;4290;2321;1966
4215059;Rio Rufino;SC;42;Sul;SERRANA;CAMPOS DE LAGES;-27.861;-49.779;True;2433;1244;1179;673;346;327;1760;898;852
4215075;Riqueza;SC;42;Sul;OESTE CATARINENSE;SAO MIGUEL D'OESTE;-27.067;-53.322;True;4998;2556;2423;1941;958;964;3057;1598;1459
4215109;Rodeio;SC;42;Sul;VALE DO ITAJAI;BLUMENAU;-26.923;-49.366;True;10773;5377;5391;9278;4597;4676;1495;780;715
4215208;Romelândia;SC;42;Sul;OESTE CATARINENSE;SAO MIGUEL D'OESTE;-26.676;-53.314;True;5738;2876;2859;1928;907;1021;3810;1969;1838
4215307;Salete;SC;42;Sul;VALE DO ITAJAI;RIO DO SUL;-26.98;-50;True;7432;3850;3580;4969;2547;2422;2463;1303;1158
4215356;Saltinho;SC;42;Sul;OESTE CATARINENSE;CHAPECO;-26.609;-53.056;True;4072;2113;1959;1058;520;538;3014;1593;1421
4215406;Salto Veloso;SC;42;Sul;OESTE CATARINENSE;JOACABA;-26.905;-51.406;True;4172;2147;2024;3203;1633;1569;969;514;455
4215455;Sangão;SC;42;Sul;SUL CATARINENSE;TUBARAO;-28.638;-49.129;True;10300;5213;5009;4884;2439;2385;5416;2774;2624
4215505;Santa Cecília;SC;42;Sul;SERRANA;CURITIBANOS;-26.961;-50.427;True;15311;7716;7595;13085;6555;6530;2226;1161;1065
4215554;Santa Helena;SC;42;Sul;OESTE CATARINENSE;SAO MIGUEL D'OESTE;-26.938;-53.619;True;2437;1246;1185;838;398;434;1599;848;751
4215604;Santa Rosa de Lima;SC;42;Sul;SUL CATARINENSE;TUBARAO;-28.039;-49.128;True;2031;1057;974;482;249;233;1549;808;741
4215653;Santa Rosa do Sul;SC;42;Sul;SUL CATARINENSE;ARARANGUA;-29.136;-49.7;True;7949;4038;3911;3599;1779;1820;4350;2259;2091
4215679;Santa Terezinha;SC;42;Sul;NORTE CATARINENSE;CANOINHAS;-26.779;-50.008;True;9025;4920;4105;1499;782;717;7526;4138;3388
4215687;Santa Terezinha do Progresso;SC;42;Sul;OESTE CATARINENSE;CHAPECO;-26.619;-53.202;True;3044;1572;1472;494;227;267;2550;1345;1205
4215695;Santiago do Sul;SC;42;Sul;OESTE CATARINENSE;CHAPECO;-26.639;-52.685;True;1450;764;686;583;302;281;867;462;405
4215703;Santo Amaro da Imperatriz;SC;42;Sul;GRANDE FLORIANOPOLIS;FLORIANOPOLIS;-27.688;-48.779;True;17602;8886;8693;13974;7015;6943;3628;1871;1750
4215752;São Bernardino;SC;42;Sul;OESTE CATARINENSE;CHAPECO;-26.475;-52.964;True;2653;1388;1265;589;302;287;2064;1086;978
4215802;São Bento do Sul;SC;42;Sul;NORTE CATARINENSE;SAO BENTO DO SUL;-26.25;-49.379;True;72548;36254;36052;69902;34933;34833;2646;1321;1219
4215901;São Bonifácio;SC;42;Sul;GRANDE FLORIANOPOLIS;TABULEIRO;-27.901;-48.929;True;3178;1634;1544;673;346;327;2505;1288;1217
4216008;São Carlos;SC;42;Sul;OESTE CATARINENSE;CHAPECO;-27.078;-53.004;True;10372;5318;4953;6817;3462;3316;3555;1856;1637
4216057;São Cristovão do Sul;SC;42;Sul;SERRANA;CURITIBANOS;-27.267;-50.441;True;4850;2647;2203;3776;1856;1920;1074;791;283
4216107;São Domingos;SC;42;Sul;OESTE CATARINENSE;XANXERE;-26.558;-52.532;True;9346;4763;4583;5859;2880;2979;3487;1883;1604
4216206;São Francisco do Sul;SC;42;Sul;NORTE CATARINENSE;JOINVILLE;-26.243;-48.638;True;37613;18701;18746;35076;17379;17542;2537;1322;1204
4216255;São João do Oeste;SC;42;Sul;OESTE CATARINENSE;SAO MIGUEL D'OESTE;-27.098;-53.594;True;6020;3094;2922;1810;881;929;4210;2213;1993
4216305;São João Batista;SC;42;Sul;GRANDE FLORIANOPOLIS;TIJUCAS;-27.276;-48.849;True;22089;11194;10895;16242;8194;8048;5847;3000;2847
4216354;São João do Itaperiú;SC;42;Sul;VALE DO ITAJAI;ITAJAI;-26.618;-48.768;True;3289;1715;1567;1826;948;876;1463;767;691
4216404;São João do Sul;SC;42;Sul;SUL CATARINENSE;ARARANGUA;-29.223;-49.81;True;6916;3578;3338;1232;608;624;5684;2970;2714
4216503;São Joaquim;SC;42;Sul;SERRANA;CAMPOS DE LAGES;-28.294;-49.932;True;24058;12135;11913;17177;8439;8738;6881;3696;3175
4216602;São José;SC;42;Sul;GRANDE FLORIANOPOLIS;FLORIANOPOLIS;-27.615;-48.628;True;196887;;;;;;;;
4216701;São José do Cedro;SC;42;Sul;OESTE CATARINENSE;SAO MIGUEL D'OESTE;-26.455;-53.494;True;13699;6903;6796;7735;3768;3967;5964;3135;2829
4216800;São José do Cerrito;SC;42;Sul;SERRANA;CAMPOS DE LAGES;-27.663;-50.58;True;10304;5347;4939;2396;1198;1198;7908;4149;3741
4216909;São Lourenço do Oeste;SC;42;Sul;OESTE CATARINENSE;CHAPECO;-26.359;-52.851;True;21799;10833;10966;16408;7996;8412;5391;2837;2554
4217006;São Ludgero;SC;42;Sul;SUL CATARINENSE;TUBARAO;-28.326;-49.177;True;10246;5221;5004;8312;4213;4088;1934;1008;916
4217105;São Martinho;SC;42;Sul;SUL CATARINENSE;TUBARAO;-28.165;-48.979;True;3194;1662;1530;1160;576;582;2034;1086;948
4217154;São Miguel da Boa Vista;SC;42;Sul;OESTE CATARINENSE;CHAPECO;-26.69;-53.251;True;1972;1011;948;393;190;203;1579;821;745
4217204;São Miguel do Oeste;SC;42;Sul;OESTE CATARINENSE;SAO MIGUEL D'OESTE;-26.725;-53.518;True;33806;16537;17253;29765;14428;15326;4041;2109;1927
4217253;São Pedro de Alcântara;SC;42;Sul;GRANDE FLORIANOPOLIS;FLORIANOPOLIS;-27.566;-48.805;True;4765;2937;1710;3631;2343;1184;1134;594;526
4217303;Saudades;SC;42;Sul;OESTE CATARINENSE;CHAPECO;-26.924;-53.003;True;8587;4433;4148;4297;2160;2136;4290;2273;2012
4217402;Schroeder;SC;42;Sul;NORTE CATARINENSE;JOINVILLE;-26.413;-49.073;True;12776;6527;6249;10190;5153;5037;2586;1374;1212
4217501;Seara;SC;42;Sul;OESTE CATARINENSE;CONCORDIA;-27.149;-52.311;True;17121;8697;8422;11664;5821;5843;5457;2876;2579
4217550;Serra Alta;SC;42;Sul;OESTE CATARINENSE;CHAPECO;-26.729;-53.042;True;3200;1578;1613;1418;692;722;1782;886;891
4217600;Siderópolis;SC;42;Sul;SUL CATARINENSE;CRICIUMA;-28.598;-49.424;True;12470;6179;6278;9618;4706;4907;2852;1473;1371
4217709;Sombrio;SC;42;Sul;SUL CATARINENSE;ARARANGUA;-29.104;-49.629;True;24424;11911;12337;16899;8048;8722;7525;3863;3615
4217758;Sul Brasil;SC;42;Sul;OESTE CATARINENSE;CHAPECO;-26.736;-52.965;True;3061;1563;1496;951;466;485;2110;1097;1011
4217808;Taió;SC;42;Sul;VALE DO ITAJAI;RIO DO SUL;-27.116;-49.998;True;16838;8469;8359;8864;4344;4518;7974;4125;3841
4217907;Tangará;SC;42;Sul;OESTE CATARINENSE;JOACABA;-27.105;-51.247;True;8410;4263;4047;4567;2267;2255;3843;1996;1792
4217956;Tigrinhos;SC;42;Sul;OESTE CATARINENSE;CHAPECO;-26.688;-53.158;True;1741;905;820;239;117;122;1502;788;698
4218004;Tijucas;SC;42;Sul;GRANDE FLORIANOPOLIS;TIJUCAS;-27.241;-48.634;True;27804;13925;13879;23195;11432;11763;4609;2493;2116
4218103;Timbé do Sul;SC;42;Sul;SUL CATARINENSE;ARARANGUA;-28.83;-49.847;True;5133;2619;2511;1690;807;880;3443;1812;1631
4218202;Timbó;SC;42;Sul;VALE DO ITAJAI;BLUMENAU;-26.823;-49.272;True;33326;16507;16619;30572;15080;15321;2754;1427;1298
4218251;Timbó Grande;SC;42;Sul;NORTE CATARINENSE;CANOINHAS;-26.615;-50.674;True;6979;3577;3394;3498;1746;1752;3481;1831;1642
4218301;Três Barras;SC;42;Sul;NORTE CATARINENSE;CANOINHAS;-26.106;-50.322;True;17937;8996;8938;15208;7593;7614;2729;1403;1324
4218350;Treviso;SC;42;Sul;SUL CATARINENSE;CRICIUMA;-28.516;-49.458;True;3498;1759;1736;1802;891;908;1696;868;828
4218400;Treze de Maio;SC;42;Sul;SUL CATARINENSE;TUBARAO;-28.559;-49.148;True;6599;3137;3072;1900;836;886;4699;2301;2186
4218509;Treze Tílias;SC;42;Sul;OESTE CATARINENSE;JOACABA;-27.002;-51.406;True;5641;2711;2783;3907;1830;1947;1734;881;836
4218608;Trombudo Central;SC;42;Sul;VALE DO ITAJAI;RIO DO SUL;-27.299;-49.79;True;6221;3127;3080;3818;1870;1941;2403;1257;1139
4218707;Tubarão;SC;42;Sul;SUL CATARINENSE;TUBARAO;-28.467;-49.007;True;92569;44731;47635;83500;40093;43241;9069;4638;4394
4218756;Tunápolis;SC;42;Sul;OESTE CATARINENSE;SAO MIGUEL D'OESTE;-26.969;-53.639;True;4650;2429;2221;1358;677;681;3292;1752;1540
4218806;Turvo;SC;42;Sul;SUL CATARINENSE;ARARANGUA;-28.926;-49.679;True;11031;5366;5554;7233;3466;3686;3798;1900;1868
4218855;União do Oeste;SC;42;Sul;OESTE CATARINENSE;CHAPECO;-26.761;-52.855;True;3058;1533;1484;1070;514;533;1988;1019;951
4218905;Urubici;SC;42;Sul;SERRANA;CAMPOS DE LAGES;-28.015;-49.592;True;10439;5191;5210;7332;3579;3723;3107;1612;1487
4218954;Urupema;SC;42;Sul;SERRANA;CAMPOS DE LAGES;-27.953;-49.873;True;2501;1281;1211;1213;597;616;1288;684;595
4219002;Urussanga;SC;42;Sul;SUL CATARINENSE;CRICIUMA;-28.518;-49.321;True;18588;9104;9430;10726;5210;5492;7862;3894;3938
4219101;Vargeão;SC;42;Sul;OESTE CATARINENSE;XANXERE;-26.864;-52.155;True;3560;1778;1779;1736;832;904;1824;946;875
4219150;Vargem;SC;42;Sul;SERRANA;CURITIBANOS;-27.489;-50.975;True;3110;1566;1456;679;341;338;2431;1225;1118
4219176;Vargem Bonita;SC;42;Sul;OESTE CATARINENSE;JOACABA;-27.007;-51.74;True;4321;2116;2127;1863;906;934;2458;1210;1193
4219200;Vidal Ramos;SC;42;Sul;VALE DO ITAJAI;ITUPORANGA;-27.392;-49.356;True;5981;3071;2910;1583;764;819;4398;2307;2091
4219309;Videira;SC;42;Sul;OESTE CATARINENSE;JOACABA;-27.008;-51.152;True;44479;21865;22399;39049;19077;19823;5430;2788;2576
4219358;Vitor Meireles;SC;42;Sul;VALE DO ITAJAI;RIO DO SUL;-26.881;-49.833;True;5563;2891;2651;1353;669;678;4210;2222;1973
4219408;Witmarsum;SC;42;Sul;VALE DO ITAJAI;RIO DO SUL;-26.926;-49.796;True;3431;1749;1676;721;335;386;2710;1414;1290
4219507;Xanxerê;SC;42;Sul;OESTE CATARINENSE;XANXERE;-26.877;-52.404;True;40228;19376;20112;36387;17471;18285;3841;1905;1827
4219606;Xavantina;SC;42;Sul;OESTE CATARINENSE;CONCORDIA;-27.069;-52.342;True;4218;2217;2000;1079;540;538;3139;1677;1462
4219705;Xaxim;SC;42;Sul;OESTE CATARINENSE;XANXERE;-26.962;-52.535;True;24318;11941;12254;18033;8713;9216;6285;3228;3038
4219853;Zortéa;SC;42;Sul;SERRANA;CURITIBANOS;-27.451;-51.555;True;2868;1468;1398;2230;1124;1104;638;344;294
4300034;Aceguá;RS;43;Sul;SUDOESTE RIO-GRANDENSE;CAMPANHA MERIDIONAL;-31.868;-54.1617;True;4138;2146;1935;988;503;483;3150;1643;1452
4300059;Água Santa;RS;43;Sul;NOROESTE RIO-GRANDENSE;PASSO FUNDO;-28.177;-52.034;True;3565;1818;1743;1242;591;651;2323;1227;1092
4300109;Agudo;RS;43;Sul;CENTRO OCIDENTAL RIO-GRANDENSE;RESTINGA SECA;-29.645;-53.24;True;16714;8399;8279;6626;3258;3368;10088;5141;4911
4300208;Ajuricaba;RS;43;Sul;NOROESTE RIO-GRANDENSE;IJUI;-28.239;-53.771;True;7261;3609;3652;3937;1892;2045;3324;1717;1607
4300307;Alecrim;RS;43;Sul;NOROESTE RIO-GRANDENSE;SANTA ROSA;-27.655;-54.764;True;7357;3711;3636;2057;973;1082;5300;2738;2554
4300406;Alegrete;RS;43;Sul;SUDOESTE RIO-GRANDENSE;CAMPANHA OCIDENTAL;-29.783;-55.792;True;78188;38640;39540;69871;33813;36058;8317;4827;3482
4300455;Alegria;RS;43;Sul;NOROESTE RIO-GRANDENSE;IJUI;-27.827;-54.057;True;4789;2399;2366;1644;769;854;3145;1630;1512
4300471;Almirante Tamandaré do Sul;RS;43;Sul;NOROESTE RIO-GRANDENSE;CARAZINHO;-28.113;-52.909;True;2158;1089;1040;266;125;135;1892;964;905
4300505;Alpestre;RS;43;Sul;NOROESTE RIO-GRANDENSE;FREDERICO WESTPHALEN;-27.249;-53.035;True;8972;4588;4281;2097;990;1096;6875;3598;3185
4300554;Alto Alegre;RS;43;Sul;NOROESTE RIO-GRANDENSE;CRUZ ALTA;-28.773;-52.99;True;1940;999;937;733;386;347;1207;613;590
4300570;Alto Feliz;RS;43;Sul;METROPOLITANA DE PORTO ALEGRE;MONTENEGRO;-29.392;-51.312;True;2934;1507;1427;746;360;386;2188;1147;1041
4300604;Alvorada;RS;43;Sul;METROPOLITANA DE PORTO ALEGRE;PORTO ALEGRE;-29.99;-51.084;True;207142;;;;;;;;
4300638;Amaral Ferrador;RS;43;Sul;SUDESTE RIO-GRANDENSE;SERRAS DE SUDESTE;-30.875;-52.253;True;6232;3193;2996;1408;682;724;4824;2511;2272
4300646;Ametista do Sul;RS;43;Sul;NOROESTE RIO-GRANDENSE;FREDERICO WESTPHALEN;-27.361;-53.182;True;8058;4116;3942;3715;1837;1878;4343;2279;2064
4300661;André da Rocha;RS;43;Sul;NORDESTE RIO-GRANDENSE;GUAPORE;-28.631;-51.571;True;1206;620;586;428;203;225;778;417;361
4300703;Anta Gorda;RS;43;Sul;NORDESTE RIO-GRANDENSE;GUAPORE;-28.97;-52.005;True;6163;3077;3086;2244;1037;1207;3919;2040;1879
4300802;Antônio Prado;RS;43;Sul;NORDESTE RIO-GRANDENSE;CAXIAS DO SUL;-28.858;-51.283;True;13591;6744;6676;9502;4630;4823;4089;2114;1853
4300851;Arambaré;RS;43;Sul;METROPOLITANA DE PORTO ALEGRE;CAMAQUA;-30.915;-51.498;True;3825;1968;1857;2923;1470;1453;902;498;404
4300877;Araricá;RS;43;Sul;METROPOLITANA DE PORTO ALEGRE;PORTO ALEGRE;-29.614;-50.925;True;4781;2418;2363;4263;2144;2119;518;274;244
4300901;Aratiba;RS;43;Sul;NOROESTE RIO-GRANDENSE;ERECHIM;-27.394;-52.3;True;6616;3396;3220;2994;1480;1514;3622;1916;1706
4301008;Arroio do Meio;RS;43;Sul;CENTRO ORIENTAL RIO-GRANDENSE;LAJEADO-ESTRELA;-29.401;-51.945;True;18079;9024;9055;13985;6909;7076;4094;2115;1979
4301057;Arroio do Sal;RS;43;Sul;METROPOLITANA DE PORTO ALEGRE;OSORIO;-29.551;-49.889;True;6635;3293;3318;6404;3175;3216;231;118;102
4301073;Arroio do Padre;RS;43;Sul;SUDESTE RIO-GRANDENSE;PELOTAS;-31.443;-52.422;True;2734;1432;1302;463;230;233;2271;1202;1069
4301107;Arroio dos Ratos;RS;43;Sul;METROPOLITANA DE PORTO ALEGRE;SAO JERONIMO;-30.077;-51.729;True;13619;6697;6914;12954;6331;6623;665;366;291
4301206;Arroio do Tigre;RS;43;Sul;CENTRO ORIENTAL RIO-GRANDENSE;SANTA CRUZ DO SUL;-29.333;-53.093;True;12638;6382;6252;5860;2820;3038;6778;3562;3214
4301305;Arroio Grande;RS;43;Sul;SUDESTE RIO-GRANDENSE;JAGUARAO;-32.238;-53.087;True;18358;9220;9112;15772;7754;8012;2586;1466;1100
4301404;Arvorezinha;RS;43;Sul;NORDESTE RIO-GRANDENSE;GUAPORE;-28.872;-52.175;True;10210;5156;5045;5860;2867;2984;4350;2289;2061
4301503;Augusto Pestana;RS;43;Sul;NOROESTE RIO-GRANDENSE;IJUI;-28.517;-53.992;True;7273;3546;3670;3455;1633;1818;3818;1913;1852
4301552;Áurea;RS;43;Sul;NOROESTE RIO-GRANDENSE;ERECHIM;-27.698;-52.049;True;3715;1864;1851;1362;655;707;2353;1209;1144
4301602;Bagé;RS;43;Sul;SUDOESTE RIO-GRANDENSE;CAMPANHA MERIDIONAL;-31.331;-54.107;True;112550;53722;58759;94398;44501;49874;18152;9221;8885
4301636;Balneário Pinhal;RS;43;Sul;METROPOLITANA DE PORTO ALEGRE;OSORIO;-30.247;-50.233;True;10517;5192;5325;10062;4959;5103;455;233;222
4301651;Barão;RS;43;Sul;METROPOLITANA DE PORTO ALEGRE;MONTENEGRO;-29.377;-51.496;True;5293;2719;2567;2563;1282;1279;2730;1437;1288
4301701;Barão de Cotegipe;RS;43;Sul;NOROESTE RIO-GRANDENSE;ERECHIM;-27.621;-52.38;True;6519;3287;3219;3697;1769;1918;2822;1518;1301
4301750;Barão do Triunfo;RS;43;Sul;METROPOLITANA DE PORTO ALEGRE;SAO JERONIMO;-30.388;-51.734;True;6924;3691;3233;714;347;367;6210;3344;2866
4301800;Barracão;RS;43;Sul;NOROESTE RIO-GRANDENSE;SANANDUVA;-27.672;-51.461;True;5306;2650;2656;2853;1373;1480;2453;1277;1176
4301859;Barra do Guarita;RS;43;Sul;NOROESTE RIO-GRANDENSE;TRES PASSOS;-27.192;-53.71;True;2969;1491;1470;1201;586;615;1768;905;855
4301875;Barra do Quaraí;RS;43;Sul;SUDOESTE RIO-GRANDENSE;CAMPANHA OCIDENTAL;-30.207;-57.555;True;3776;1818;1650;2725;1282;1237;1051;536;413
4301909;Barra do Ribeiro;RS;43;Sul;METROPOLITANA DE PORTO ALEGRE;CAMAQUA;-30.291;-51.301;True;11478;5698;5780;8907;4336;4571;2571;1362;1209
4301925;Barra do Rio Azul;RS;43;Sul;NOROESTE RIO-GRANDENSE;ERECHIM;-27.409;-52.41;True;2028;1070;958;383;188;195;1645;882;763
4301958;Barra Funda;RS;43;Sul;NOROESTE RIO-GRANDENSE;CARAZINHO;-27.923;-53.039;True;2338;1169;1169;1387;688;699;951;481;470
4302006;Barros Cassal;RS;43;Sul;NOROESTE RIO-GRANDENSE;SOLEDADE;-29.093;-52.583;True;11450;5933;5517;3560;1727;1833;7890;4206;3684
4302055;Benjamin Constant do Sul;RS;43;Sul;NOROESTE RIO-GRANDENSE;ERECHIM;-27.51;-52.598;True;2256;1166;1090;304;142;162;1952;1024;928
4302105;Bento Gonçalves;RS;43;Sul;NORDESTE RIO-GRANDENSE;CAXIAS DO SUL;-29.171;-51.519;True;100643;49645;50964;90756;44544;46178;9887;5101;4786
4302154;Boa Vista das MissõEs;RS;43;Sul;NOROESTE RIO-GRANDENSE;CARAZINHO;-27.663;-53.314;True;2066;1026;1022;688;327;354;1378;699;668
4302204;Boa Vista do Buricá;RS;43;Sul;NOROESTE RIO-GRANDENSE;TRES PASSOS;-27.669;-54.11;True;6468;3239;3229;4065;2010;2055;2403;1229;1174
4302220;Boa Vista do Cadeado;RS;43;Sul;NOROESTE RIO-GRANDENSE;CRUZ ALTA;-28.607;-53.815;True;2447;1257;1153;433;214;219;2014;1043;934
4302238;Boa Vista do Incra;RS;43;Sul;NOROESTE RIO-GRANDENSE;CRUZ ALTA;-28.819;-53.387;True;2447;1259;1188;680;330;350;1767;929;838
4302253;Boa Vista do Sul;RS;43;Sul;NORDESTE RIO-GRANDENSE;CAXIAS DO SUL;-29.351;-51.676;True;2663;1404;1240;352;174;168;2311;1230;1072
4302303;Bom Jesus;RS;43;Sul;NORDESTE RIO-GRANDENSE;VACARIA;-28.668;-50.417;True;11843;5870;5952;8832;4236;4596;3011;1634;1356
4302352;Bom Princípio;RS;43;Sul;METROPOLITANA DE PORTO ALEGRE;MONTENEGRO;-29.489;-51.353;True;10910;5587;5315;8207;4155;4050;2703;1432;1265
4302378;Bom Progresso;RS;43;Sul;NOROESTE RIO-GRANDENSE;TRES PASSOS;-27.544;-53.866;True;2441;1224;1217;1075;501;574;1366;723;643
4302402;Bom Retiro do Sul;RS;43;Sul;CENTRO ORIENTAL RIO-GRANDENSE;LAJEADO-ESTRELA;-29.609;-51.943;True;11130;5476;5645;8707;4231;4474;2423;1245;1171
4302451;Boqueirão do Leão;RS;43;Sul;CENTRO ORIENTAL RIO-GRANDENSE;LAJEADO-ESTRELA;-29.304;-52.429;True;7825;4037;3788;1634;802;832;6191;3235;2956
4302501;Bossoroca;RS;43;Sul;NOROESTE RIO-GRANDENSE;SANTO ANGELO;-28.73;-54.9;True;7652;3994;3658;3937;1933;2004;3715;2061;1654
4302584;Bozano;RS;43;Sul;NOROESTE RIO-GRANDENSE;IJUI;-28.368;-53.771;True;2296;1175;1121;544;284;260;1752;891;861
4302600;Braga;RS;43;Sul;NOROESTE RIO-GRANDENSE;TRES PASSOS;-27.614;-53.739;True;3826;1923;1903;2186;1061;1125;1640;862;778
4302659;Brochier;RS;43;Sul;METROPOLITANA DE PORTO ALEGRE;MONTENEGRO;-29.551;-51.593;True;4701;2408;2291;1902;933;969;2799;1475;1322
4302709;Butiá;RS;43;Sul;METROPOLITANA DE PORTO ALEGRE;SAO JERONIMO;-30.12;-51.962;True;19717;9779;9929;18480;9109;9362;1237;670;567
4302808;Caçapava do Sul;RS;43;Sul;SUDESTE RIO-GRANDENSE;SERRAS DE SUDESTE;-30.512;-53.491;True;32574;15897;16660;19017;8786;10221;13557;7111;6439
4302907;Cacequi;RS;43;Sul;CENTRO OCIDENTAL RIO-GRANDENSE;SANTA MARIA;-29.884;-54.825;True;13629;6744;6872;11900;5766;6121;1729;978;751
4303004;Cachoeira do Sul;RS;43;Sul;CENTRO ORIENTAL RIO-GRANDENSE;CACHOEIRA DO SUL;-30.039;-52.894;True;84629;40865;43734;71878;34199;37656;12751;6666;6078
4303103;Cachoeirinha;RS;43;Sul;METROPOLITANA DE PORTO ALEGRE;PORTO ALEGRE;-29.951;-51.094;True;112603;53683;57088;112603;53683;57088;;;
4303202;Cacique Doble;RS;43;Sul;NOROESTE RIO-GRANDENSE;SANANDUVA;-27.77;-51.66;True;4824;2401;2423;1566;759;807;3258;1642;1616
4303301;Caibaté;RS;43;Sul;NOROESTE RIO-GRANDENSE;CERRO LARGO;-28.288;-54.638;True;5080;2576;2504;2650;1276;1374;2430;1300;1130
4303400;Caiçara;RS;43;Sul;NOROESTE RIO-GRANDENSE;FREDERICO WESTPHALEN;-27.274;-53.432;True;5184;2651;2533;1603;774;829;3581;1877;1704
4303509;Camaquã;RS;43;Sul;METROPOLITANA DE PORTO ALEGRE;CAMAQUA;-30.851;-51.812;True;60563;29723;30672;47455;22817;24550;13108;6906;6122
4303558;Camargo;RS;43;Sul;NOROESTE RIO-GRANDENSE;PASSO FUNDO;-28.587;-52.202;True;2471;1261;1201;1056;524;529;1415;737;672
4303608;Cambará do Sul;RS;43;Sul;NORDESTE RIO-GRANDENSE;VACARIA;-29.048;-50.145;True;6959;3603;3354;3490;1778;1712;3469;1825;1642
4303673;Campestre da Serra;RS;43;Sul;NORDESTE RIO-GRANDENSE;VACARIA;-28.795;-51.093;True;3205;1637;1568;1022;503;519;2183;1134;1049
4303707;Campina das MissõEs;RS;43;Sul;NOROESTE RIO-GRANDENSE;CERRO LARGO;-27.989;-54.839;True;6342;3174;3168;2270;1089;1181;4072;2085;1987
4303806;Campinas do Sul;RS;43;Sul;NOROESTE RIO-GRANDENSE;ERECHIM;-27.716;-52.628;True;5588;2704;2878;4185;1997;2184;1403;707;694
4303905;Campo Bom;RS;43;Sul;METROPOLITANA DE PORTO ALEGRE;PORTO ALEGRE;-29.679;-51.053;True;56595;27820;28697;52181;25552;26551;4414;2268;2146
4304002;Campo Novo;RS;43;Sul;NOROESTE RIO-GRANDENSE;TRES PASSOS;-27.675;-53.803;True;5581;2749;2824;4116;1996;2120;1465;753;704
4304101;Campos Borges;RS;43;Sul;NOROESTE RIO-GRANDENSE;CRUZ ALTA;-28.886;-52.999;True;3564;1808;1756;1931;937;994;1633;871;762
4304200;Candelária;RS;43;Sul;CENTRO ORIENTAL RIO-GRANDENSE;SANTA CRUZ DO SUL;-29.669;-52.789;True;29444;14441;15002;14372;6754;7618;15072;7687;7384
4304309;Cândido Godói;RS;43;Sul;NOROESTE RIO-GRANDENSE;SANTA ROSA;-27.952;-54.752;True;6634;3365;3266;1718;836;882;4916;2529;2384
4304358;Candiota;RS;43;Sul;SUDESTE RIO-GRANDENSE;SERRAS DE SUDESTE;-31.558;-53.673;True;8236;4265;3949;2538;1263;1275;5698;3002;2674
4304408;Canela;RS;43;Sul;METROPOLITANA DE PORTO ALEGRE;GRAMADO-CANELA;-29.366;-50.816;True;38318;18481;19094;34961;16786;17514;3357;1695;1580
4304507;Canguçu;RS;43;Sul;SUDESTE RIO-GRANDENSE;PELOTAS;-31.395;-52.676;True;53547;27143;26388;18817;8779;10038;34730;18364;16350
4304606;Canoas;RS;43;Sul;METROPOLITANA DE PORTO ALEGRE;PORTO ALEGRE;-29.918;-51.184;True;326458;;;;;;;;
4304614;Canudos do Vale;RS;43;Sul;CENTRO ORIENTAL RIO-GRANDENSE;LAJEADO-ESTRELA;-29.323;-52.234;True;1941;1034;907;445;228;217;1496;806;690
4304622;Capão Bonito do Sul;RS;43;Sul;NORDESTE RIO-GRANDENSE;VACARIA;-28.128;-51.394;True;1837;975;854;534;277;257;1303;698;597
4304630;Capão da Canoa;RS;43;Sul;METROPOLITANA DE PORTO ALEGRE;OSORIO;-29.761;-50.03;True;37405;16999;17666;37201;16899;17576;204;100;90
4304655;Capão do Cipó;RS;43;Sul;CENTRO OCIDENTAL RIO-GRANDENSE;SANTIAGO;-28.9257;-54.692;True;3180;1685;1495;431;214;217;2749;1471;1278
4304663;Capão do Leão;RS;43;Sul;SUDESTE RIO-GRANDENSE;PELOTAS;-31.763;-52.484;True;23655;11684;11969;21704;10656;11046;1951;1028;923
4304671;Capivari do Sul;RS;43;Sul;METROPOLITANA DE PORTO ALEGRE;OSORIO;-30.145;-50.515;True;3339;1656;1660;2493;1214;1260;846;442;400
4304689;Capela de Santana;RS;43;Sul;METROPOLITANA DE PORTO ALEGRE;MONTENEGRO;-29.7;-51.325;True;10950;5550;5400;6626;3293;3333;4324;2257;2067
4304697;Capitão;RS;43;Sul;CENTRO ORIENTAL RIO-GRANDENSE;LAJEADO-ESTRELA;-29.269;-51.989;True;2595;1356;1239;1059;528;531;1536;828;708
4304705;Carazinho;RS;43;Sul;NOROESTE RIO-GRANDENSE;CARAZINHO;-28.284;-52.786;True;58196;27793;30388;56823;27080;29735;1373;713;653
4304713;Caraá;RS;43;Sul;METROPOLITANA DE PORTO ALEGRE;OSORIO;-29.79;-50.435;True;7131;3736;3336;938;461;469;6193;3275;2867
4304804;Carlos Barbosa;RS;43;Sul;NORDESTE RIO-GRANDENSE;CAXIAS DO SUL;-29.298;-51.504;True;23960;12089;11871;18803;9415;9388;5157;2674;2483
4304853;Carlos Gomes;RS;43;Sul;NOROESTE RIO-GRANDENSE;ERECHIM;-27.718;-51.914;True;1719;889;830;379;187;192;1340;702;638
4304903;Casca;RS;43;Sul;NOROESTE RIO-GRANDENSE;PASSO FUNDO;-28.561;-51.978;True;8381;4153;4215;4647;2245;2389;3734;1908;1826
4304952;Caseiros;RS;43;Sul;NOROESTE RIO-GRANDENSE;PASSO FUNDO;-28.269;-51.69;True;2989;1517;1468;1407;694;713;1582;823;755
4305009;Catuípe;RS;43;Sul;NOROESTE RIO-GRANDENSE;SANTO ANGELO;-28.25;-54.012;True;9499;4671;4802;5907;2788;3119;3592;1883;1683
4305108;Caxias do Sul;RS;43;Sul;NORDESTE RIO-GRANDENSE;CAXIAS DO SUL;-29.168;-51.179;True;399038;;;;;;;;
4305116;Centenário;RS;43;Sul;NOROESTE RIO-GRANDENSE;ERECHIM;-27.761;-51.999;True;3026;1598;1428;863;437;426;2163;1161;1002
4305124;Cerrito;RS;43;Sul;SUDESTE RIO-GRANDENSE;PELOTAS;-31.856;-52.813;True;6629;3332;3288;3844;1873;1969;2785;1459;1319
4305132;Cerro Branco;RS;43;Sul;CENTRO ORIENTAL RIO-GRANDENSE;CACHOEIRA DO SUL;-29.654;-52.934;True;4465;2240;2225;1281;624;657;3184;1616;1568
4305157;Cerro Grande;RS;43;Sul;NOROESTE RIO-GRANDENSE;CARAZINHO;-27.606;-53.167;True;2577;1270;1230;782;379;403;1795;891;827
4305173;Cerro Grande do Sul;RS;43;Sul;METROPOLITANA DE PORTO ALEGRE;CAMAQUA;-30.59;-51.739;True;9233;4842;4383;2144;1055;1089;7089;3787;3294
4305207;Cerro Largo;RS;43;Sul;NOROESTE RIO-GRANDENSE;CERRO LARGO;-28.149;-54.738;True;12484;6149;6333;9547;4615;4932;2937;1534;1401
4305306;Chapada;RS;43;Sul;NOROESTE RIO-GRANDENSE;CARAZINHO;-28.055;-53.068;True;9440;4656;4784;5173;2469;2704;4267;2187;2080
4305355;Charqueadas;RS;43;Sul;METROPOLITANA DE PORTO ALEGRE;SAO JERONIMO;-29.955;-51.625;True;33705;18331;15374;32786;17703;15083;919;628;291
4305371;Charrua;RS;43;Sul;NOROESTE RIO-GRANDENSE;PASSO FUNDO;-27.952;-52.015;True;3581;1793;1785;555;269;286;3026;1524;1499
4305405;Chiapetta;RS;43;Sul;NOROESTE RIO-GRANDENSE;IJUI;-27.923;-53.941;True;4078;1986;2089;2366;1126;1240;1712;860;849
4305439;Chuí;RS;43;Sul;SUDESTE RIO-GRANDENSE;LITORAL LAGUNAR;-33.691;-53.457;True;5278;2590;2688;4986;2418;2568;292;172;120
4305447;Chuvisca;RS;43;Sul;METROPOLITANA DE PORTO ALEGRE;CAMAQUA;-30.758;-51.978;True;4874;2564;2310;259;127;132;4615;2437;2178
4305454;Cidreira;RS;43;Sul;METROPOLITANA DE PORTO ALEGRE;OSORIO;-30.161;-50.234;True;10883;5388;5365;10447;5154;5163;436;234;202
4305504;Ciríaco;RS;43;Sul;NOROESTE RIO-GRANDENSE;PASSO FUNDO;-28.344;-51.876;True;4945;2544;2401;2407;1200;1207;2538;1344;1194
4305587;Colinas;RS;43;Sul;CENTRO ORIENTAL RIO-GRANDENSE;LAJEADO-ESTRELA;-29.388;-51.87;True;2404;1197;1207;1120;539;581;1284;658;626
4305603;Colorado;RS;43;Sul;NOROESTE RIO-GRANDENSE;NAO-ME-TOQUE;-28.524;-52.994;True;3744;1785;1870;1919;892;998;1825;893;872
4305702;Condor;RS;43;Sul;NOROESTE RIO-GRANDENSE;IJUI;-28.208;-53.487;True;6607;3273;3334;3919;1909;2010;2688;1364;1324
4305801;Constantina;RS;43;Sul;NOROESTE RIO-GRANDENSE;FREDERICO WESTPHALEN;-27.735;-52.992;True;9842;4804;5015;6324;3016;3306;3518;1788;1709
4305835;Coqueiro Baixo;RS;43;Sul;CENTRO ORIENTAL RIO-GRANDENSE;LAJEADO-ESTRELA;-29.178;-52.093;True;1566;808;758;247;120;127;1319;688;631
4305850;Coqueiros do Sul;RS;43;Sul;NOROESTE RIO-GRANDENSE;CARAZINHO;-28.119;-52.783;True;3106;1628;1478;853;401;452;2253;1227;1026
4305871;Coronel Barros;RS;43;Sul;NOROESTE RIO-GRANDENSE;IJUI;-28.383;-54.066;True;2441;1213;1228;972;471;501;1469;742;727
4305900;Coronel Bicaco;RS;43;Sul;NOROESTE RIO-GRANDENSE;IJUI;-27.716;-53.701;True;7873;3895;3935;5109;2489;2603;2764;1406;1332
4305934;Coronel Pilar;RS;43;Sul;NORDESTE RIO-GRANDENSE;CAXIAS DO SUL;-29.273;-51.687;True;1658;863;795;173;77;96;1485;786;699
4305959;Cotiporã;RS;43;Sul;NORDESTE RIO-GRANDENSE;CAXIAS DO SUL;-28.994;-51.696;True;4577;2594;1983;2139;1089;1050;2438;1505;933
4305975;Coxilha;RS;43;Sul;NOROESTE RIO-GRANDENSE;PASSO FUNDO;-28.127;-52.296;True;2916;1435;1455;1741;834;898;1175;601;557
4306007;Crissiumal;RS;43;Sul;NOROESTE RIO-GRANDENSE;TRES PASSOS;-27.5;-54.101;True;14726;7255;7471;5977;2784;3193;8749;4471;4278
4306056;Cristal;RS;43;Sul;SUDESTE RIO-GRANDENSE;PELOTAS;-31.003;-52.05;True;7026;3565;3442;3912;1960;1952;3114;1605;1490
4306072;Cristal do Sul;RS;43;Sul;NOROESTE RIO-GRANDENSE;FREDERICO WESTPHALEN;-27.454;-53.246;True;2967;1575;1392;826;410;416;2141;1165;976
4306106;Cruz Alta;RS;43;Sul;NOROESTE RIO-GRANDENSE;CRUZ ALTA;-28.639;-53.606;True;63450;30086;33347;61412;28991;32404;2038;1095;943
4306130;Cruzaltense;RS;43;Sul;NOROESTE RIO-GRANDENSE;ERECHIM;-27.668;-52.649;True;2273;1173;1070;367;180;185;1906;993;885
4306205;Cruzeiro do Sul;RS;43;Sul;CENTRO ORIENTAL RIO-GRANDENSE;LAJEADO-ESTRELA;-29.513;-51.985;True;12171;6076;6095;7074;3486;3588;5097;2590;2507
4306304;David Canabarro;RS;43;Sul;NOROESTE RIO-GRANDENSE;PASSO FUNDO;-28.388;-51.848;True;4704;2380;2262;1845;886;959;2859;1494;1303
4306320;Derrubadas;RS;43;Sul;NOROESTE RIO-GRANDENSE;TRES PASSOS;-27.265;-53.861;True;3378;1711;1667;877;403;474;2501;1308;1193
4306353;Dezesseis de Novembro;RS;43;Sul;NOROESTE RIO-GRANDENSE;SANTO ANGELO;-28.213;-55.068;True;2968;1515;1452;623;314;309;2345;1201;1143
4306379;Dilermando de Aguiar;RS;43;Sul;CENTRO OCIDENTAL RIO-GRANDENSE;SANTA MARIA;-29.706;-54.208;True;3129;1629;1497;975;504;471;2154;1125;1026
4306403;Dois Irmãos;RS;43;Sul;METROPOLITANA DE PORTO ALEGRE;GRAMADO-CANELA;-29.58;-51.085;True;24815;12175;12343;24645;12086;12268;170;89;75
4306429;Dois Irmãos das MissõEs;RS;43;Sul;NOROESTE RIO-GRANDENSE;FREDERICO WESTPHALEN;-27.659;-53.531;True;2362;1195;1167;1053;521;532;1309;674;635
4306452;Dois Lajeados;RS;43;Sul;NORDESTE RIO-GRANDENSE;GUAPORE;-28.984;-51.836;True;3334;1704;1630;1431;689;742;1903;1015;888
4306502;Dom Feliciano;RS;43;Sul;METROPOLITANA DE PORTO ALEGRE;CAMAQUA;-30.704;-52.108;True;14504;7515;6989;3115;1477;1638;11389;6038;5351
4306551;Dom Pedro de Alcântara;RS;43;Sul;METROPOLITANA DE PORTO ALEGRE;OSORIO;-29.369;-49.85;True;2728;1355;1228;755;363;371;1973;992;857
4306601;Dom Pedrito;RS;43;Sul;SUDOESTE RIO-GRANDENSE;CAMPANHA MERIDIONAL;-30.983;-54.673;True;38148;18582;19514;34759;16643;18110;3389;1939;1404
4306700;Dona Francisca;RS;43;Sul;CENTRO OCIDENTAL RIO-GRANDENSE;RESTINGA SECA;-29.622;-53.357;True;3572;1782;1788;2200;1086;1112;1372;696;676
4306734;Doutor Maurício Cardoso;RS;43;Sul;NOROESTE RIO-GRANDENSE;TRES PASSOS;-27.506;-54.361;True;5494;2703;2754;2571;1245;1310;2923;1458;1444
4306759;Doutor Ricardo;RS;43;Sul;CENTRO ORIENTAL RIO-GRANDENSE;LAJEADO-ESTRELA;-29.086;-51.992;True;2053;1049;1004;590;291;299;1463;758;705
4306767;Eldorado do Sul;RS;43;Sul;METROPOLITANA DE PORTO ALEGRE;PORTO ALEGRE;-30.084;-51.616;True;31316;15506;15602;22653;11155;11426;8663;4351;4176
4306809;Encantado;RS;43;Sul;CENTRO ORIENTAL RIO-GRANDENSE;LAJEADO-ESTRELA;-29.236;-51.87;True;19536;9339;10006;16967;8042;8737;2569;1297;1269
4306908;Encruzilhada do Sul;RS;43;Sul;SUDESTE RIO-GRANDENSE;SERRAS DE SUDESTE;-30.544;-52.522;True;24152;12204;11933;16174;7821;8345;7978;4383;3588
4306924;Engenho Velho;RS;43;Sul;NOROESTE RIO-GRANDENSE;FREDERICO WESTPHALEN;-27.708;-52.913;True;1584;764;812;527;252;272;1057;512;540
4306932;Entre-Ijuís;RS;43;Sul;NOROESTE RIO-GRANDENSE;SANTO ANGELO;-28.36;-54.268;True;9126;4513;4613;4582;2188;2394;4544;2325;2219
4306957;Entre Rios do Sul;RS;43;Sul;NOROESTE RIO-GRANDENSE;ERECHIM;-27.528;-52.733;True;3101;1545;1543;1953;941;1012;1148;604;531
4306973;Erebango;RS;43;Sul;NOROESTE RIO-GRANDENSE;ERECHIM;-27.855;-52.302;True;2881;1462;1419;1906;945;961;975;517;458
4307005;Erechim;RS;43;Sul;NOROESTE RIO-GRANDENSE;ERECHIM;-27.634;-52.274;True;92945;44696;48142;87562;41956;45502;5383;2740;2640
4307054;Ernestina;RS;43;Sul;NOROESTE RIO-GRANDENSE;PASSO FUNDO;-28.499;-52.573;True;3010;1543;1457;1219;606;613;1791;937;844
4307104;Herval;RS;43;Sul;SUDESTE RIO-GRANDENSE;JAGUARAO;-32.024;-53.396;True;6873;3556;3317;4460;2155;2305;2413;1401;1012
4307203;Erval Grande;RS;43;Sul;NOROESTE RIO-GRANDENSE;ERECHIM;-27.391;-52.571;True;5294;2619;2524;2433;1175;1223;2861;1444;1301
4307302;Erval Seco;RS;43;Sul;NOROESTE RIO-GRANDENSE;FREDERICO WESTPHALEN;-27.549;-53.504;True;8212;4106;4079;3067;1427;1616;5145;2679;2463
4307401;Esmeralda;RS;43;Sul;NORDESTE RIO-GRANDENSE;VACARIA;-28.054;-51.19;True;3234;1636;1598;2141;1049;1092;1093;587;506
4307450;Esperança do Sul;RS;43;Sul;NOROESTE RIO-GRANDENSE;TRES PASSOS;-27.355;-53.992;True;3445;1726;1708;478;214;264;2967;1512;1444
4307500;Espumoso;RS;43;Sul;NOROESTE RIO-GRANDENSE;CRUZ ALTA;-28.725;-52.85;True;14991;7412;7570;10649;5129;5517;4342;2283;2053
4307559;Estação;RS;43;Sul;NOROESTE RIO-GRANDENSE;ERECHIM;-27.911;-52.26;True;6086;2989;3083;5192;2513;2665;894;476;418
4307609;Estância Velha;RS;43;Sul;METROPOLITANA DE PORTO ALEGRE;PORTO ALEGRE;-29.648;-51.174;True;40740;20149;20591;39695;19616;20079;1045;533;512
4307708;Esteio;RS;43;Sul;METROPOLITANA DE PORTO ALEGRE;PORTO ALEGRE;-29.861;-51.179;True;78816;37963;40245;78728;37919;40218;88;44;27
4307807;Estrela;RS;43;Sul;CENTRO ORIENTAL RIO-GRANDENSE;LAJEADO-ESTRELA;-29.502;-51.966;True;29071;14235;14824;24538;11908;12618;4533;2327;2206
4307815;Estrela Velha;RS;43;Sul;CENTRO ORIENTAL RIO-GRANDENSE;SANTA CRUZ DO SUL;-29.177;-53.159;True;3659;1896;1763;1004;504;500;2655;1392;1263
4307831;Eugênio de Castro;RS;43;Sul;NOROESTE RIO-GRANDENSE;SANTO ANGELO;-28.525;-54.149;True;3057;1523;1527;1106;517;589;1951;1006;938
4307864;Fagundes Varela;RS;43;Sul;NORDESTE RIO-GRANDENSE;CAXIAS DO SUL;-28.881;-51.698;True;2508;1264;1244;1223;606;617;1285;658;627
4307906;Farroupilha;RS;43;Sul;NORDESTE RIO-GRANDENSE;CAXIAS DO SUL;-29.225;-51.348;True;59871;29581;30290;47909;23465;24444;11962;6116;5846
4308003;Faxinal do Soturno;RS;43;Sul;CENTRO OCIDENTAL RIO-GRANDENSE;RESTINGA SECA;-29.575;-53.445;True;6343;3166;3173;3747;1810;1933;2596;1356;1240
4308052;Faxinalzinho;RS;43;Sul;NOROESTE RIO-GRANDENSE;ERECHIM;-27.424;-52.673;True;2613;1306;1301;1173;572;595;1440;734;706
4308078;Fazenda Vilanova;RS;43;Sul;CENTRO ORIENTAL RIO-GRANDENSE;LAJEADO-ESTRELA;-29.589;-51.825;True;3068;1430;1491;1420;675;719;1648;755;772
4308102;Feliz;RS;43;Sul;METROPOLITANA DE PORTO ALEGRE;MONTENEGRO;-29.451;-51.306;True;11679;5805;5825;8826;4385;4416;2853;1420;1409
4308201;Flores da Cunha;RS;43;Sul;NORDESTE RIO-GRANDENSE;CAXIAS DO SUL;-29.029;-51.182;True;25307;12774;12514;16410;8173;8228;8897;4601;4286
4308250;Floriano Peixoto;RS;43;Sul;NOROESTE RIO-GRANDENSE;ERECHIM;-27.861;-52.084;True;2148;1148;997;250;128;122;1898;1020;875
4308300;Fontoura Xavier;RS;43;Sul;NOROESTE RIO-GRANDENSE;SOLEDADE;-28.983;-52.346;True;11074;5724;5341;3836;1915;1921;7238;3809;3420
4308409;Formigueiro;RS;43;Sul;CENTRO OCIDENTAL RIO-GRANDENSE;RESTINGA SECA;-30;-53.499;True;7116;3665;3451;2385;1163;1222;4731;2502;2229
4308433;Forquetinha;RS;43;Sul;CENTRO ORIENTAL RIO-GRANDENSE;LAJEADO-ESTRELA;-29.382;-52.091;True;2548;1304;1244;465;238;227;2083;1066;1017
4308458;Fortaleza dos Valos;RS;43;Sul;NOROESTE RIO-GRANDENSE;CRUZ ALTA;-28.797;-53.223;True;4597;2253;2339;2891;1388;1503;1706;865;836
4308508;Frederico Westphalen;RS;43;Sul;NOROESTE RIO-GRANDENSE;FREDERICO WESTPHALEN;-27.359;-53.394;True;27308;13290;14008;21544;10271;11263;5764;3019;2745
4308607;Garibaldi;RS;43;Sul;NORDESTE RIO-GRANDENSE;CAXIAS DO SUL;-29.256;-51.534;True;28791;14235;14540;25589;12556;13017;3202;1679;1523
4308656;Garruchos;RS;43;Sul;SUDOESTE RIO-GRANDENSE;CAMPANHA OCIDENTAL;-28.184;-55.639;True;3457;1800;1657;1109;534;575;2348;1266;1082
4308706;Gaurama;RS;43;Sul;NOROESTE RIO-GRANDENSE;ERECHIM;-27.584;-52.094;True;6108;2978;3127;3247;1540;1707;2861;1438;1420
4308805;General Câmara;RS;43;Sul;METROPOLITANA DE PORTO ALEGRE;SAO JERONIMO;-29.905;-51.76;True;8782;4398;4310;5242;2533;2701;3540;1865;1609
4308854;Gentil;RS;43;Sul;NOROESTE RIO-GRANDENSE;PASSO FUNDO;-28.43;-52.036;True;1579;829;747;571;292;276;1008;537;471
4308904;Getúlio Vargas;RS;43;Sul;NOROESTE RIO-GRANDENSE;ERECHIM;-27.89;-52.228;True;15961;7720;8199;13356;6375;6957;2605;1345;1242
4309001;Giruá;RS;43;Sul;NOROESTE RIO-GRANDENSE;SANTO ANGELO;-28.028;-54.35;True;17070;8274;8765;12484;5864;6606;4586;2410;2159
4309050;Glorinha;RS;43;Sul;METROPOLITANA DE PORTO ALEGRE;PORTO ALEGRE;-29.881;-50.767;True;6908;3604;3304;1906;947;959;5002;2657;2345
4309100;Gramado;RS;43;Sul;METROPOLITANA DE PORTO ALEGRE;GRAMADO-CANELA;-29.379;-50.874;True;31652;15406;15963;28080;13540;14257;3572;1866;1706
4309126;Gramado dos Loureiros;RS;43;Sul;NOROESTE RIO-GRANDENSE;FREDERICO WESTPHALEN;-27.444;-52.918;True;2370;1139;1148;480;214;243;1890;925;905
4309159;Gramado Xavier;RS;43;Sul;CENTRO ORIENTAL RIO-GRANDENSE;SANTA CRUZ DO SUL;-29.268;-52.579;True;3911;2006;1903;418;196;222;3493;1810;1681
4309209;Gravataí;RS;43;Sul;METROPOLITANA DE PORTO ALEGRE;PORTO ALEGRE;-29.944;-50.992;True;261150;;;;;;;;
4309258;Guabiju;RS;43;Sul;NORDESTE RIO-GRANDENSE;GUAPORE;-28.541;-51.69;True;1669;839;830;702;343;359;967;496;471
4309308;Guaíba;RS;43;Sul;METROPOLITANA DE PORTO ALEGRE;PORTO ALEGRE;-30.114;-51.325;True;93578;45588;47849;91400;44450;46893;2178;1138;956
4309407;Guaporé;RS;43;Sul;NORDESTE RIO-GRANDENSE;GUAPORE;-28.846;-51.89;True;21421;10359;11062;19426;9295;10131;1995;1064;931
4309506;Guarani das MissõEs;RS;43;Sul;NOROESTE RIO-GRANDENSE;CERRO LARGO;-28.141;-54.558;True;8331;4100;4222;4920;2326;2592;3411;1774;1630
4309555;Harmonia;RS;43;Sul;METROPOLITANA DE PORTO ALEGRE;MONTENEGRO;-29.548;-51.426;True;3658;1851;1807;2086;1044;1042;1572;807;765
4309571;Herveiras;RS;43;Sul;CENTRO ORIENTAL RIO-GRANDENSE;SANTA CRUZ DO SUL;-29.407;-52.653;True;2825;1467;1358;356;178;178;2469;1289;1180
4309605;Horizontina;RS;43;Sul;NOROESTE RIO-GRANDENSE;TRES PASSOS;-27.626;-54.308;True;18305;8948;9342;14234;6883;7351;4071;2065;1991
4309654;Hulha Negra;RS;43;Sul;SUDOESTE RIO-GRANDENSE;CAMPANHA MERIDIONAL;-31.404;-53.869;True;6030;3099;2883;2625;1302;1323;3405;1797;1560
4309704;Humaitá;RS;43;Sul;NOROESTE RIO-GRANDENSE;TRES PASSOS;-27.563;-53.974;True;4923;2400;2522;2762;1302;1460;2161;1098;1062
4309753;Ibarama;RS;43;Sul;CENTRO ORIENTAL RIO-GRANDENSE;SANTA CRUZ DO SUL;-29.419;-53.135;True;4331;2259;2072;1041;511;530;3290;1748;1542
4309803;Ibiaçá;RS;43;Sul;NOROESTE RIO-GRANDENSE;SANANDUVA;-28.057;-51.855;True;4681;2266;2415;2777;1325;1452;1904;941;963
4309902;Ibiraiaras;RS;43;Sul;NOROESTE RIO-GRANDENSE;PASSO FUNDO;-28.37;-51.636;True;7094;3581;3513;3432;1696;1736;3662;1885;1777
4309951;Ibirapuitã;RS;43;Sul;NOROESTE RIO-GRANDENSE;SOLEDADE;-28.624;-52.511;True;4182;2108;2074;2231;1081;1150;1951;1027;924
4310009;Ibirubá;RS;43;Sul;NOROESTE RIO-GRANDENSE;CRUZ ALTA;-28.628;-53.09;True;18690;9116;9548;14388;6929;7450;4302;2187;2098
4310108;Igrejinha;RS;43;Sul;METROPOLITANA DE PORTO ALEGRE;GRAMADO-CANELA;-29.574;-50.79;True;31113;15321;15769;29860;14684;15176;1253;637;593
4310207;Ijuí;RS;43;Sul;NOROESTE RIO-GRANDENSE;IJUI;-28.388;-53.915;True;76739;36998;39501;69107;33073;35803;7632;3925;3698
4310306;Ilópolis;RS;43;Sul;NORDESTE RIO-GRANDENSE;GUAPORE;-28.927;-52.124;True;4202;2105;2091;2122;1016;1103;2080;1089;988
4310330;Imbé;RS;43;Sul;METROPOLITANA DE PORTO ALEGRE;OSORIO;-29.975;-50.128;True;14940;7340;7496;14898;7316;7478;42;24;18
4310363;Imigrante;RS;43;Sul;CENTRO ORIENTAL RIO-GRANDENSE;LAJEADO-ESTRELA;-29.355;-51.777;True;3013;1485;1528;1422;679;743;1591;806;785
4310405;Independência;RS;43;Sul;NOROESTE RIO-GRANDENSE;SANTA ROSA;-27.833;-54.188;True;6679;3303;3376;3894;1861;2033;2785;1442;1343
4310413;Inhacorá;RS;43;Sul;NOROESTE RIO-GRANDENSE;IJUI;-27.883;-54.017;True;2290;1177;1113;1289;648;641;1001;529;472
4310439;Ipê;RS;43;Sul;NORDESTE RIO-GRANDENSE;VACARIA;-28.82;-51.279;True;5875;3037;2838;2731;1346;1385;3144;1691;1453
4310462;Ipiranga do Sul;RS;43;Sul;NOROESTE RIO-GRANDENSE;ERECHIM;-27.937;-52.426;True;1983;980;1003;645;307;338;1338;673;665
4310504;Iraí;RS;43;Sul;NOROESTE RIO-GRANDENSE;FREDERICO WESTPHALEN;-27.194;-53.251;True;8468;4264;4196;4460;2165;2295;4008;2099;1901
4310538;Itaara;RS;43;Sul;CENTRO OCIDENTAL RIO-GRANDENSE;SANTA MARIA;-29.61;-53.765;True;4633;2368;2256;3505;1758;1738;1128;610;518
4310553;Itacurubi;RS;43;Sul;CENTRO OCIDENTAL RIO-GRANDENSE;SANTIAGO;-28.787;-55.251;True;3568;1890;1678;1168;558;610;2400;1332;1068
4310579;Itapuca;RS;43;Sul;NORDESTE RIO-GRANDENSE;GUAPORE;-28.78;-52.172;True;2454;1273;1176;506;244;259;1948;1029;917
4310603;Itaqui;RS;43;Sul;SUDOESTE RIO-GRANDENSE;CAMPANHA OCIDENTAL;-29.125;-56.553;True;36361;18011;18154;31794;15466;16132;4567;2545;2022
4310652;Itati;RS;43;Sul;METROPOLITANA DE PORTO ALEGRE;OSORIO;-29.489;-50.105;True;2677;1386;1281;239;120;119;2438;1266;1162
4310702;Itatiba do Sul;RS;43;Sul;NOROESTE RIO-GRANDENSE;ERECHIM;-27.387;-52.453;True;4574;2382;2191;1633;820;812;2941;1562;1379
4310751;Ivorá;RS;43;Sul;CENTRO OCIDENTAL RIO-GRANDENSE;RESTINGA SECA;-29.52;-53.581;True;2378;1193;1143;763;340;414;1615;853;729
4310801;Ivoti;RS;43;Sul;METROPOLITANA DE PORTO ALEGRE;GRAMADO-CANELA;-29.591;-51.161;True;18517;9155;9337;16572;8133;8414;1945;1022;923
4310850;Jaboticaba;RS;43;Sul;NOROESTE RIO-GRANDENSE;CARAZINHO;-27.631;-53.277;True;4173;2126;2047;1377;670;707;2796;1456;1340
4310876;Jacuizinho;RS;43;Sul;NOROESTE RIO-GRANDENSE;CRUZ ALTA;-29.034;-53.059;True;2619;1340;1260;588;291;297;2031;1049;963
4310900;Jacutinga;RS;43;Sul;NOROESTE RIO-GRANDENSE;ERECHIM;-27.729;-52.535;True;3567;1752;1807;2284;1103;1173;1283;649;634
4311007;Jaguarão;RS;43;Sul;SUDESTE RIO-GRANDENSE;JAGUARAO;-32.566;-53.376;True;27944;13669;14253;25580;12248;13325;2364;1421;928
4311106;Jaguari;RS;43;Sul;CENTRO OCIDENTAL RIO-GRANDENSE;SANTA MARIA;-29.497;-54.69;True;11626;5866;5760;6425;3106;3319;5201;2760;2441
4311122;Jaquirana;RS;43;Sul;NORDESTE RIO-GRANDENSE;VACARIA;-28.885;-50.358;True;4404;2248;2151;2569;1251;1318;1835;997;833
4311130;Jari;RS;43;Sul;CENTRO OCIDENTAL RIO-GRANDENSE;SANTIAGO;-29.291;-54.224;True;3692;1957;1735;563;285;278;3129;1672;1457
4311155;Jóia;RS;43;Sul;NOROESTE RIO-GRANDENSE;CRUZ ALTA;-28.647;-54.122;True;8279;4292;3987;1959;920;1039;6320;3372;2948
4311205;Júlio de Castilhos;RS;43;Sul;CENTRO OCIDENTAL RIO-GRANDENSE;SANTIAGO;-29.227;-53.682;True;19541;9669;9872;16200;7904;8296;3341;1765;1576
4311239;Lagoa Bonita do Sul;RS;43;Sul;CENTRO ORIENTAL RIO-GRANDENSE;SANTA CRUZ DO SUL;-29.489;-53.014;True;2617;1368;1220;317;157;160;2300;1211;1060
4311254;Lagoão;RS;43;Sul;NOROESTE RIO-GRANDENSE;SOLEDADE;-29.235;-52.796;True;6389;3294;3047;1159;566;593;5230;2728;2454
4311270;Lagoa dos Três Cantos;RS;43;Sul;NOROESTE RIO-GRANDENSE;NAO-ME-TOQUE;-28.571;-52.858;True;1590;775;815;783;386;397;807;389;418
4311304;Lagoa Vermelha;RS;43;Sul;NORDESTE RIO-GRANDENSE;VACARIA;-28.209;-51.526;True;27434;13614;13782;23645;11576;12036;3789;2038;1746
4311403;Lajeado;RS;43;Sul;CENTRO ORIENTAL RIO-GRANDENSE;LAJEADO-ESTRELA;-29.467;-51.961;True;67474;32923;34551;67239;32795;34444;235;128;107
4311429;Lajeado do Bugre;RS;43;Sul;NOROESTE RIO-GRANDENSE;CARAZINHO;-27.689;-53.182;True;2536;1301;1232;610;281;329;1926;1020;903
4311502;Lavras do Sul;RS;43;Sul;SUDOESTE RIO-GRANDENSE;CAMPANHA MERIDIONAL;-30.813;-53.895;True;8115;4015;4098;4738;2229;2509;3377;1786;1589
4311601;Liberato Salzano;RS;43;Sul;NOROESTE RIO-GRANDENSE;FREDERICO WESTPHALEN;-27.6;-53.073;True;6102;3138;2952;1345;663;679;4757;2475;2273
4311627;Lindolfo Collor;RS;43;Sul;METROPOLITANA DE PORTO ALEGRE;GRAMADO-CANELA;-29.597;-51.209;True;5279;2720;2559;4425;2290;2135;854;430;424
4311643;Linha Nova;RS;43;Sul;METROPOLITANA DE PORTO ALEGRE;MONTENEGRO;-29.468;-51.201;True;1488;747;741;393;174;219;1095;573;522
4311700;Machadinho;RS;43;Sul;NOROESTE RIO-GRANDENSE;SANANDUVA;-27.567;-51.668;True;5503;2768;2735;3081;1494;1587;2422;1274;1148
4311718;Maçambara;RS;43;Sul;SUDOESTE RIO-GRANDENSE;CAMPANHA OCIDENTAL;-29.143;-56.065;True;4415;2225;2037;1264;615;649;3151;1610;1388
4311734;Mampituba;RS;43;Sul;METROPOLITANA DE PORTO ALEGRE;OSORIO;-29.211;-49.935;True;2926;1508;1418;464;222;242;2462;1286;1176
4311759;Manoel Viana;RS;43;Sul;SUDOESTE RIO-GRANDENSE;CAMPANHA OCIDENTAL;-29.589;-55.483;True;6784;3402;3382;5103;2456;2647;1681;946;735
4311775;Maquiné;RS;43;Sul;METROPOLITANA DE PORTO ALEGRE;OSORIO;-29.675;-50.207;True;7374;3662;3471;2206;1114;1092;5168;2548;2379
4311791;Maratá;RS;43;Sul;METROPOLITANA DE PORTO ALEGRE;MONTENEGRO;-29.549;-51.554;True;2444;1233;1204;719;354;362;1725;879;842
4311809;Marau;RS;43;Sul;NOROESTE RIO-GRANDENSE;PASSO FUNDO;-28.449;-52.2;True;33778;16751;16997;28729;14126;14598;5049;2625;2399
4311908;Marcelino Ramos;RS;43;Sul;NOROESTE RIO-GRANDENSE;ERECHIM;-27.462;-51.906;True;5372;2700;2672;2783;1354;1429;2589;1346;1243
4311981;Mariana Pimentel;RS;43;Sul;METROPOLITANA DE PORTO ALEGRE;PORTO ALEGRE;-30.353;-51.583;True;3964;2112;1852;671;337;334;3293;1775;1518
4312005;Mariano Moro;RS;43;Sul;NOROESTE RIO-GRANDENSE;ERECHIM;-27.354;-52.147;True;2284;1187;1097;1066;541;525;1218;646;572
4312054;Marques de Souza;RS;43;Sul;CENTRO ORIENTAL RIO-GRANDENSE;LAJEADO-ESTRELA;-29.328;-52.093;True;4043;2043;2000;1492;724;768;2551;1319;1232
4312104;Mata;RS;43;Sul;CENTRO OCIDENTAL RIO-GRANDENSE;SANTA MARIA;-29.566;-54.46;True;5291;2694;2597;2728;1330;1398;2563;1364;1199
4312138;Mato Castelhano;RS;43;Sul;NOROESTE RIO-GRANDENSE;PASSO FUNDO;-28.278;-52.192;True;2608;1348;1214;471;236;229;2137;1112;985
4312153;Mato Leitão;RS;43;Sul;CENTRO ORIENTAL RIO-GRANDENSE;SANTA CRUZ DO SUL;-29.524;-52.129;True;3585;1790;1795;1524;737;787;2061;1053;1008
4312179;Mato Queimado;RS;43;Sul;NOROESTE RIO-GRANDENSE;CERRO LARGO;-28.256;-54.616;True;1865;949;916;422;200;222;1443;749;694
4312203;Maximiliano de Almeida;RS;43;Sul;NOROESTE RIO-GRANDENSE;SANANDUVA;-27.632;-51.803;True;5059;2542;2517;2934;1404;1530;2125;1138;987
4312252;Minas do Leão;RS;43;Sul;METROPOLITANA DE PORTO ALEGRE;SAO JERONIMO;-30.127;-52.048;True;7728;3857;3825;7412;3665;3701;316;192;124
4312302;Miraguaí;RS;43;Sul;NOROESTE RIO-GRANDENSE;TRES PASSOS;-27.494;-53.686;True;4869;2394;2475;1803;838;965;3066;1556;1510
4312351;Montauri;RS;43;Sul;NORDESTE RIO-GRANDENSE;GUAPORE;-28.652;-52.07;True;1583;810;762;620;305;315;963;505;447
4312377;Monte Alegre dos Campos;RS;43;Sul;NORDESTE RIO-GRANDENSE;VACARIA;-28.683;-50.783;True;3122;1667;1455;152;74;78;2970;1593;1377
4312385;Monte Belo do Sul;RS;43;Sul;NORDESTE RIO-GRANDENSE;CAXIAS DO SUL;-29.163;-51.632;True;2766;1403;1363;689;326;363;2077;1077;1000
4312401;Montenegro;RS;43;Sul;METROPOLITANA DE PORTO ALEGRE;MONTENEGRO;-29.689;-51.461;True;56790;27948;28296;50470;24280;25725;6320;3668;2571
4312427;Mormaço;RS;43;Sul;NOROESTE RIO-GRANDENSE;SOLEDADE;-28.692;-52.692;True;2578;1324;1254;471;243;228;2107;1081;1026
4312443;Morrinhos do Sul;RS;43;Sul;METROPOLITANA DE PORTO ALEGRE;OSORIO;-29.365;-49.935;True;3241;1640;1601;1345;651;694;1896;989;907
4312450;Morro Redondo;RS;43;Sul;SUDESTE RIO-GRANDENSE;PELOTAS;-31.588;-52.633;True;6199;3117;3040;2623;1268;1355;3576;1849;1685
4312476;Morro Reuter;RS;43;Sul;METROPOLITANA DE PORTO ALEGRE;GRAMADO-CANELA;-29.538;-51.081;True;5599;2843;2743;4741;2385;2353;858;458;390
4312500;Mostardas;RS;43;Sul;METROPOLITANA DE PORTO ALEGRE;OSORIO;-31.107;-50.921;True;11903;6057;5819;7875;3933;3942;4028;2124;1877
4312609;Muçum;RS;43;Sul;CENTRO ORIENTAL RIO-GRANDENSE;LAJEADO-ESTRELA;-29.165;-51.868;True;4574;2200;2364;3789;1799;1980;785;401;384
4312617;Muitos CapõEs;RS;43;Sul;NORDESTE RIO-GRANDENSE;VACARIA;-28.314;-51.182;True;2969;1518;1451;947;450;497;2022;1068;954
4312625;Muliterno;RS;43;Sul;NOROESTE RIO-GRANDENSE;PASSO FUNDO;-28.329;-51.768;True;1800;925;875;459;224;235;1341;701;640
4312658;Não-Me-Toque;RS;43;Sul;NOROESTE RIO-GRANDENSE;NAO-ME-TOQUE;-28.459;-52.821;True;15228;7475;7753;13096;6385;6711;2132;1090;1042
4312674;Nicolau Vergueiro;RS;43;Sul;NOROESTE RIO-GRANDENSE;PASSO FUNDO;-28.536;-52.464;True;1759;881;863;607;300;307;1152;581;556
4312708;Nonoai;RS;43;Sul;NOROESTE RIO-GRANDENSE;FREDERICO WESTPHALEN;-27.362;-52.771;True;12327;6023;6216;9043;4315;4685;3284;1708;1531
4312757;Nova Alvorada;RS;43;Sul;NORDESTE RIO-GRANDENSE;GUAPORE;-28.678;-52.166;True;3058;1558;1500;1147;566;581;1911;992;919
4312807;Nova Araçá;RS;43;Sul;NORDESTE RIO-GRANDENSE;GUAPORE;-28.659;-51.745;True;3775;1841;1934;2577;1243;1334;1198;598;600
4312906;Nova Bassano;RS;43;Sul;NORDESTE RIO-GRANDENSE;GUAPORE;-28.724;-51.705;True;8683;4439;4244;5210;2608;2602;3473;1831;1642
4312955;Nova Boa Vista;RS;43;Sul;NOROESTE RIO-GRANDENSE;CARAZINHO;-27.994;-52.979;True;2083;1038;1021;504;248;256;1579;790;765
4313003;Nova Bréscia;RS;43;Sul;CENTRO ORIENTAL RIO-GRANDENSE;LAJEADO-ESTRELA;-29.214;-52.028;True;3162;1603;1559;1428;693;735;1734;910;824
4313011;Nova Candelária;RS;43;Sul;NOROESTE RIO-GRANDENSE;TRES PASSOS;-27.607;-54.107;True;2739;1401;1334;440;219;221;2299;1182;1113
4313037;Nova Esperança do Sul;RS;43;Sul;CENTRO OCIDENTAL RIO-GRANDENSE;SANTA MARIA;-29.41;-54.829;True;4775;2394;2381;3634;1783;1851;1141;611;530
4313060;Nova Hartz;RS;43;Sul;METROPOLITANA DE PORTO ALEGRE;PORTO ALEGRE;-29.583;-50.902;True;16688;8337;8349;14039;7003;7036;2649;1334;1313
4313086;Nova Pádua;RS;43;Sul;NORDESTE RIO-GRANDENSE;CAXIAS DO SUL;-29.029;-51.307;True;2484;1325;1158;739;408;331;1745;917;827
4313102;Nova Palma;RS;43;Sul;CENTRO OCIDENTAL RIO-GRANDENSE;RESTINGA SECA;-29.472;-53.469;True;6432;3268;3164;2898;1418;1480;3534;1850;1684
4313201;Nova Petrópolis;RS;43;Sul;METROPOLITANA DE PORTO ALEGRE;GRAMADO-CANELA;-29.376;-51.114;True;17747;8757;8978;12846;6241;6604;4901;2516;2374
4313300;Nova Prata;RS;43;Sul;NORDESTE RIO-GRANDENSE;GUAPORE;-28.784;-51.61;True;22257;11055;11194;18204;8992;9204;4053;2063;1990
4313334;Nova Ramada;RS;43;Sul;NOROESTE RIO-GRANDENSE;IJUI;-28.064;-53.697;True;2461;1257;1203;601;289;312;1860;968;891
4313359;Nova Roma do Sul;RS;43;Sul;NORDESTE RIO-GRANDENSE;CAXIAS DO SUL;-28.99;-51.408;True;3490;1762;1693;1777;893;884;1713;869;809
4313375;Nova Santa Rita;RS;43;Sul;METROPOLITANA DE PORTO ALEGRE;PORTO ALEGRE;-29.857;-51.274;True;20591;10263;10034;16941;8331;8363;3650;1932;1671
4313391;Novo Cabrais;RS;43;Sul;CENTRO ORIENTAL RIO-GRANDENSE;CACHOEIRA DO SUL;-29.735;-52.948;True;3766;1930;1834;451;224;227;3315;1706;1607
4313409;Novo Hamburgo;RS;43;Sul;METROPOLITANA DE PORTO ALEGRE;PORTO ALEGRE;-29.678;-51.131;True;253067;;;;;;;;
4313425;Novo Machado;RS;43;Sul;NOROESTE RIO-GRANDENSE;SANTA ROSA;-27.574;-54.505;True;4246;2066;2051;1626;750;790;2620;1316;1261
4313441;Novo Tiradentes;RS;43;Sul;NOROESTE RIO-GRANDENSE;FREDERICO WESTPHALEN;-27.563;-53.182;True;2331;1210;1092;629;300;303;1702;910;789
4313466;Novo Xingu;RS;43;Sul;NOROESTE RIO-GRANDENSE;FREDERICO WESTPHALEN;-27.747;-53.054;True;1858;902;928;448;214;226;1410;688;702
4313490;Novo Barreiro;RS;43;Sul;NOROESTE RIO-GRANDENSE;CARAZINHO;-27.909;-53.108;True;3858;1962;1871;1020;499;521;2838;1463;1350
4313508;Osório;RS;43;Sul;METROPOLITANA DE PORTO ALEGRE;OSORIO;-29.887;-50.27;True;39290;19280;19431;33819;16014;17270;5471;3266;2161
4313607;Paim Filho;RS;43;Sul;NOROESTE RIO-GRANDENSE;SANANDUVA;-27.711;-51.761;True;4480;2252;2228;2178;1055;1123;2302;1197;1105
4313656;Palmares do Sul;RS;43;Sul;METROPOLITANA DE PORTO ALEGRE;OSORIO;-30.258;-50.51;True;11423;5709;5697;9918;4912;5006;1505;797;691
4313706;Palmeira das MissõEs;RS;43;Sul;NOROESTE RIO-GRANDENSE;CARAZINHO;-27.899;-53.314;True;33846;16477;17340;28608;13736;14858;5238;2741;2482
4313805;Palmitinho;RS;43;Sul;NOROESTE RIO-GRANDENSE;FREDERICO WESTPHALEN;-27.355;-53.555;True;6905;3526;3379;2799;1399;1400;4106;2127;1979
4313904;Panambi;RS;43;Sul;NOROESTE RIO-GRANDENSE;IJUI;-28.293;-53.502;True;36360;18078;18265;32682;16217;16456;3678;1861;1809
4313953;Pantano Grande;RS;43;Sul;CENTRO ORIENTAL RIO-GRANDENSE;CACHOEIRA DO SUL;-30.191;-52.374;True;9816;4898;4898;8231;4030;4181;1585;868;717
4314001;Paraí;RS;43;Sul;NORDESTE RIO-GRANDENSE;GUAPORE;-28.594;-51.786;True;6577;3330;3247;3547;1749;1798;3030;1581;1449
4314027;Paraíso do Sul;RS;43;Sul;CENTRO ORIENTAL RIO-GRANDENSE;CACHOEIRA DO SUL;-29.669;-53.149;True;7346;3726;3620;1735;832;903;5611;2894;2717
4314035;Pareci Novo;RS;43;Sul;METROPOLITANA DE PORTO ALEGRE;MONTENEGRO;-29.638;-51.398;True;3151;1592;1550;870;433;437;2281;1159;1113
4314050;Parobé;RS;43;Sul;METROPOLITANA DE PORTO ALEGRE;PORTO ALEGRE;-29.629;-50.835;True;48713;24037;24579;46179;22776;23343;2534;1261;1236
4314068;Passa Sete;RS;43;Sul;CENTRO ORIENTAL RIO-GRANDENSE;SANTA CRUZ DO SUL;-29.453;-52.961;True;4996;2596;2392;501;247;254;4495;2349;2138
4314076;Passo do Sobrado;RS;43;Sul;CENTRO ORIENTAL RIO-GRANDENSE;CACHOEIRA DO SUL;-29.748;-52.275;True;5967;2962;2981;1356;618;734;4611;2344;2247
4314100;Passo Fundo;RS;43;Sul;NOROESTE RIO-GRANDENSE;PASSO FUNDO;-28.263;-52.407;True;183300;;;;;;;;
4314134;Paulo Bento;RS;43;Sul;NOROESTE RIO-GRANDENSE;ERECHIM;-27.703;-52.421;True;2090;1064;1006;477;239;238;1613;825;768
4314159;Paverama;RS;43;Sul;CENTRO ORIENTAL RIO-GRANDENSE;LAJEADO-ESTRELA;-29.552;-51.733;True;7616;3854;3754;3893;1925;1968;3723;1929;1786
4314175;Pedras Altas;RS;43;Sul;SUDESTE RIO-GRANDENSE;SERRAS DE SUDESTE;-31.733;-53.584;True;2546;1388;1125;840;416;424;1706;972;701
4314209;Pedro Osório;RS;43;Sul;SUDESTE RIO-GRANDENSE;PELOTAS;-31.864;-52.823;True;8039;3937;4086;7303;3494;3809;736;443;277
4314308;Pejuçara;RS;43;Sul;NOROESTE RIO-GRANDENSE;IJUI;-28.423;-53.656;True;3900;1968;1925;2545;1258;1284;1355;710;641
4314407;Pelotas;RS;43;Sul;SUDESTE RIO-GRANDENSE;PELOTAS;-31.772;-52.343;True;339934;;;;;;;;
4314423;Picada Café;RS;43;Sul;METROPOLITANA DE PORTO ALEGRE;GRAMADO-CANELA;-29.444;-51.136;True;4824;2428;2366;4444;2231;2185;380;197;181
4314456;Pinhal;RS;43;Sul;NOROESTE RIO-GRANDENSE;CARAZINHO;-27.511;-53.215;True;2362;1182;1180;1076;497;579;1286;685;601
4314464;Pinhal da Serra;RS;43;Sul;NORDESTE RIO-GRANDENSE;VACARIA;-27.874;-51.17;True;2058;1072;986;448;229;219;1610;843;767
4314472;Pinhal Grande;RS;43;Sul;CENTRO OCIDENTAL RIO-GRANDENSE;SANTIAGO;-29.346;-53.307;True;4496;2319;2167;1765;858;907;2731;1461;1260
4314498;Pinheirinho do Vale;RS;43;Sul;NOROESTE RIO-GRANDENSE;FREDERICO WESTPHALEN;-27.21;-53.612;True;4411;2222;2189;862;412;450;3549;1810;1739
4314506;Pinheiro Machado;RS;43;Sul;SUDESTE RIO-GRANDENSE;SERRAS DE SUDESTE;-31.578;-53.381;True;12939;6453;6428;9635;4546;5031;3304;1907;1397
4314555;Pirapó;RS;43;Sul;NOROESTE RIO-GRANDENSE;SANTO ANGELO;-28.045;-55.199;True;2988;1522;1454;725;349;376;2263;1173;1078
4314605;Piratini;RS;43;Sul;SUDESTE RIO-GRANDENSE;SERRAS DE SUDESTE;-31.448;-53.104;True;20225;10339;9854;11710;5670;6037;8515;4669;3817
4314704;Planalto;RS;43;Sul;NOROESTE RIO-GRANDENSE;FREDERICO WESTPHALEN;-27.329;-53.059;True;10589;5202;5381;5602;2633;2969;4987;2569;2412
4314753;Poço das Antas;RS;43;Sul;METROPOLITANA DE PORTO ALEGRE;MONTENEGRO;-29.45;-51.671;True;1976;1012;964;737;360;377;1239;652;587
4314779;Pontão;RS;43;Sul;NOROESTE RIO-GRANDENSE;PASSO FUNDO;-28.059;-52.677;True;3904;1997;1870;1514;734;774;2390;1263;1096
4314787;Ponte Preta;RS;43;Sul;NOROESTE RIO-GRANDENSE;ERECHIM;-27.654;-52.488;True;1840;964;861;482;238;229;1358;726;632
4314803;Portão;RS;43;Sul;METROPOLITANA DE PORTO ALEGRE;MONTENEGRO;-29.702;-51.242;True;28583;14255;14321;23334;11526;11801;5249;2729;2520
4314902;Porto Alegre;RS;43;Sul;METROPOLITANA DE PORTO ALEGRE;PORTO ALEGRE;-30.033;-51.23;True;1420667;;;;;;;;
4315008;Porto Lucena;RS;43;Sul;NOROESTE RIO-GRANDENSE;SANTA ROSA;-27.856;-55.016;True;5631;2816;2815;2256;1080;1176;3375;1736;1639
4315057;Porto Mauá;RS;43;Sul;NOROESTE RIO-GRANDENSE;SANTA ROSA;-27.575;-54.668;True;2565;1282;1280;911;445;463;1654;837;817
4315073;Porto Vera Cruz;RS;43;Sul;NOROESTE RIO-GRANDENSE;SANTA ROSA;-27.736;-54.901;True;2084;1064;1020;479;221;258;1605;843;762
4315107;Porto Xavier;RS;43;Sul;NOROESTE RIO-GRANDENSE;CERRO LARGO;-27.906;-55.138;True;10857;5433;5416;5396;2624;2764;5461;2809;2652
4315131;Pouso Novo;RS;43;Sul;CENTRO ORIENTAL RIO-GRANDENSE;LAJEADO-ESTRELA;-29.171;-52.208;True;1992;1012;980;582;287;295;1410;725;685
4315149;Presidente Lucena;RS;43;Sul;METROPOLITANA DE PORTO ALEGRE;GRAMADO-CANELA;-29.519;-51.178;True;2355;1232;1119;1135;573;558;1220;659;561
4315156;Progresso;RS;43;Sul;CENTRO ORIENTAL RIO-GRANDENSE;LAJEADO-ESTRELA;-29.244;-52.312;True;6210;3150;3060;1803;853;950;4407;2297;2110
4315172;Protásio Alves;RS;43;Sul;NORDESTE RIO-GRANDENSE;GUAPORE;-28.757;-51.473;True;2114;1132;982;418;213;205;1696;919;777
4315206;Putinga;RS;43;Sul;NORDESTE RIO-GRANDENSE;GUAPORE;-29.002;-52.154;True;4192;2138;2051;1467;709;758;2725;1429;1293
4315305;Quaraí;RS;43;Sul;SUDOESTE RIO-GRANDENSE;CAMPANHA OCIDENTAL;-30.388;-56.451;True;22552;11098;11454;20658;9972;10686;1894;1126;768
4315313;Quatro Irmãos;RS;43;Sul;NOROESTE RIO-GRANDENSE;ERECHIM;-27.821;-52.439;True;1735;850;841;847;388;415;888;462;426
4315321;Quevedos;RS;43;Sul;CENTRO OCIDENTAL RIO-GRANDENSE;SANTIAGO;-29.353;-54.072;True;2732;1433;1252;736;360;366;1996;1073;886
4315354;Quinze de Novembro;RS;43;Sul;NOROESTE RIO-GRANDENSE;CRUZ ALTA;-28.742;-53.095;True;3561;1776;1783;1866;914;952;1695;862;831
4315404;Redentora;RS;43;Sul;NOROESTE RIO-GRANDENSE;TRES PASSOS;-27.664;-53.638;True;9600;4806;4789;3011;1461;1550;6589;3345;3239
4315453;Relvado;RS;43;Sul;CENTRO ORIENTAL RIO-GRANDENSE;LAJEADO-ESTRELA;-29.111;-52.072;True;2196;1085;1093;708;329;368;1488;756;725
4315503;Restinga Seca;RS;43;Sul;CENTRO OCIDENTAL RIO-GRANDENSE;RESTINGA SECA;-29.813;-53.375;True;15595;7714;7879;8797;4252;4545;6798;3462;3334
4315552;Rio dos Índios;RS;43;Sul;NOROESTE RIO-GRANDENSE;FREDERICO WESTPHALEN;-27.3;-52.841;True;4202;2168;2011;691;337;348;3511;1831;1663
4315602;Rio Grande;RS;43;Sul;SUDESTE RIO-GRANDENSE;LITORAL LAGUNAR;-32.035;-52.099;True;194351;;;;;;;;
4315701;Rio Pardo;RS;43;Sul;CENTRO ORIENTAL RIO-GRANDENSE;CACHOEIRA DO SUL;-29.99;-52.378;True;37704;18303;19194;25934;12307;13555;11770;5996;5639
4315750;Riozinho;RS;43;Sul;METROPOLITANA DE PORTO ALEGRE;GRAMADO-CANELA;-29.641;-50.453;True;4406;2253;2151;2748;1350;1398;1658;903;753
4315800;Roca Sales;RS;43;Sul;CENTRO ORIENTAL RIO-GRANDENSE;LAJEADO-ESTRELA;-29.284;-51.868;True;9922;4965;4955;5995;2948;3045;3927;2017;1910
4315909;Rodeio Bonito;RS;43;Sul;NOROESTE RIO-GRANDENSE;FREDERICO WESTPHALEN;-27.471;-53.169;True;5698;2888;2810;2823;1372;1451;2875;1516;1359
4315958;Rolador;RS;43;Sul;NOROESTE RIO-GRANDENSE;SANTO ANGELO;-28.258;-54.817;True;2795;1462;1333;303;157;146;2492;1305;1187
4316006;Rolante;RS;43;Sul;METROPOLITANA DE PORTO ALEGRE;GRAMADO-CANELA;-29.651;-50.576;True;19213;9696;9487;14738;7333;7398;4475;2363;2089
4316105;Ronda Alta;RS;43;Sul;NOROESTE RIO-GRANDENSE;PASSO FUNDO;-27.767;-52.802;True;9654;4730;4924;5255;2501;2754;4399;2229;2170
4316204;Rondinha;RS;43;Sul;NOROESTE RIO-GRANDENSE;FREDERICO WESTPHALEN;-27.828;-52.91;True;5674;2796;2845;2227;1058;1169;3447;1738;1676
4316303;Roque Gonzales;RS;43;Sul;NOROESTE RIO-GRANDENSE;CERRO LARGO;-28.131;-55.026;True;7297;3674;3620;2732;1308;1424;4565;2366;2196
4316402;Rosário do Sul;RS;43;Sul;SUDOESTE RIO-GRANDENSE;CAMPANHA CENTRAL;-30.258;-54.914;True;40509;19822;20628;35787;17209;18537;4722;2613;2091
4316428;Sagrada Família;RS;43;Sul;NOROESTE RIO-GRANDENSE;CARAZINHO;-27.707;-53.136;True;2595;1330;1254;695;338;357;1900;992;897
4316436;Saldanha Marinho;RS;43;Sul;NOROESTE RIO-GRANDENSE;CRUZ ALTA;-28.393;-53.095;True;2982;1458;1524;1898;889;1009;1084;569;515
4316451;Salto do Jacuí;RS;43;Sul;NOROESTE RIO-GRANDENSE;CRUZ ALTA;-29.088;-53.213;True;12154;6024;6125;10230;4984;5241;1924;1040;884
4316477;Salvador das MissõEs;RS;43;Sul;NOROESTE RIO-GRANDENSE;CERRO LARGO;-28.126;-54.835;True;2601;1328;1255;1017;510;503;1584;818;752
4316501;Salvador do Sul;RS;43;Sul;METROPOLITANA DE PORTO ALEGRE;MONTENEGRO;-29.438;-51.511;True;6644;3395;3245;3697;1824;1871;2947;1571;1374
4316600;Sananduva;RS;43;Sul;NOROESTE RIO-GRANDENSE;SANANDUVA;-27.95;-51.807;True;14714;7265;7449;9722;4693;5029;4992;2572;2420
4316709;Santa Bárbara do Sul;RS;43;Sul;NOROESTE RIO-GRANDENSE;CRUZ ALTA;-28.358;-53.247;True;9122;4443;4654;7125;3421;3704;1997;1022;950
4316733;Santa Cecília do Sul;RS;43;Sul;NOROESTE RIO-GRANDENSE;PASSO FUNDO;-28.161;-51.925;True;1716;871;845;448;218;230;1268;653;615
4316758;Santa Clara do Sul;RS;43;Sul;CENTRO ORIENTAL RIO-GRANDENSE;LAJEADO-ESTRELA;-29.469;-52.088;True;5471;2766;2705;2509;1229;1280;2962;1537;1425
4316808;Santa Cruz do Sul;RS;43;Sul;CENTRO ORIENTAL RIO-GRANDENSE;SANTA CRUZ DO SUL;-29.718;-52.426;True;115857;55934;59911;101844;48637;53195;14013;7297;6716
4316907;Santa Maria;RS;43;Sul;CENTRO OCIDENTAL RIO-GRANDENSE;SANTA MARIA;-29.684;-53.807;True;263403;;;;;;;;
4316956;Santa Maria do Herval;RS;43;Sul;METROPOLITANA DE PORTO ALEGRE;GRAMADO-CANELA;-29.498;-50.993;True;6173;3086;2916;4420;2187;2083;1753;899;833
4316972;Santa Margarida do Sul;RS;43;Sul;SUDOESTE RIO-GRANDENSE;CAMPANHA CENTRAL;-30.339;-54.08;True;2163;1154;1001;556;279;277;1607;875;724
4317004;Santana da Boa Vista;RS;43;Sul;SUDESTE RIO-GRANDENSE;SERRAS DE SUDESTE;-30.872;-53.115;True;8599;4336;4137;3856;1856;2000;4743;2480;2137
4317103;Santana do Livramento;RS;43;Sul;SUDOESTE RIO-GRANDENSE;CAMPANHA CENTRAL;-30.891;-55.533;True;83479;39993;43408;75338;35545;39761;8141;4448;3647
4317202;Santa Rosa;RS;43;Sul;NOROESTE RIO-GRANDENSE;SANTA ROSA;-27.871;-54.481;True;64113;31208;32871;56156;27206;28928;7957;4002;3943
4317251;Santa Tereza;RS;43;Sul;NORDESTE RIO-GRANDENSE;CAXIAS DO SUL;-29.169;-51.735;True;1815;949;866;659;324;335;1156;625;531
4317301;Santa Vitória do Palmar;RS;43;Sul;SUDESTE RIO-GRANDENSE;LITORAL LAGUNAR;-33.519;-53.368;True;31183;15717;15439;27165;13361;13788;4018;2356;1651
4317400;Santiago;RS;43;Sul;CENTRO OCIDENTAL RIO-GRANDENSE;SANTIAGO;-29.192;-54.867;True;49558;23920;25638;44993;21483;23510;4565;2437;2128
4317509;Santo Ângelo;RS;43;Sul;NOROESTE RIO-GRANDENSE;SANTO ANGELO;-28.299;-54.263;True;73800;35313;38323;62893;29822;32953;10907;5491;5370
4317558;Santo Antônio do Palma;RS;43;Sul;NOROESTE RIO-GRANDENSE;PASSO FUNDO;-28.497;-52.025;True;2216;1105;1047;629;303;311;1587;802;736
4317608;Santo Antônio da Patrulha;RS;43;Sul;METROPOLITANA DE PORTO ALEGRE;OSORIO;-29.818;-50.52;True;37910;18877;18903;26510;12870;13542;11400;6007;5361
4317707;Santo Antônio das MissõEs;RS;43;Sul;NOROESTE RIO-GRANDENSE;SANTO ANGELO;-28.511;-55.228;True;11863;5921;5942;6875;3292;3583;4988;2629;2359
4317756;Santo Antônio do Planalto;RS;43;Sul;NOROESTE RIO-GRANDENSE;CARAZINHO;-28.396;-52.691;True;2029;1014;1015;1155;538;617;874;476;398
4317806;Santo Augusto;RS;43;Sul;NOROESTE RIO-GRANDENSE;IJUI;-27.851;-53.777;True;13622;6618;7001;10709;5097;5612;2913;1521;1389
4317905;Santo Cristo;RS;43;Sul;NOROESTE RIO-GRANDENSE;SANTA ROSA;-27.824;-54.663;True;14280;7107;7143;7100;3455;3642;7180;3652;3501
4317954;Santo Expedito do Sul;RS;43;Sul;NOROESTE RIO-GRANDENSE;SANANDUVA;-27.908;-51.645;True;2614;1315;1299;807;384;423;1807;931;876
4318002;São Borja;RS;43;Sul;SUDOESTE RIO-GRANDENSE;CAMPANHA OCIDENTAL;-28.661;-56.004;True;61834;30408;31414;54738;26647;28088;7096;3761;3326
4318051;São Domingos do Sul;RS;43;Sul;NOROESTE RIO-GRANDENSE;PASSO FUNDO;-28.531;-51.888;True;2854;1423;1431;1608;765;843;1246;658;588
4318101;São Francisco de Assis;RS;43;Sul;SUDOESTE RIO-GRANDENSE;CAMPANHA OCIDENTAL;-29.55;-55.131;True;19523;9663;9815;13453;6419;7023;6070;3244;2792
4318200;São Francisco de Paula;RS;43;Sul;NORDESTE RIO-GRANDENSE;VACARIA;-29.448;-50.584;True;21278;10478;10392;13221;6258;6760;8057;4220;3632
4318309;São Gabriel;RS;43;Sul;SUDOESTE RIO-GRANDENSE;CAMPANHA CENTRAL;-30.336;-54.32;True;57978;28263;29691;51297;24556;26738;6681;3707;2953
4318408;São Jerônimo;RS;43;Sul;METROPOLITANA DE PORTO ALEGRE;SAO JERONIMO;-29.959;-51.722;True;20506;10293;10140;15705;7745;7950;4801;2548;2190
4318424;São João da Urtiga;RS;43;Sul;NOROESTE RIO-GRANDENSE;SANANDUVA;-27.82;-51.828;True;4946;2503;2430;2133;1031;1102;2813;1472;1328
4318432;São João do Polêsine;RS;43;Sul;CENTRO OCIDENTAL RIO-GRANDENSE;RESTINGA SECA;-29.614;-53.446;True;2702;1317;1383;1132;519;611;1570;798;772
4318440;São Jorge;RS;43;Sul;NORDESTE RIO-GRANDENSE;GUAPORE;-28.499;-51.703;True;2764;1368;1396;1350;616;734;1414;752;662
4318457;São José das MissõEs;RS;43;Sul;NOROESTE RIO-GRANDENSE;CARAZINHO;-27.78;-53.122;True;2952;1478;1415;801;403;388;2151;1075;1027
4318465;São José do Herval;RS;43;Sul;NOROESTE RIO-GRANDENSE;SOLEDADE;-29.044;-52.296;True;2479;1269;1210;814;415;399;1665;854;811
4318481;São José do Hortêncio;RS;43;Sul;METROPOLITANA DE PORTO ALEGRE;MONTENEGRO;-29.528;-51.251;True;3883;1977;1906;2395;1209;1186;1488;768;720
4318499;São José do Inhacorá;RS;43;Sul;NOROESTE RIO-GRANDENSE;SANTA ROSA;-27.725;-54.129;True;2132;1093;1039;705;342;363;1427;751;676
4318507;São José do Norte;RS;43;Sul;SUDESTE RIO-GRANDENSE;LITORAL LAGUNAR;-32.015;-52.042;True;24905;12737;12168;18696;9333;9363;6209;3404;2805
4318606;São José do Ouro;RS;43;Sul;NOROESTE RIO-GRANDENSE;SANANDUVA;-27.769;-51.594;True;6973;3404;3536;4377;2105;2272;2596;1299;1264
4318614;São José do Sul;RS;43;Sul;METROPOLITANA DE PORTO ALEGRE;MONTENEGRO;-29.531;-51.482;True;1899;951;919;538;267;271;1361;684;648
4318622;São José dos Ausentes;RS;43;Sul;NORDESTE RIO-GRANDENSE;VACARIA;-28.748;-50.066;True;3180;1623;1529;1749;857;885;1431;766;644
4318705;São Leopoldo;RS;43;Sul;METROPOLITANA DE PORTO ALEGRE;PORTO ALEGRE;-29.76;-51.147;True;207721;;;;;;;;
4318804;São Lourenço do Sul;RS;43;Sul;SUDESTE RIO-GRANDENSE;PELOTAS;-31.365;-51.978;True;42339;21255;21065;23165;11131;12022;19174;10124;9043
4318903;São Luiz Gonzaga;RS;43;Sul;NOROESTE RIO-GRANDENSE;SANTO ANGELO;-28.408;-54.961;True;34487;16914;17569;30295;14557;15738;4192;2357;1831
4319000;São Marcos;RS;43;Sul;NORDESTE RIO-GRANDENSE;CAXIAS DO SUL;-28.971;-51.068;True;19641;9662;9948;16741;8199;8530;2900;1463;1418
4319109;São Martinho;RS;43;Sul;NOROESTE RIO-GRANDENSE;TRES PASSOS;-27.707;-53.969;True;5853;2882;2971;3056;1443;1613;2797;1439;1358
4319125;São Martinho da Serra;RS;43;Sul;CENTRO OCIDENTAL RIO-GRANDENSE;SANTA MARIA;-29.538;-53.855;True;3409;1731;1610;900;441;456;2509;1290;1154
4319158;São Miguel das MissõEs;RS;43;Sul;NOROESTE RIO-GRANDENSE;SANTO ANGELO;-28.563;-54.554;True;7382;3839;3528;3537;1764;1762;3845;2075;1766
4319208;São Nicolau;RS;43;Sul;NOROESTE RIO-GRANDENSE;SANTO ANGELO;-28.183;-55.267;True;5909;3006;2903;3808;1871;1937;2101;1135;966
4319307;São Paulo das MissõEs;RS;43;Sul;NOROESTE RIO-GRANDENSE;CERRO LARGO;-28.021;-54.936;True;6690;3392;3298;2114;1024;1090;4576;2368;2208
4319356;São Pedro da Serra;RS;43;Sul;METROPOLITANA DE PORTO ALEGRE;MONTENEGRO;-29.421;-51.513;True;3117;1599;1518;1437;729;708;1680;870;810
4319364;São Pedro das MissõEs;RS;43;Sul;NOROESTE RIO-GRANDENSE;CARAZINHO;-27.077;-53.246;True;1939;966;964;426;201;219;1513;765;745
4319372;São Pedro do Butiá;RS;43;Sul;NOROESTE RIO-GRANDENSE;CERRO LARGO;-28.124;-54.887;True;2744;1397;1338;1040;507;533;1704;890;805
4319406;São Pedro do Sul;RS;43;Sul;CENTRO OCIDENTAL RIO-GRANDENSE;SANTA MARIA;-29.621;-54.179;True;16613;8194;8419;11865;5698;6167;4748;2496;2252
4319505;São Sebastião do Caí;RS;43;Sul;METROPOLITANA DE PORTO ALEGRE;MONTENEGRO;-29.587;-51.376;True;20359;9987;10362;16295;7880;8413;4064;2107;1949
4319604;São Sepé;RS;43;Sul;CENTRO OCIDENTAL RIO-GRANDENSE;SANTA MARIA;-30.161;-53.565;True;23787;11696;12091;18544;8809;9735;5243;2887;2356
4319703;São Valentim;RS;43;Sul;NOROESTE RIO-GRANDENSE;ERECHIM;-27.558;-52.524;True;3919;1965;1954;1677;815;862;2242;1150;1092
4319711;São Valentim do Sul;RS;43;Sul;NORDESTE RIO-GRANDENSE;GUAPORE;-29.047;-51.765;True;2230;1175;1055;644;329;315;1586;846;740
4319737;São Valério do Sul;RS;43;Sul;NOROESTE RIO-GRANDENSE;IJUI;-27.787;-53.937;True;2635;1373;1262;516;252;264;2119;1121;998
4319752;São Vendelino;RS;43;Sul;METROPOLITANA DE PORTO ALEGRE;MONTENEGRO;-29.369;-51.377;True;1794;933;859;1164;590;572;630;343;287
4319802;São Vicente do Sul;RS;43;Sul;CENTRO OCIDENTAL RIO-GRANDENSE;SANTA MARIA;-29.692;-54.679;True;8361;4195;4166;5545;2708;2837;2816;1487;1329
4319901;Sapiranga;RS;43;Sul;METROPOLITANA DE PORTO ALEGRE;PORTO ALEGRE;-29.638;-51.007;True;73979;36466;37061;68962;33851;34659;5017;2615;2402
4320008;Sapucaia do Sul;RS;43;Sul;METROPOLITANA DE PORTO ALEGRE;PORTO ALEGRE;-29.839;-51.144;True;122231;59411;62311;121799;59200;62095;432;211;216
4320107;Sarandi;RS;43;Sul;NOROESTE RIO-GRANDENSE;CARAZINHO;-27.944;-52.923;True;20415;9863;10527;16848;8052;8778;3567;1811;1749
4320206;Seberi;RS;43;Sul;NOROESTE RIO-GRANDENSE;FREDERICO WESTPHALEN;-27.478;-53.403;True;10870;5342;5528;5657;2635;3022;5213;2707;2506
4320230;Sede Nova;RS;43;Sul;NOROESTE RIO-GRANDENSE;TRES PASSOS;-27.635;-53.946;True;2968;1501;1467;1469;718;751;1499;783;716
4320263;Segredo;RS;43;Sul;CENTRO ORIENTAL RIO-GRANDENSE;SANTA CRUZ DO SUL;-29.269;-53.012;True;7022;3587;3435;1842;873;969;5180;2714;2466
4320305;Selbach;RS;43;Sul;NOROESTE RIO-GRANDENSE;NAO-ME-TOQUE;-28.629;-52.953;True;4773;2294;2448;3005;1420;1585;1768;874;863
4320321;Senador Salgado Filho;RS;43;Sul;NOROESTE RIO-GRANDENSE;SANTO ANGELO;-28.031;-54.543;True;2861;1422;1438;801;384;416;2060;1038;1022
4320354;Sentinela do Sul;RS;43;Sul;METROPOLITANA DE PORTO ALEGRE;CAMAQUA;-30.611;-51.579;True;5290;2733;2557;1290;637;653;4000;2096;1904
4320404;Serafina Corrêa;RS;43;Sul;NORDESTE RIO-GRANDENSE;GUAPORE;-28.712;-51.935;True;13463;6730;6718;11139;5491;5637;2324;1239;1081
4320453;Sério;RS;43;Sul;CENTRO ORIENTAL RIO-GRANDENSE;LAJEADO-ESTRELA;-29.383;-52.269;True;2399;1266;1133;525;264;261;1874;1002;872
4320503;Sertão;RS;43;Sul;NOROESTE RIO-GRANDENSE;PASSO FUNDO;-27.98;-52.26;True;6663;3248;3405;3453;1632;1818;3210;1616;1587
4320552;Sertão Santana;RS;43;Sul;METROPOLITANA DE PORTO ALEGRE;PORTO ALEGRE;-30.46;-51.603;True;5791;2970;2821;1179;578;601;4612;2392;2220
4320578;Sete de Setembro;RS;43;Sul;NOROESTE RIO-GRANDENSE;CERRO LARGO;-28.131;-54.463;True;2131;1079;1052;493;227;266;1638;852;786
4320602;Severiano de Almeida;RS;43;Sul;NOROESTE RIO-GRANDENSE;ERECHIM;-27.433;-52.116;True;3907;1937;1931;1251;605;642;2656;1332;1289
4320651;Silveira Martins;RS;43;Sul;CENTRO OCIDENTAL RIO-GRANDENSE;RESTINGA SECA;-29.642;-53.586;True;2479;1227;1209;1089;522;553;1390;705;656
4320677;Sinimbu;RS;43;Sul;CENTRO ORIENTAL RIO-GRANDENSE;SANTA CRUZ DO SUL;-29.539;-52.522;True;10315;5350;4962;1449;699;750;8866;4651;4212
4320701;Sobradinho;RS;43;Sul;CENTRO ORIENTAL RIO-GRANDENSE;SANTA CRUZ DO SUL;-29.421;-53.029;True;14162;6993;7161;11272;5477;5787;2890;1516;1374
4320800;Soledade;RS;43;Sul;NOROESTE RIO-GRANDENSE;SOLEDADE;-28.818;-52.51;True;29926;14683;15243;23663;11391;12272;6263;3292;2971
4320859;Tabaí;RS;43;Sul;CENTRO ORIENTAL RIO-GRANDENSE;LAJEADO-ESTRELA;-29.643;-51.682;True;4046;2013;1915;1198;561;590;2848;1452;1325
4320909;Tapejara;RS;43;Sul;NOROESTE RIO-GRANDENSE;PASSO FUNDO;-28.068;-52.014;True;17500;8476;9024;15162;7289;7873;2338;1187;1151
4321006;Tapera;RS;43;Sul;NOROESTE RIO-GRANDENSE;NAO-ME-TOQUE;-28.626;-52.87;True;10457;5104;5330;8645;4203;4427;1812;901;903
4321105;Tapes;RS;43;Sul;METROPOLITANA DE PORTO ALEGRE;CAMAQUA;-30.673;-51.396;True;16557;8202;8355;14731;7206;7525;1826;996;830
4321204;Taquara;RS;43;Sul;METROPOLITANA DE PORTO ALEGRE;GRAMADO-CANELA;-29.651;-50.781;True;53428;26254;26965;44394;21502;22712;9034;4752;4253
4321303;Taquari;RS;43;Sul;CENTRO ORIENTAL RIO-GRANDENSE;LAJEADO-ESTRELA;-29.8;-51.864;True;25768;12537;13040;21393;10303;10990;4375;2234;2050
4321329;Taquaruçu do Sul;RS;43;Sul;NOROESTE RIO-GRANDENSE;FREDERICO WESTPHALEN;-27.4;-53.467;True;2849;1474;1375;1025;503;522;1824;971;853
4321352;Tavares;RS;43;Sul;METROPOLITANA DE PORTO ALEGRE;OSORIO;-31.287;-51.094;True;5160;2666;2488;2890;1443;1441;2270;1223;1047
4321402;Tenente Portela;RS;43;Sul;NOROESTE RIO-GRANDENSE;TRES PASSOS;-27.371;-53.758;True;13906;6817;7081;8563;4131;4429;5343;2686;2652
4321436;Terra de Areia;RS;43;Sul;METROPOLITANA DE PORTO ALEGRE;OSORIO;-29.585;-50.071;True;9709;4717;4625;5288;2542;2629;4421;2175;1996
4321451;Teutônia;RS;43;Sul;CENTRO ORIENTAL RIO-GRANDENSE;LAJEADO-ESTRELA;-29.448;-51.806;True;25105;12523;12538;21292;10599;10660;3813;1924;1878
4321469;Tio Hugo;RS;43;Sul;NOROESTE RIO-GRANDENSE;NAO-ME-TOQUE;-28.579;-52.599;True;2593;1328;1265;1008;494;514;1585;834;751
4321477;Tiradentes do Sul;RS;43;Sul;NOROESTE RIO-GRANDENSE;TRES PASSOS;-27.398;-54.084;True;6928;3490;3399;1973;969;995;4955;2521;2404
4321493;Toropi;RS;43;Sul;CENTRO OCIDENTAL RIO-GRANDENSE;SANTA MARIA;-29.478;-54.228;True;3070;1608;1462;568;278;290;2502;1330;1172
4321501;Torres;RS;43;Sul;METROPOLITANA DE PORTO ALEGRE;OSORIO;-29.335;-49.727;True;32358;15405;16187;29042;13905;14708;3316;1500;1479
4321600;Tramandaí;RS;43;Sul;METROPOLITANA DE PORTO ALEGRE;OSORIO;-29.985;-50.134;True;39891;16522;17575;38872;16103;17191;1019;419;384
4321626;Travesseiro;RS;43;Sul;CENTRO ORIENTAL RIO-GRANDENSE;LAJEADO-ESTRELA;-29.294;-52.055;True;2379;1220;1159;896;448;448;1483;772;711
4321634;Três Arroios;RS;43;Sul;NOROESTE RIO-GRANDENSE;ERECHIM;-27.499;-52.147;True;3015;1507;1507;948;445;503;2067;1062;1004
4321667;Três Cachoeiras;RS;43;Sul;METROPOLITANA DE PORTO ALEGRE;OSORIO;-29.456;-49.924;True;10390;5244;5043;7003;3545;3428;3387;1699;1615
4321709;Três Coroas;RS;43;Sul;METROPOLITANA DE PORTO ALEGRE;GRAMADO-CANELA;-29.517;-50.778;True;22905;11354;11400;20338;10016;10174;2567;1338;1226
4321808;Três de Maio;RS;43;Sul;NOROESTE RIO-GRANDENSE;SANTA ROSA;-27.773;-54.24;True;23333;11325;11999;18137;8684;9453;5196;2641;2546
4321832;Três Forquilhas;RS;43;Sul;METROPOLITANA DE PORTO ALEGRE;OSORIO;-29.537;-50.064;True;3073;1574;1473;269;132;132;2804;1442;1341
4321857;Três Palmeiras;RS;43;Sul;NOROESTE RIO-GRANDENSE;FREDERICO WESTPHALEN;-27.615;-52.841;True;4388;2228;2160;1875;899;976;2513;1329;1184
4321907;Três Passos;RS;43;Sul;NOROESTE RIO-GRANDENSE;TRES PASSOS;-27.456;-53.932;True;23467;11493;11930;18088;8705;9374;5379;2788;2556
4321956;Trindade do Sul;RS;43;Sul;NOROESTE RIO-GRANDENSE;FREDERICO WESTPHALEN;-27.522;-52.894;True;5905;2903;2907;2573;1240;1330;3332;1663;1577
4322004;Triunfo;RS;43;Sul;METROPOLITANA DE PORTO ALEGRE;SAO JERONIMO;-29.943;-51.718;True;23976;12009;11832;14644;7203;7377;9332;4806;4455
4322103;Tucunduva;RS;43;Sul;NOROESTE RIO-GRANDENSE;SANTA ROSA;-27.657;-54.44;True;5907;2819;3073;3818;1808;2010;2089;1011;1063
4322152;Tunas;RS;43;Sul;NOROESTE RIO-GRANDENSE;SOLEDADE;-29.103;-52.956;True;4378;2291;2087;1319;649;670;3059;1642;1417
4322186;Tupanci do Sul;RS;43;Sul;NOROESTE RIO-GRANDENSE;SANANDUVA;-27.925;-51.536;True;1723;896;827;495;241;254;1228;655;573
4322202;Tupanciretã;RS;43;Sul;CENTRO OCIDENTAL RIO-GRANDENSE;SANTIAGO;-29.081;-53.836;True;22556;11088;11468;17787;8538;9249;4769;2550;2219
4322251;Tupandi;RS;43;Sul;METROPOLITANA DE PORTO ALEGRE;MONTENEGRO;-29.476;-51.421;True;3604;1909;1695;2452;1268;1184;1152;641;511
4322301;Tuparendi;RS;43;Sul;NOROESTE RIO-GRANDENSE;SANTA ROSA;-27.756;-54.482;True;8793;4308;4485;5136;2415;2721;3657;1893;1764
4322327;Turuçu;RS;43;Sul;SUDESTE RIO-GRANDENSE;PELOTAS;-31.422;-52.178;True;3829;1942;1884;1735;868;867;2094;1074;1017
4322343;Ubiretama;RS;43;Sul;NOROESTE RIO-GRANDENSE;SANTO ANGELO;-28.046;-54.681;True;2440;1246;1194;477;235;242;1963;1011;952
4322350;União da Serra;RS;43;Sul;NORDESTE RIO-GRANDENSE;GUAPORE;-28.795;-52.037;True;1666;869;776;283;137;138;1383;732;638
4322376;Unistalda;RS;43;Sul;CENTRO OCIDENTAL RIO-GRANDENSE;SANTIAGO;-29.047;-55.15;True;2392;1221;1171;829;419;410;1563;802;761
4322400;Uruguaiana;RS;43;Sul;SUDOESTE RIO-GRANDENSE;CAMPANHA OCIDENTAL;-29.755;-57.088;True;123743;60506;62754;116261;56140;59647;7482;4366;3107
4322509;Vacaria;RS;43;Sul;NORDESTE RIO-GRANDENSE;VACARIA;-28.512;-50.934;True;59938;29299;30630;55851;27033;28809;4087;2266;1821
4322525;Vale Verde;RS;43;Sul;METROPOLITANA DE PORTO ALEGRE;SAO JERONIMO;-29.787;-52.184;True;3227;1559;1531;845;397;418;2382;1162;1113
4322533;Vale do Sol;RS;43;Sul;CENTRO ORIENTAL RIO-GRANDENSE;SANTA CRUZ DO SUL;-29.604;-52.683;True;10817;5473;5330;1140;553;585;9677;4920;4745
4322541;Vale Real;RS;43;Sul;METROPOLITANA DE PORTO ALEGRE;MONTENEGRO;-29.398;-51.254;True;4741;2409;2319;4130;2094;2026;611;315;293
4322558;Vanini;RS;43;Sul;NOROESTE RIO-GRANDENSE;PASSO FUNDO;-28.478;-51.845;True;1956;992;964;904;435;469;1052;557;495
4322608;Venâncio Aires;RS;43;Sul;CENTRO ORIENTAL RIO-GRANDENSE;SANTA CRUZ DO SUL;-29.606;-52.192;True;64442;32020;32352;40441;19566;20814;24001;12454;11538
4322707;Vera Cruz;RS;43;Sul;CENTRO ORIENTAL RIO-GRANDENSE;SANTA CRUZ DO SUL;-29.715;-52.506;True;22702;11126;11543;12167;5820;6347;10535;5306;5196
4322806;Veranópolis;RS;43;Sul;NORDESTE RIO-GRANDENSE;CAXIAS DO SUL;-28.936;-51.549;True;23904;12091;11806;20712;10416;10289;3192;1675;1517
4322855;Vespasiano Correa;RS;43;Sul;CENTRO ORIENTAL RIO-GRANDENSE;LAJEADO-ESTRELA;-29.068;-51.859;True;1973;1015;958;369;167;202;1604;848;756
4322905;Viadutos;RS;43;Sul;NOROESTE RIO-GRANDENSE;ERECHIM;-27.569;-52.02;True;5663;2814;2849;2570;1215;1355;3093;1599;1494
4323002;Viamão;RS;43;Sul;METROPOLITANA DE PORTO ALEGRE;PORTO ALEGRE;-30.081;-51.023;True;253264;;;;;;;;
4323101;Vicente Dutra;RS;43;Sul;NOROESTE RIO-GRANDENSE;FREDERICO WESTPHALEN;-27.162;-53.405;True;5569;2856;2713;2257;1097;1160;3312;1759;1553
4323200;Victor Graeff;RS;43;Sul;NOROESTE RIO-GRANDENSE;NAO-ME-TOQUE;-28.56;-52.748;True;3080;1503;1537;1257;594;663;1823;909;874
4323309;Vila Flores;RS;43;Sul;NORDESTE RIO-GRANDENSE;CAXIAS DO SUL;-28.863;-51.533;True;3169;1588;1581;1280;632;648;1889;956;933
4323358;Vila Lângaro;RS;43;Sul;NOROESTE RIO-GRANDENSE;PASSO FUNDO;-28.107;-52.144;True;2230;1129;1070;296;144;150;1934;985;920
4323408;Vila Maria;RS;43;Sul;NOROESTE RIO-GRANDENSE;PASSO FUNDO;-28.535;-52.154;True;4159;2111;2046;1989;996;993;2170;1115;1053
4323457;Vila Nova do Sul;RS;43;Sul;CENTRO OCIDENTAL RIO-GRANDENSE;SANTA MARIA;-30.344;-53.883;True;4255;2128;2127;2079;1001;1078;2176;1127;1049
4323507;Vista Alegre;RS;43;Sul;NOROESTE RIO-GRANDENSE;FREDERICO WESTPHALEN;-27.367;-53.49;True;2871;1444;1427;1082;520;562;1789;924;865
4323606;Vista Alegre do Prata;RS;43;Sul;NORDESTE RIO-GRANDENSE;GUAPORE;-28.809;-51.79;True;1492;782;710;393;200;193;1099;582;517
4323705;Vista Gaúcha;RS;43;Sul;NOROESTE RIO-GRANDENSE;TRES PASSOS;-27.291;-53.702;True;2713;1388;1325;772;366;406;1941;1022;919
4323754;Vitória das MissõEs;RS;43;Sul;NOROESTE RIO-GRANDENSE;SANTO ANGELO;-28.351;-54.496;True;3652;1907;1745;613;314;299;3039;1593;1446
4323770;Westfalia;RS;43;Sul;CENTRO ORIENTAL RIO-GRANDENSE;LAJEADO-ESTRELA;-29.417;-51.765;True;2716;1367;1349;972;482;490;1744;885;859
4323804;Xangri-Lá;RS;43;Sul;METROPOLITANA DE PORTO ALEGRE;OSORIO;-29.801;-50.044;True;10602;5300;5252;10535;5262;5223;67;38;29
5000203;Água Clara;MS;50;Centro-Oeste;LESTE DE MATO GROSSO DO SUL;TRES LAGOAS;-20.448;-52.878;True;13183;6717;6145;8986;4573;4364;4197;2144;1781
5000252;Alcinópolis;MS;50;Centro-Oeste;CENTRO NORTE DE MATO GROSSO DO SUL;ALTO TAQUARI;-18.324;-53.706;True;4299;2258;2041;2724;1380;1344;1575;878;697
5000609;Amambaí;MS;50;Centro-Oeste;SUDOESTE DE MATO GROSSO DO SUL;DOURADOS;-23.104;-55.226;True;33426;16727;16596;19883;9792;10059;13543;6935;6537
5000708;Anastácio;MS;50;Centro-Oeste;PANTANAL SUL MATO-GROSSENSE;AQUIDAUANA;-20.484;-55.807;True;22364;11251;11007;18119;8946;9070;4245;2305;1937
5000807;Anaurilândia;MS;50;Centro-Oeste;LESTE DE MATO GROSSO DO SUL;NOVA ANDRADINA;-22.188;-52.718;True;8380;4302;4059;4577;2255;2322;3803;2047;1737
5000856;Angélica;MS;50;Centro-Oeste;SUDOESTE DE MATO GROSSO DO SUL;IGUATEMI;-22.153;-53.771;True;7253;3688;3542;5743;2885;2858;1510;803;684
5000906;Antônio João;MS;50;Centro-Oeste;SUDOESTE DE MATO GROSSO DO SUL;DOURADOS;-22.191;-55.948;True;8350;4095;4080;7135;3500;3574;1215;595;506
5001003;Aparecida do Taboado;MS;50;Centro-Oeste;LESTE DE MATO GROSSO DO SUL;PARANAIBA;-20.087;-51.094;True;19819;9888;9919;17480;8619;8855;2339;1269;1064
5001102;Aquidauana;MS;50;Centro-Oeste;PANTANAL SUL MATO-GROSSENSE;AQUIDAUANA;-20.471;-55.787;True;44920;22297;22404;35379;17244;18025;9541;5053;4379
5001243;Aral Moreira;MS;50;Centro-Oeste;SUDOESTE DE MATO GROSSO DO SUL;DOURADOS;-22.934;-55.635;True;9236;4730;4482;3028;1478;1544;6208;3252;2938
5001508;Bandeirantes;MS;50;Centro-Oeste;CENTRO NORTE DE MATO GROSSO DO SUL;CAMPO GRANDE;-19.918;-54.364;True;5888;3060;2802;4207;2126;2081;1681;934;721
5001904;Bataguassu;MS;50;Centro-Oeste;LESTE DE MATO GROSSO DO SUL;NOVA ANDRADINA;-21.714;-52.422;True;18687;9537;9127;13925;7052;6857;4762;2485;2270
5002001;Batayporã;MS;50;Centro-Oeste;LESTE DE MATO GROSSO DO SUL;NOVA ANDRADINA;-22.295;-53.271;True;10564;5329;5204;7509;3720;3786;3055;1609;1418
5002100;Bela Vista;MS;50;Centro-Oeste;SUDOESTE DE MATO GROSSO DO SUL;BODOQUENA;-22.109;-56.521;True;22868;11597;11079;18121;9049;8967;4747;2548;2112
5002159;Bodoquena;MS;50;Centro-Oeste;SUDOESTE DE MATO GROSSO DO SUL;BODOQUENA;-20.539;-56.715;True;8168;4228;3890;5350;2676;2651;2818;1552;1239
5002209;Bonito;MS;50;Centro-Oeste;SUDOESTE DE MATO GROSSO DO SUL;BODOQUENA;-21.121;-56.482;True;17275;8639;8251;13635;6719;6679;3640;1920;1572
5002308;Brasilândia;MS;50;Centro-Oeste;LESTE DE MATO GROSSO DO SUL;TRES LAGOAS;-21.256;-52.037;True;12136;6001;5639;7793;3799;3799;4343;2202;1840
5002407;Caarapó;MS;50;Centro-Oeste;SUDOESTE DE MATO GROSSO DO SUL;DOURADOS;-22.634;-54.822;True;22723;11292;11426;15989;7887;8098;6734;3405;3328
5002605;Camapuã;MS;50;Centro-Oeste;CENTRO NORTE DE MATO GROSSO DO SUL;ALTO TAQUARI;-19.531;-54.044;True;13192;6808;6368;9627;4860;4767;3565;1948;1601
5002704;Campo Grande;MS;50;Centro-Oeste;CENTRO NORTE DE MATO GROSSO DO SUL;CAMPO GRANDE;-20.443;-54.646;True;724524;348613;371668;714790;343331;367227;9734;5282;4441
5002803;Caracol;MS;50;Centro-Oeste;SUDOESTE DE MATO GROSSO DO SUL;BODOQUENA;-22.014;-57.024;True;5095;2639;2436;3217;1623;1591;1878;1016;845
5002902;Cassilândia;MS;50;Centro-Oeste;LESTE DE MATO GROSSO DO SUL;CASSILANDIA;-19.113;-51.734;True;20916;10410;10468;18858;9310;9548;2058;1100;920
5002951;Chapadão do Sul;MS;50;Centro-Oeste;LESTE DE MATO GROSSO DO SUL;CASSILANDIA;-18.794;-52.623;True;16193;8443;7730;13173;6791;6366;3020;1652;1364
5003108;Corguinho;MS;50;Centro-Oeste;CENTRO NORTE DE MATO GROSSO DO SUL;CAMPO GRANDE;-19.832;-54.829;True;4165;2142;1860;1773;907;853;2392;1235;1007
5003157;Coronel Sapucaia;MS;50;Centro-Oeste;SUDOESTE DE MATO GROSSO DO SUL;IGUATEMI;-23.272;-55.529;True;13979;7000;6905;10291;5123;5116;3688;1877;1789
5003207;Corumbá;MS;50;Centro-Oeste;PANTANAL SUL MATO-GROSSENSE;BAIXO PANTANAL;-19.009;-57.653;True;96373;48197;47505;86656;42545;43511;9717;5652;3994
5003256;Costa Rica;MS;50;Centro-Oeste;LESTE DE MATO GROSSO DO SUL;CASSILANDIA;-18.544;-53.129;True;18277;9634;8606;14708;7562;7143;3569;2072;1463
5003306;Coxim;MS;50;Centro-Oeste;CENTRO NORTE DE MATO GROSSO DO SUL;ALTO TAQUARI;-18.507;-54.76;True;31816;16145;15540;28507;14340;14080;3309;1805;1460
5003454;Deodápolis;MS;50;Centro-Oeste;SUDOESTE DE MATO GROSSO DO SUL;IGUATEMI;-22.276;-54.165;True;11261;5673;5580;9042;4545;4494;2219;1128;1086
5003488;Dois Irmãos do Buriti;MS;50;Centro-Oeste;PANTANAL SUL MATO-GROSSENSE;AQUIDAUANA;-20.68;-55.296;True;9350;4841;4483;4137;2077;2054;5213;2764;2429
5003504;Douradina;MS;50;Centro-Oeste;SUDOESTE DE MATO GROSSO DO SUL;DOURADOS;-22.04;-54.613;True;4900;2457;2440;2996;1483;1510;1904;974;930
5003702;Dourados;MS;50;Centro-Oeste;SUDOESTE DE MATO GROSSO DO SUL;DOURADOS;-22.221;-54.806;True;181869;89274;92129;165886;81062;84386;15983;8212;7743
5003751;Eldorado;MS;50;Centro-Oeste;SUDOESTE DE MATO GROSSO DO SUL;IGUATEMI;-23.787;-54.284;True;11934;5988;5894;8867;4394;4436;3067;1594;1458
5003801;Fátima do Sul;MS;50;Centro-Oeste;SUDOESTE DE MATO GROSSO DO SUL;DOURADOS;-22.374;-54.514;True;18789;9155;9532;16502;7990;8429;2287;1165;1103
5003900;Figueirão;MS;50;Centro-Oeste;CENTRO NORTE DE MATO GROSSO DO SUL;ALTO TAQUARI;-18.686;-53.631;True;3280;1739;1416;1408;717;691;1872;1022;725
5004007;Glória de Dourados;MS;50;Centro-Oeste;SUDOESTE DE MATO GROSSO DO SUL;IGUATEMI;-22.418;-54.233;True;9644;4746;4843;7398;3562;3784;2246;1184;1059
5004106;Guia Lopes da Laguna;MS;50;Centro-Oeste;SUDOESTE DE MATO GROSSO DO SUL;BODOQUENA;-21.458;-56.114;True;10208;5120;5042;8423;4134;4261;1785;986;781
5004304;Iguatemi;MS;50;Centro-Oeste;SUDOESTE DE MATO GROSSO DO SUL;IGUATEMI;-23.68;-54.561;True;14632;7330;7302;10306;5020;5286;4326;2310;2016
5004403;Inocência;MS;50;Centro-Oeste;LESTE DE MATO GROSSO DO SUL;PARANAIBA;-19.726;-51.93;True;7342;3799;3511;4498;2252;2230;2844;1547;1281
5004502;Itaporã;MS;50;Centro-Oeste;SUDOESTE DE MATO GROSSO DO SUL;DOURADOS;-22.079;-54.789;True;18605;9398;9164;12285;6148;6137;6320;3250;3027
5004601;Itaquiraí;MS;50;Centro-Oeste;SUDOESTE DE MATO GROSSO DO SUL;IGUATEMI;-23.474;-54.185;True;16924;8796;8014;7136;3552;3566;9788;5244;4448
5004700;Ivinhema;MS;50;Centro-Oeste;SUDOESTE DE MATO GROSSO DO SUL;IGUATEMI;-22.305;-53.815;True;20567;10353;10170;15514;7679;7799;5053;2674;2371
5004809;Japorã;MS;50;Centro-Oeste;SUDOESTE DE MATO GROSSO DO SUL;IGUATEMI;-23.891;-54.404;True;7362;3761;3588;1417;689;718;5945;3072;2870
5004908;Jaraguari;MS;50;Centro-Oeste;CENTRO NORTE DE MATO GROSSO DO SUL;CAMPO GRANDE;-20.142;-54.399;True;5577;3000;2570;1663;825;838;3914;2175;1732
5005004;Jardim;MS;50;Centro-Oeste;SUDOESTE DE MATO GROSSO DO SUL;BODOQUENA;-21.48;-56.138;True;23341;11470;11562;21464;10441;10767;1877;1029;795
5005103;Jateí;MS;50;Centro-Oeste;SUDOESTE DE MATO GROSSO DO SUL;IGUATEMI;-22.482;-54.303;True;3808;1973;1806;1631;819;788;2177;1154;1018
5005152;Juti;MS;50;Centro-Oeste;SUDOESTE DE MATO GROSSO DO SUL;DOURADOS;-22.861;-54.603;True;5353;2689;2652;3245;1603;1634;2108;1086;1018
5005202;Ladário;MS;50;Centro-Oeste;PANTANAL SUL MATO-GROSSENSE;BAIXO PANTANAL;-19.005;-57.602;True;17906;8986;8842;16813;8358;8380;1093;628;462
5005251;Laguna Carapã;MS;50;Centro-Oeste;SUDOESTE DE MATO GROSSO DO SUL;DOURADOS;-22.546;-55.15;True;5813;2953;2854;2368;1153;1209;3445;1800;1645
5005400;Maracaju;MS;50;Centro-Oeste;SUDOESTE DE MATO GROSSO DO SUL;DOURADOS;-21.614;-55.168;True;30912;15905;14961;26034;13080;12954;4878;2825;2007
5005608;Miranda;MS;50;Centro-Oeste;PANTANAL SUL MATO-GROSSENSE;AQUIDAUANA;-20.241;-56.378;True;23965;12231;11594;14403;7219;7176;9562;5012;4418
5005681;Mundo Novo;MS;50;Centro-Oeste;SUDOESTE DE MATO GROSSO DO SUL;IGUATEMI;-23.938;-54.271;True;15968;7720;8159;14135;6752;7294;1833;968;865
5005707;Naviraí;MS;50;Centro-Oeste;SUDOESTE DE MATO GROSSO DO SUL;IGUATEMI;-23.065;-54.191;True;43391;21620;21580;39820;19681;19982;3571;1939;1598
5005806;Nioaque;MS;50;Centro-Oeste;SUDOESTE DE MATO GROSSO DO SUL;BODOQUENA;-21.135;-55.83;True;15203;7976;7160;7066;3614;3448;8137;4362;3712
5006002;Nova Alvorada do Sul;MS;50;Centro-Oeste;SUDOESTE DE MATO GROSSO DO SUL;DOURADOS;-21.466;-54.384;True;12026;6220;5783;8111;4075;4036;3915;2145;1747
5006200;Nova Andradina;MS;50;Centro-Oeste;LESTE DE MATO GROSSO DO SUL;NOVA ANDRADINA;-22.233;-53.343;True;43495;21722;21685;36538;17956;18552;6957;3766;3133
5006259;Novo Horizonte do Sul;MS;50;Centro-Oeste;SUDOESTE DE MATO GROSSO DO SUL;IGUATEMI;-22.669;-53.86;True;4967;2530;2434;2268;1090;1175;2699;1440;1259
5006309;Paranaíba;MS;50;Centro-Oeste;LESTE DE MATO GROSSO DO SUL;PARANAIBA;-19.677;-51.191;True;38969;19538;19407;34247;16971;17267;4722;2567;2140
5006358;Paranhos;MS;50;Centro-Oeste;SUDOESTE DE MATO GROSSO DO SUL;IGUATEMI;-23.893;-55.431;True;11092;5562;5522;5407;2649;2750;5685;2913;2772
5006408;Pedro Gomes;MS;50;Centro-Oeste;CENTRO NORTE DE MATO GROSSO DO SUL;ALTO TAQUARI;-18.101;-54.552;True;8307;4342;3941;6382;3268;3105;1925;1074;836
5006606;Ponta Porã;MS;50;Centro-Oeste;SUDOESTE DE MATO GROSSO DO SUL;DOURADOS;-22.536;-55.726;True;72207;35470;36058;56684;27207;28922;15523;8263;7136
5006903;Porto Murtinho;MS;50;Centro-Oeste;PANTANAL SUL MATO-GROSSENSE;BAIXO PANTANAL;-21.699;-57.883;True;14861;7793;6942;9612;4846;4702;5249;2947;2240
5007109;Ribas do Rio Pardo;MS;50;Centro-Oeste;LESTE DE MATO GROSSO DO SUL;TRES LAGOAS;-20.443;-53.759;True;19159;9834;9209;12872;6447;6388;6287;3387;2821
5007208;Rio Brilhante;MS;50;Centro-Oeste;SUDOESTE DE MATO GROSSO DO SUL;DOURADOS;-21.802;-54.546;True;26560;13615;12870;20270;10225;9997;6290;3390;2873
5007307;Rio Negro;MS;50;Centro-Oeste;CENTRO NORTE DE MATO GROSSO DO SUL;CAMPO GRANDE;-19.449;-54.987;True;4961;2570;2389;3406;1696;1710;1555;874;679
5007406;Rio Verde de Mato Grosso;MS;50;Centro-Oeste;CENTRO NORTE DE MATO GROSSO DO SUL;ALTO TAQUARI;-18.918;-54.844;True;18579;9420;9046;15829;7933;7847;2750;1487;1199
5007505;Rochedo;MS;50;Centro-Oeste;CENTRO NORTE DE MATO GROSSO DO SUL;CAMPO GRANDE;-19.953;-54.893;True;4346;2281;2062;2303;1145;1158;2043;1136;904
5007554;Santa Rita do Pardo;MS;50;Centro-Oeste;LESTE DE MATO GROSSO DO SUL;TRES LAGOAS;-21.303;-52.831;True;7162;3614;3282;3444;1706;1723;3718;1908;1559
5007695;São Gabriel do Oeste;MS;50;Centro-Oeste;CENTRO NORTE DE MATO GROSSO DO SUL;ALTO TAQUARI;-19.395;-54.566;True;20524;10464;10060;17629;8861;8768;2895;1603;1292
5007703;Sete Quedas;MS;50;Centro-Oeste;SUDOESTE DE MATO GROSSO DO SUL;IGUATEMI;-23.97;-55.036;True;10659;5404;5255;8793;4426;4367;1866;978;888
5007802;Selvíria;MS;50;Centro-Oeste;LESTE DE MATO GROSSO DO SUL;PARANAIBA;-20.367;-51.419;True;6413;3185;2981;4628;2304;2266;1785;881;715
5007901;Sidrolândia;MS;50;Centro-Oeste;CENTRO NORTE DE MATO GROSSO DO SUL;CAMPO GRANDE;-20.932;-54.961;True;38147;19545;18102;22842;11315;11355;15305;8230;6747
5007935;Sonora;MS;50;Centro-Oeste;CENTRO NORTE DE MATO GROSSO DO SUL;ALTO TAQUARI;-17.577;-54.758;True;12548;6354;5907;10922;5558;5247;1626;796;660
5007950;Tacuru;MS;50;Centro-Oeste;SUDOESTE DE MATO GROSSO DO SUL;IGUATEMI;-23.633;-55.016;True;9203;4731;4448;3927;2008;1919;5276;2723;2529
5007976;Taquarussu;MS;50;Centro-Oeste;LESTE DE MATO GROSSO DO SUL;NOVA ANDRADINA;-22.488;-53.351;True;3117;1564;1497;2103;1050;1047;1014;514;450
5008008;Terenos;MS;50;Centro-Oeste;CENTRO NORTE DE MATO GROSSO DO SUL;CAMPO GRANDE;-20.442;-54.86;True;14458;7472;6577;6176;2949;2953;8282;4523;3624
5008305;Três Lagoas;MS;50;Centro-Oeste;LESTE DE MATO GROSSO DO SUL;TRES LAGOAS;-20.751;-51.678;True;85914;42042;43339;81510;39668;41354;4404;2374;1985
5008404;Vicentina;MS;50;Centro-Oeste;SUDOESTE DE MATO GROSSO DO SUL;DOURADOS;-22.409;-54.436;True;5627;2813;2756;3897;1898;1963;1730;915;793
5100102;Acorizal;MT;51;Centro-Oeste;CENTRO-SUL MATO-GROSSENSE;ROSARIO OESTE;-15.205;-56.366;True;5530;2975;2555;3040;1576;1464;2490;1399;1091
5100201;Água Boa;MT;51;Centro-Oeste;NORDESTE MATO-GROSSENSE;CANARANA;-14.05;-52.159;True;18991;9590;8757;15068;7410;7195;3923;2180;1562
5100250;Alta Floresta;MT;51;Centro-Oeste;NORTE MATO-GROSSENSE;ALTA FLORESTA;-9.876;-56.086;True;49140;25117;23857;41798;21162;20536;7342;3955;3321
5100300;Alto Araguaia;MT;51;Centro-Oeste;SUDESTE MATO-GROSSENSE;ALTO ARAGUAIA;-17.315;-53.215;True;13790;7090;6668;11681;5900;5749;2109;1190;919
5100359;Alto Boa Vista;MT;51;Centro-Oeste;NORDESTE MATO-GROSSENSE;NORTE ARAGUAIA;-11.674;-51.388;True;5025;2535;2317;2985;1419;1419;2040;1116;898
5100409;Alto Garças;MT;51;Centro-Oeste;SUDESTE MATO-GROSSENSE;ALTO ARAGUAIA;-16.944;-53.528;True;9132;4711;4413;8280;4248;4032;852;463;381
5100508;Alto Paraguai;MT;51;Centro-Oeste;CENTRO-SUL MATO-GROSSENSE;ALTO PARAGUAI;-14.514;-56.483;True;8144;3936;3500;5801;2816;2687;2343;1120;813
5100607;Alto Taquari;MT;51;Centro-Oeste;SUDESTE MATO-GROSSENSE;ALTO ARAGUAIA;-17.826;-53.282;True;6058;3201;2834;5190;2700;2467;868;501;367
5100805;Apiacás;MT;51;Centro-Oeste;NORTE MATO-GROSSENSE;ALTA FLORESTA;-9.544;-57.449;True;7926;4260;3472;5944;3046;2746;1982;1214;726
5101001;Araguaiana;MT;51;Centro-Oeste;NORDESTE MATO-GROSSENSE;MEDIO ARAGUAIA;-15.734;-51.831;True;2974;1559;1392;2180;1089;1068;794;470;324
5101209;Araguainha;MT;51;Centro-Oeste;SUDESTE MATO-GROSSENSE;TESOURO;-16.856;-53.033;True;1117;585;532;968;498;470;149;87;62
5101258;Araputanga;MT;51;Centro-Oeste;SUDOESTE MATO-GROSSENSE;JAURU;-15.471;-58.353;True;15335;7688;7645;12281;6019;6260;3054;1669;1385
5101308;Arenápolis;MT;51;Centro-Oeste;CENTRO-SUL MATO-GROSSENSE;ALTO PARAGUAI;-14.45;-56.846;True;9869;5050;4809;9383;4777;4606;486;273;203
5101407;Aripuanã;MT;51;Centro-Oeste;NORTE MATO-GROSSENSE;ARIPUANA;-10.167;-59.459;True;19100;10222;8674;11556;5980;5397;7544;4242;3277
5101605;Barão de Melgaço;MT;51;Centro-Oeste;CENTRO-SUL MATO-GROSSENSE;ALTO PANTANAL;-16.279;-55.958;True;7619;4150;3465;3357;1726;1631;4262;2424;1834
5101704;Barra do Bugres;MT;51;Centro-Oeste;SUDOESTE MATO-GROSSENSE;TANGARA DA SERRA;-15.073;-57.181;True;32490;16955;15174;26303;13451;12525;6187;3504;2649
5101803;Barra do Garças;MT;51;Centro-Oeste;NORDESTE MATO-GROSSENSE;MEDIO ARAGUAIA;-15.89;-52.257;True;53243;26460;26598;47687;23466;24061;5556;2994;2537
5101852;Bom Jesus do Araguaia;MT;51;Centro-Oeste;NORDESTE MATO-GROSSENSE;NORTE ARAGUAIA;-12.175;-51.503;True;4520;2547;1969;1675;887;788;2845;1660;1181
5101902;Brasnorte;MT;51;Centro-Oeste;NORTE MATO-GROSSENSE;ARIPUANA;-12.155;-57.979;True;13975;7376;6318;7937;4087;3676;6038;3289;2642
5102504;Cáceres;MT;51;Centro-Oeste;CENTRO-SUL MATO-GROSSENSE;ALTO PANTANAL;-16.071;-57.679;True;84175;42018;41408;71474;35184;35825;12701;6834;5583
5102603;Campinápolis;MT;51;Centro-Oeste;NORDESTE MATO-GROSSENSE;CANARANA;-14.516;-52.895;True;13666;7112;6506;5366;2803;2529;8300;4309;3977
5102637;Campo Novo do Parecis;MT;51;Centro-Oeste;NORTE MATO-GROSSENSE;PARECIS;-13.675;-57.892;True;22322;11573;10332;19486;9880;9189;2836;1693;1143
5102678;Campo Verde;MT;51;Centro-Oeste;SUDESTE MATO-GROSSENSE;PRIMAVERA DO LESTE;-15.547;-55.169;True;25924;13404;12436;20244;10350;9834;5680;3054;2602
5102686;Campos de Júlio;MT;51;Centro-Oeste;NORTE MATO-GROSSENSE;PARECIS;-13.899;-59.148;True;4770;2519;2245;3591;1876;1715;1179;643;530
5102694;Canabrava do Norte;MT;51;Centro-Oeste;NORDESTE MATO-GROSSENSE;NORTE ARAGUAIA;-11.054;-51.831;True;5337;2822;2229;2292;1111;1014;3045;1711;1215
5102702;Canarana;MT;51;Centro-Oeste;NORDESTE MATO-GROSSENSE;CANARANA;-13.55;-52.166;True;17183;8813;8233;13676;6932;6705;3507;1881;1528
5102793;Carlinda;MT;51;Centro-Oeste;NORTE MATO-GROSSENSE;ALTA FLORESTA;-9.958;-55.832;True;12108;6402;5632;4839;2490;2348;7269;3912;3284
5102850;Castanheira;MT;51;Centro-Oeste;NORTE MATO-GROSSENSE;ARIPUANA;-11.133;-58.603;True;7808;4075;3659;3793;1848;1885;4015;2227;1774
5103007;Chapada dos Guimarães;MT;51;Centro-Oeste;CENTRO-SUL MATO-GROSSENSE;CUIABA;-15.461;-55.75;True;17377;8993;8049;9877;4851;4879;7500;4142;3170
5103056;Cláudia;MT;51;Centro-Oeste;NORTE MATO-GROSSENSE;SINOP;-11.515;-54.891;True;10670;5577;5084;8172;4199;3967;2498;1378;1117
5103106;Cocalinho;MT;51;Centro-Oeste;NORDESTE MATO-GROSSENSE;MEDIO ARAGUAIA;-14.397;-50.996;True;5841;3181;2657;3808;1997;1811;2033;1184;846
5103205;Colíder;MT;51;Centro-Oeste;NORTE MATO-GROSSENSE;COLIDER;-10.813;-55.455;True;30695;15653;15042;24591;12314;12277;6104;3339;2765
5103254;Colniza;MT;51;Centro-Oeste;NORTE MATO-GROSSENSE;ARIPUANA;-9.456;-59.229;True;27882;14828;12630;15860;8074;7412;12022;6754;5218
5103304;Comodoro;MT;51;Centro-Oeste;NORTE MATO-GROSSENSE;PARECIS;-13.663;-59.786;True;17939;9323;8589;11322;5781;5541;6617;3542;3048
5103353;Confresa;MT;51;Centro-Oeste;NORDESTE MATO-GROSSENSE;NORTE ARAGUAIA;-10.644;-51.569;True;21361;11318;9750;9469;4827;4585;11892;6491;5165
5103361;Conquista D'Oeste;MT;51;Centro-Oeste;SUDOESTE MATO-GROSSENSE;ALTO GUAPORE;-14.541;-59.548;True;3106;1610;1496;1796;933;863;1310;677;633
5103379;Cotriguaçu;MT;51;Centro-Oeste;NORTE MATO-GROSSENSE;ARIPUANA;-9.858;-58.414;True;13740;7474;6248;5506;2893;2613;8234;4581;3635
5103403;Cuiabá;MT;51;Centro-Oeste;CENTRO-SUL MATO-GROSSENSE;CUIABA;-15.596;-56.097;True;526830;252892;268159;519015;248651;264695;7815;4241;3464
5103437;Curvelândia;MT;51;Centro-Oeste;CENTRO-SUL MATO-GROSSENSE;ALTO PANTANAL;-15.608;-57.915;True;4835;2417;2193;2716;1321;1296;2119;1096;897
5103452;Denise;MT;51;Centro-Oeste;SUDOESTE MATO-GROSSENSE;TANGARA DA SERRA;-14.74;-57.054;True;10349;5962;4324;8491;4500;3931;1858;1462;393
5103502;Diamantino;MT;51;Centro-Oeste;NORTE MATO-GROSSENSE;PARECIS;-14.409;-56.446;True;18428;9747;8599;13659;6879;6742;4769;2868;1857
5103601;Dom Aquino;MT;51;Centro-Oeste;SUDESTE MATO-GROSSENSE;RONDONOPOLIS;-15.811;-54.918;True;8261;4193;3979;6683;3319;3275;1578;874;704
5103700;Feliz Natal;MT;51;Centro-Oeste;NORTE MATO-GROSSENSE;SINOP;-12.386;-54.92;True;10279;5391;4823;7515;3912;3562;2764;1479;1261
5103809;Figueirópolis D'Oeste;MT;51;Centro-Oeste;SUDOESTE MATO-GROSSENSE;JAURU;-15.445;-58.74;True;3648;1873;1775;2034;992;1042;1614;881;733
5103858;Gaúcha do Norte;MT;51;Centro-Oeste;NORTE MATO-GROSSENSE;PARANATINGA;-13.242;-53.08;True;5816;3092;2676;2117;1102;1011;3699;1990;1665
5103908;General Carneiro;MT;51;Centro-Oeste;SUDESTE MATO-GROSSENSE;TESOURO;-15.711;-52.755;True;4803;2577;2226;2390;1238;1152;2413;1339;1074
5103957;Glória D'Oeste;MT;51;Centro-Oeste;SUDOESTE MATO-GROSSENSE;JAURU;-15.768;-58.356;True;3124;1602;1492;2042;1048;994;1082;554;498
5104104;Guarantã do Norte;MT;51;Centro-Oeste;NORTE MATO-GROSSENSE;COLIDER;-9.788;-54.91;True;30754;15794;14805;22020;11075;10853;8734;4719;3952
5104203;Guiratinga;MT;51;Centro-Oeste;SUDESTE MATO-GROSSENSE;TESOURO;-16.349;-53.758;True;13883;7174;6570;11542;5825;5674;2341;1349;896
5104500;Indiavaí;MT;51;Centro-Oeste;SUDOESTE MATO-GROSSENSE;JAURU;-15.494;-58.573;True;2524;1312;1212;1842;949;893;682;363;319
5104526;Ipiranga do Norte;MT;51;Centro-Oeste;NORTE MATO-GROSSENSE;ALTO TELES PIRES;-12.241;-56.146;True;4129;2246;1858;2650;1386;1264;1479;860;594
5104542;Itanhangá;MT;51;Centro-Oeste;NORTE MATO-GROSSENSE;ALTO TELES PIRES;-12.172;-56.68;True;4703;2618;2059;2155;1167;985;2548;1451;1074
5104559;Itaúba;MT;51;Centro-Oeste;NORTE MATO-GROSSENSE;SINOP;-11.062;-55.276;True;4625;2449;2168;3578;1843;1727;1047;606;441
5104609;Itiquira;MT;51;Centro-Oeste;SUDESTE MATO-GROSSENSE;RONDONOPOLIS;-17.209;-54.15;True;12159;6577;5569;3867;1991;1876;8292;4586;3693
5104807;Jaciara;MT;51;Centro-Oeste;SUDESTE MATO-GROSSENSE;RONDONOPOLIS;-15.965;-54.968;True;24945;12476;12080;22996;11425;11232;1949;1051;848
5104906;Jangada;MT;51;Centro-Oeste;CENTRO-SUL MATO-GROSSENSE;ROSARIO OESTE;-15.236;-56.489;True;8058;4274;3777;3539;1799;1740;4519;2475;2037
5105002;Jauru;MT;51;Centro-Oeste;SUDOESTE MATO-GROSSENSE;JAURU;-15.342;-58.866;True;10774;5414;5209;6525;3198;3272;4249;2216;1937
5105101;Juara;MT;51;Centro-Oeste;NORTE MATO-GROSSENSE;ARINOS;-11.255;-57.52;True;32023;16616;15274;26252;13498;12738;5771;3118;2536
5105150;Juína;MT;51;Centro-Oeste;NORTE MATO-GROSSENSE;ARIPUANA;-11.378;-58.741;True;38422;19871;18471;32831;16788;16013;5591;3083;2458
5105176;Juruena;MT;51;Centro-Oeste;NORTE MATO-GROSSENSE;ARIPUANA;-10.318;-58.359;True;8731;4421;4126;5517;2657;2682;3214;1764;1444
5105200;Juscimeira;MT;51;Centro-Oeste;SUDESTE MATO-GROSSENSE;RONDONOPOLIS;-16.051;-54.884;True;11830;6062;5644;8701;4368;4216;3129;1694;1428
5105234;Lambari D'Oeste;MT;51;Centro-Oeste;SUDOESTE MATO-GROSSENSE;JAURU;-15.323;-58.004;True;4870;2536;2236;2945;1513;1383;1925;1023;853
5105259;Lucas do Rio Verde;MT;51;Centro-Oeste;NORTE MATO-GROSSENSE;ALTO TELES PIRES;-13.05;-55.911;True;30741;15947;14734;28017;14440;13517;2724;1507;1217
5105309;Luciára;MT;51;Centro-Oeste;NORDESTE MATO-GROSSENSE;NORTE ARAGUAIA;-11.222;-50.669;True;2405;1254;1151;2176;1109;1067;229;145;84
5105507;Vila Bela da Santíssima Trindade;MT;51;Centro-Oeste;SUDOESTE MATO-GROSSENSE;ALTO GUAPORE;-15.008;-59.951;True;13886;7337;6545;4877;2470;2407;9009;4867;4138
5105580;Marcelândia;MT;51;Centro-Oeste;NORTE MATO-GROSSENSE;SINOP;-11.133;-54.597;True;14084;7490;6574;9001;4708;4275;5083;2782;2299
5105606;Matupá;MT;51;Centro-Oeste;NORTE MATO-GROSSENSE;COLIDER;-10.057;-54.933;True;14243;7521;6720;10414;5326;5086;3829;2195;1634
5105622;Mirassol D'Oeste;MT;51;Centro-Oeste;SUDOESTE MATO-GROSSENSE;JAURU;-15.675;-58.096;True;24538;12287;11964;20394;10061;10067;4144;2226;1897
5105903;Nobres;MT;51;Centro-Oeste;NORTE MATO-GROSSENSE;ALTO TELES PIRES;-14.72;-56.328;True;14862;7656;7104;11874;6009;5790;2988;1647;1314
5106000;Nortelândia;MT;51;Centro-Oeste;CENTRO-SUL MATO-GROSSENSE;ALTO PARAGUAI;-14.455;-56.803;True;6237;3138;2998;5062;2502;2486;1175;636;512
5106109;Nossa Senhora do Livramento;MT;51;Centro-Oeste;CENTRO-SUL MATO-GROSSENSE;CUIABA;-15.775;-56.346;True;12386;6824;5537;4223;2177;2044;8163;4647;3493
5106158;Nova Bandeirantes;MT;51;Centro-Oeste;NORTE MATO-GROSSENSE;ALTA FLORESTA;-9.814;-57.862;True;12742;6882;5456;4420;2323;2031;8322;4559;3425
5106174;Nova Nazaré;MT;51;Centro-Oeste;NORDESTE MATO-GROSSENSE;CANARANA;-13.99;-51.798;True;2745;1407;1338;941;467;474;1804;940;864
5106182;Nova Lacerda;MT;51;Centro-Oeste;SUDOESTE MATO-GROSSENSE;ALTO GUAPORE;-14.476;-59.609;True;4949;2539;2142;2648;1318;1249;2301;1221;893
5106190;Nova Santa Helena;MT;51;Centro-Oeste;NORTE MATO-GROSSENSE;SINOP;-10.852;-55.27;True;3347;1766;1541;1910;956;914;1437;810;627
5106208;Nova Brasilândia;MT;51;Centro-Oeste;NORTE MATO-GROSSENSE;PARANATINGA;-14.957;-54.966;True;4891;2621;2257;3568;1875;1687;1323;746;570
5106216;Nova Canaã do Norte;MT;51;Centro-Oeste;NORTE MATO-GROSSENSE;COLIDER;-10.558;-55.953;True;12652;6904;5726;6751;3624;3124;5901;3280;2602
5106224;Nova Mutum;MT;51;Centro-Oeste;NORTE MATO-GROSSENSE;ALTO TELES PIRES;-13.838;-56.084;True;24368;13307;11014;17443;9136;8260;6925;4171;2754
5106232;Nova Olímpia;MT;51;Centro-Oeste;SUDOESTE MATO-GROSSENSE;TANGARA DA SERRA;-14.797;-57.288;True;19474;9907;8983;17501;8845;8089;1973;1062;894
5106240;Nova Ubiratã;MT;51;Centro-Oeste;NORTE MATO-GROSSENSE;ALTO TELES PIRES;-12.991;-55.255;True;7782;4176;3289;3941;1957;1717;3841;2219;1572
5106257;Nova Xavantina;MT;51;Centro-Oeste;NORDESTE MATO-GROSSENSE;CANARANA;-14.673;-52.353;True;18670;9484;9013;14740;7326;7360;3930;2158;1653
5106265;Novo Mundo;MT;51;Centro-Oeste;NORTE MATO-GROSSENSE;COLIDER;-9.95;-55.198;True;6725;3649;3056;2640;1342;1283;4085;2307;1773
5106273;Novo Horizonte do Norte;MT;51;Centro-Oeste;NORTE MATO-GROSSENSE;ARINOS;-11.413;-57.352;True;3802;1973;1751;1966;966;944;1836;1007;807
5106281;Novo São Joaquim;MT;51;Centro-Oeste;NORDESTE MATO-GROSSENSE;CANARANA;-14.906;-53.018;True;6880;3662;3214;3913;1986;1927;2967;1676;1287
5106299;Paranaíta;MT;51;Centro-Oeste;NORTE MATO-GROSSENSE;ALTA FLORESTA;-9.665;-56.477;True;11540;6217;5323;6359;3268;3091;5181;2949;2232
5106307;Paranatinga;MT;51;Centro-Oeste;NORTE MATO-GROSSENSE;PARANATINGA;-14.432;-54.051;True;20033;10960;9073;14734;7804;6930;5299;3156;2143
5106315;Novo Santo Antônio;MT;51;Centro-Oeste;NORDESTE MATO-GROSSENSE;NORTE ARAGUAIA;-12.29;-50.968;True;2110;1125;919;1442;745;646;668;380;273
5106372;Pedra Preta;MT;51;Centro-Oeste;SUDESTE MATO-GROSSENSE;RONDONOPOLIS;-16.623;-54.474;True;15638;7788;7237;11165;5384;5291;4473;2404;1946
5106422;Peixoto de Azevedo;MT;51;Centro-Oeste;NORTE MATO-GROSSENSE;COLIDER;-10.229;-54.983;True;28987;15102;13740;19760;10010;9669;9227;5092;4071
5106455;Planalto da Serra;MT;51;Centro-Oeste;NORTE MATO-GROSSENSE;PARANATINGA;-14.658;-54.774;True;2734;1400;1311;2014;1015;992;720;385;319
5106505;Poconé;MT;51;Centro-Oeste;CENTRO-SUL MATO-GROSSENSE;ALTO PANTANAL;-16.257;-56.623;True;31118;16270;14748;22272;11319;10918;8846;4951;3830
5106653;Pontal do Araguaia;MT;51;Centro-Oeste;SUDESTE MATO-GROSSENSE;TESOURO;-15.934;-52.317;True;4966;2577;2368;4033;2021;2003;933;556;365
5106703;Ponte Branca;MT;51;Centro-Oeste;SUDESTE MATO-GROSSENSE;TESOURO;-16.764;-52.833;True;1794;951;843;1533;798;735;261;153;108
5106752;Pontes e Lacerda;MT;51;Centro-Oeste;SUDOESTE MATO-GROSSENSE;ALTO GUAPORE;-15.226;-59.335;True;37910;19212;18543;31424;15645;15703;6486;3567;2840
5106778;Porto Alegre do Norte;MT;51;Centro-Oeste;NORDESTE MATO-GROSSENSE;NORTE ARAGUAIA;-10.878;-51.633;True;9639;5111;4514;5020;2588;2429;4619;2523;2085
5106802;Porto dos Gaúchos;MT;51;Centro-Oeste;NORTE MATO-GROSSENSE;ARINOS;-11.535;-57.414;True;6116;3249;2867;2827;1419;1408;3289;1830;1459
5106828;Porto Esperidião;MT;51;Centro-Oeste;SUDOESTE MATO-GROSSENSE;JAURU;-15.853;-58.46;True;9607;5098;4399;3645;1921;1721;5962;3177;2678
5106851;Porto Estrela;MT;51;Centro-Oeste;SUDOESTE MATO-GROSSENSE;TANGARA DA SERRA;-15.324;-57.228;True;4011;2105;1906;2045;1048;997;1966;1057;909
5107008;Poxoréo;MT;51;Centro-Oeste;SUDESTE MATO-GROSSENSE;TESOURO;-15.837;-54.389;True;17592;9265;8233;12154;6232;5875;5438;3033;2358
5107040;Primavera do Leste;MT;51;Centro-Oeste;SUDESTE MATO-GROSSENSE;PRIMAVERA DO LESTE;-15.528;-54.346;True;44729;23096;21334;41123;20787;20040;3606;2309;1294
5107065;Querência;MT;51;Centro-Oeste;NORDESTE MATO-GROSSENSE;CANARANA;-12.476;-52.378;True;10682;5795;4861;4902;2562;2327;5780;3233;2534
5107107;São José dos Quatro Marcos;MT;51;Centro-Oeste;SUDOESTE MATO-GROSSENSE;JAURU;-15.621;-58.176;True;19001;9527;9453;14188;6993;7191;4813;2534;2262
5107156;Reserva do Cabaçal;MT;51;Centro-Oeste;SUDOESTE MATO-GROSSENSE;JAURU;-15.08;-58.466;True;2505;1310;1195;1577;801;776;928;509;419
5107180;Ribeirão Cascalheira;MT;51;Centro-Oeste;NORDESTE MATO-GROSSENSE;NORTE ARAGUAIA;-12.942;-51.824;True;8677;4494;4026;5554;2822;2651;3123;1672;1375
5107198;Ribeirãozinho;MT;51;Centro-Oeste;SUDESTE MATO-GROSSENSE;TESOURO;-16.485;-52.692;True;2107;1052;1039;1497;738;750;610;314;289
5107206;Rio Branco;MT;51;Centro-Oeste;SUDOESTE MATO-GROSSENSE;JAURU;-15.241;-58.116;True;5053;2507;2524;4086;2012;2063;967;495;461
5107248;Santa Carmem;MT;51;Centro-Oeste;NORTE MATO-GROSSENSE;SINOP;-11.913;-55.226;True;4319;2241;1999;3217;1663;1554;1102;578;445
5107263;Santo Afonso;MT;51;Centro-Oeste;CENTRO-SUL MATO-GROSSENSE;ALTO PARAGUAI;-14.498;-57.002;True;2855;1573;1271;1487;780;702;1368;793;569
5107297;São José do Povo;MT;51;Centro-Oeste;SUDESTE MATO-GROSSENSE;RONDONOPOLIS;-16.465;-54.255;True;3305;1774;1530;1512;754;757;1793;1020;773
5107305;São José do Rio Claro;MT;51;Centro-Oeste;NORTE MATO-GROSSENSE;ARINOS;-13.447;-56.721;True;17345;9039;8251;13535;6913;6622;3810;2126;1629
5107354;São José do Xingu;MT;51;Centro-Oeste;NORDESTE MATO-GROSSENSE;NORTE ARAGUAIA;-10.804;-52.744;True;4198;2228;1970;3159;1605;1554;1039;623;416
5107404;São Pedro da Cipa;MT;51;Centro-Oeste;SUDESTE MATO-GROSSENSE;RONDONOPOLIS;-16.001;-54.921;True;4028;2075;1920;3621;1854;1736;407;221;184
5107578;Rondolândia;MT;51;Centro-Oeste;NORTE MATO-GROSSENSE;ARIPUANA;-10.83;-61.459;True;3348;1824;1523;865;444;421;2483;1380;1102
5107602;Rondonópolis;MT;51;Centro-Oeste;SUDESTE MATO-GROSSENSE;RONDONOPOLIS;-16.471;-54.636;True;172783;85323;84892;164969;80852;81619;7814;4471;3273
5107701;Rosário Oeste;MT;51;Centro-Oeste;CENTRO-SUL MATO-GROSSENSE;ROSARIO OESTE;-14.836;-56.428;True;18031;9550;8324;10373;5235;5038;7658;4315;3286
5107743;Santa Cruz do Xingu;MT;51;Centro-Oeste;NORDESTE MATO-GROSSENSE;NORTE ARAGUAIA;-10.155;-52.392;True;2116;1113;894;1407;690;623;709;423;271
5107750;Salto do Céu;MT;51;Centro-Oeste;SUDOESTE MATO-GROSSENSE;JAURU;-15.13;-58.127;True;3650;1860;1777;2013;968;1045;1637;892;732
5107768;Santa Rita do Trivelato;MT;51;Centro-Oeste;NORTE MATO-GROSSENSE;ALTO TELES PIRES;-13.812;-55.267;True;2478;1438;1039;1233;640;593;1245;798;446
5107776;Santa Terezinha;MT;51;Centro-Oeste;NORDESTE MATO-GROSSENSE;NORTE ARAGUAIA;-10.47;-50.503;True;7293;3817;3290;3229;1624;1553;4064;2193;1737
5107792;Santo Antonuio do Leste;MT;51;Centro-Oeste;NORDESTE MATO-GROSSENSE;CANARANA;-14.796;-53.64;True;3249;1749;1500;1811;929;882;1438;820;618
5107800;Santo Antônio do Leverger;MT;51;Centro-Oeste;CENTRO-SUL MATO-GROSSENSE;CUIABA;-15.866;-56.077;True;19197;10076;8710;6398;3241;3146;12799;6835;5564
5107859;São Félix do Araguaia;MT;51;Centro-Oeste;NORDESTE MATO-GROSSENSE;NORTE ARAGUAIA;-11.617;-50.669;True;10713;5540;4875;6039;3015;3006;4674;2525;1869
5107875;Sapezal;MT;51;Centro-Oeste;NORTE MATO-GROSSENSE;PARECIS;-12.989;-58.764;True;14254;8394;5809;10621;5728;4873;3633;2666;936
5107883;Serra Nova Dourada;MT;51;Centro-Oeste;NORDESTE MATO-GROSSENSE;NORTE ARAGUAIA;-12.092;-51.402;True;1349;749;552;863;473;384;486;276;168
5107909;Sinop;MT;51;Centro-Oeste;NORTE MATO-GROSSENSE;SINOP;-11.864;-55.504;True;105762;54038;51697;93977;47587;46385;11785;6451;5312
5107925;Sorriso;MT;51;Centro-Oeste;NORTE MATO-GROSSENSE;ALTO TELES PIRES;-12.545;-55.711;True;55134;27977;26545;49536;24945;24024;5598;3032;2521
5107941;Tabaporã;MT;51;Centro-Oeste;NORTE MATO-GROSSENSE;ARINOS;-10.807;-56.62;True;10484;5842;4546;5085;2650;2432;5399;3192;2114
5107958;Tangará da Serra;MT;51;Centro-Oeste;SUDOESTE MATO-GROSSENSE;TANGARA DA SERRA;-14.619;-57.486;True;76657;38616;37263;69482;34667;34071;7175;3949;3192
5108006;Tapurah;MT;51;Centro-Oeste;NORTE MATO-GROSSENSE;ALTO TELES PIRES;-12.772;-56.554;True;10478;6065;4413;6448;3399;3049;4030;2666;1364
5108055;Terra Nova do Norte;MT;51;Centro-Oeste;NORTE MATO-GROSSENSE;COLIDER;-10.517;-55.231;True;14584;7813;6741;5781;2915;2843;8803;4898;3898
5108105;Tesouro;MT;51;Centro-Oeste;SUDESTE MATO-GROSSENSE;TESOURO;-16.079;-53.553;True;3109;1740;1369;2303;1213;1090;806;527;279
5108204;Torixoréu;MT;51;Centro-Oeste;SUDESTE MATO-GROSSENSE;TESOURO;-16.199;-52.556;True;4101;2130;1948;2968;1472;1473;1133;658;475
5108303;União do Sul;MT;51;Centro-Oeste;NORTE MATO-GROSSENSE;SINOP;-11.533;-54.353;True;3998;2157;1841;2559;1354;1205;1439;803;636
5108352;Vale de São Domingos;MT;51;Centro-Oeste;SUDOESTE MATO-GROSSENSE;ALTO GUAPORE;-15.293;-59.061;True;2873;1477;1389;608;313;295;2265;1164;1094
5108402;Várzea Grande;MT;51;Centro-Oeste;CENTRO-SUL MATO-GROSSENSE;CUIABA;-15.647;-56.133;True;230307;114077;115489;224185;110759;112699;6122;3318;2790
5108501;Vera;MT;51;Centro-Oeste;NORTE MATO-GROSSENSE;SINOP;-12.306;-55.317;True;9188;4709;4396;7834;4006;3808;1354;703;588
5108600;Vila Rica;MT;51;Centro-Oeste;NORDESTE MATO-GROSSENSE;NORTE ARAGUAIA;-10.012;-51.116;True;18934;9828;8888;13702;6804;6700;5232;3024;2188
5108808;Nova Guarita;MT;51;Centro-Oeste;NORTE MATO-GROSSENSE;COLIDER;-10.316;-55.41;True;4877;2491;2315;1908;933;921;2969;1558;1394
5108857;Nova Marilândia;MT;51;Centro-Oeste;CENTRO-SUL MATO-GROSSENSE;ALTO PARAGUAI;-14.364;-56.969;True;2315;1250;1065;1584;825;759;731;425;306
5108907;Nova Maringá;MT;51;Centro-Oeste;NORTE MATO-GROSSENSE;ARINOS;-13.026;-57.074;True;5554;2968;2565;3867;2036;1815;1687;932;750
5108956;Nova Monte Verde;MT;51;Centro-Oeste;NORTE MATO-GROSSENSE;ALTA FLORESTA;-9.982;-57.535;True;8133;4382;3690;3656;1881;1746;4477;2501;1944
5200050;Abadia de Goiás;GO;52;Centro-Oeste;CENTRO GOIANO;GOIANIA;-16.757;-49.438;True;5868;2760;2864;3963;1804;1993;1905;956;871
5200100;Abadiânia;GO;52;Centro-Oeste;LESTE GOIANO;ENTORNO DE BRASILIA;-16.204;-48.707;True;12640;6182;5858;7807;3686;3874;4833;2496;1984
5200134;Acreúna;GO;52;Centro-Oeste;SUL GOIANO;VALE DO RIO DOS BOIS;-17.396;-50.377;True;18553;9190;8906;16424;8102;7935;2129;1088;971
5200159;Adelândia;GO;52;Centro-Oeste;CENTRO GOIANO;ANICUNS;-16.415;-50.166;True;2510;1287;1201;2071;1061;1007;439;226;194
5200175;Água Fria de Goiás;GO;52;Centro-Oeste;LESTE GOIANO;ENTORNO DE BRASILIA;-14.986;-47.784;True;5008;2700;2232;2082;1093;989;2926;1607;1243
5200209;Água Limpa;GO;52;Centro-Oeste;SUL GOIANO;MEIA PONTE;-18.074;-48.762;True;2074;1082;992;1447;735;712;627;347;280
5200258;Águas Lindas de Goiás;GO;52;Centro-Oeste;LESTE GOIANO;ENTORNO DE BRASILIA;-15.762;-48.282;True;131884;65685;65518;131541;65486;65374;343;199;144
5200308;Alexânia;GO;52;Centro-Oeste;LESTE GOIANO;ENTORNO DE BRASILIA;-16.082;-48.507;True;20033;9275;9225;16635;7538;7684;3398;1737;1541
5200506;Aloândia;GO;52;Centro-Oeste;SUL GOIANO;MEIA PONTE;-17.728;-49.48;True;2065;1072;993;1761;896;865;304;176;128
5200555;Alto Horizonte;GO;52;Centro-Oeste;NORTE GOIANO;PORANGATU;-14.196;-49.339;True;3136;1678;1458;2442;1286;1156;694;392;302
5200605;Alto Paraíso de Goiás;GO;52;Centro-Oeste;NORTE GOIANO;CHAPADA DOS VEADEIROS;-14.133;-47.51;True;6638;3367;3271;4595;2258;2337;2043;1109;934
5200803;Alvorada do Norte;GO;52;Centro-Oeste;LESTE GOIANO;VAO DO PARANA;-14.481;-46.492;True;8217;4049;3942;7070;3407;3445;1147;642;497
5200829;Amaralina;GO;52;Centro-Oeste;NORTE GOIANO;PORANGATU;-13.926;-49.297;True;3492;1886;1600;1143;580;563;2349;1306;1037
5200852;Americano do Brasil;GO;52;Centro-Oeste;CENTRO GOIANO;ANICUNS;-16.255;-49.983;True;4698;2407;2284;4371;2239;2130;327;168;154
5200902;Amorinópolis;GO;52;Centro-Oeste;CENTRO GOIANO;IPORA;-16.619;-51.094;True;3527;1799;1713;2307;1140;1152;1220;659;561
5201108;Anápolis;GO;52;Centro-Oeste;CENTRO GOIANO;ANAPOLIS;-16.327;-48.953;True;325544;;;;;;;;
5201207;Anhanguera;GO;52;Centro-Oeste;SUL GOIANO;CATALAO;-18.337;-48.219;True;966;488;478;919;463;456;47;25;22
5201306;Anicuns;GO;52;Centro-Oeste;CENTRO GOIANO;ANICUNS;-16.461;-49.962;True;17705;8856;8526;15228;7554;7381;2477;1302;1145
5201405;Aparecida de Goiânia;GO;52;Centro-Oeste;CENTRO GOIANO;GOIANIA;-16.822;-49.245;True;475303;;;;;;;;
5201454;Aparecida do Rio Doce;GO;52;Centro-Oeste;SUL GOIANO;SUDOESTE DE GOIAS;-18.299;-51.145;True;2702;1368;1309;2088;1038;1050;614;330;259
5201504;Aporé;GO;52;Centro-Oeste;SUL GOIANO;SUDOESTE DE GOIAS;-18.965;-51.926;True;3554;1846;1577;2291;1164;1021;1263;682;556
5201603;Araçu;GO;52;Centro-Oeste;CENTRO GOIANO;ANAPOLIS;-16.358;-49.681;True;3880;1955;1925;3343;1674;1669;537;281;256
5201702;Aragarças;GO;52;Centro-Oeste;NOROESTE GOIANO;ARAGARCAS;-15.898;-52.251;True;17156;8594;8499;16776;8376;8337;380;218;162
5201801;Aragoiânia;GO;52;Centro-Oeste;CENTRO GOIANO;GOIANIA;-16.912;-49.451;True;7243;3625;3599;5146;2504;2642;2097;1121;957
5202155;Araguapaz;GO;52;Centro-Oeste;NOROESTE GOIANO;RIO VERMELHO;-15.091;-50.632;True;7482;3788;3548;5218;2602;2569;2264;1186;979
5202353;Arenópolis;GO;52;Centro-Oeste;NOROESTE GOIANO;ARAGARCAS;-16.386;-51.56;True;3495;1755;1655;2116;986;1054;1379;769;601
5202502;Aruanã;GO;52;Centro-Oeste;NOROESTE GOIANO;RIO VERMELHO;-14.92;-51.083;True;6476;3373;2986;5349;2727;2505;1127;646;481
5202601;Aurilândia;GO;52;Centro-Oeste;CENTRO GOIANO;ANICUNS;-16.682;-50.465;True;3719;1852;1867;2762;1338;1424;957;514;443
5202809;Avelinópolis;GO;52;Centro-Oeste;CENTRO GOIANO;ANICUNS;-16.466;-49.758;True;2375;1183;1192;1804;884;920;571;299;272
5203104;Baliza;GO;52;Centro-Oeste;NOROESTE GOIANO;ARAGARCAS;-16.196;-52.545;True;3299;1774;1460;1043;542;501;2256;1232;959
5203203;Barro Alto;GO;52;Centro-Oeste;CENTRO GOIANO;CERES;-14.971;-48.916;True;6446;3303;3131;4239;2133;2106;2207;1170;1025
5203302;Bela Vista de Goiás;GO;52;Centro-Oeste;CENTRO GOIANO;GOIANIA;-16.973;-48.953;True;20615;10552;10027;14296;7113;7183;6319;3439;2844
5203401;Bom Jardim de Goiás;GO;52;Centro-Oeste;NOROESTE GOIANO;ARAGARCAS;-16.21;-52.172;True;8372;4367;4001;6102;3093;3005;2270;1274;996
5203500;Bom Jesus de Goiás;GO;52;Centro-Oeste;SUL GOIANO;MEIA PONTE;-18.215;-49.742;True;19574;10216;9337;18218;9458;8751;1356;758;586
5203559;Bonfinópolis;GO;52;Centro-Oeste;CENTRO GOIANO;GOIANIA;-16.618;-48.963;True;6744;3454;3290;6167;3127;3040;577;327;250
5203575;Bonópolis;GO;52;Centro-Oeste;NORTE GOIANO;PORANGATU;-13.636;-49.81;True;3160;1655;1505;1265;629;636;1895;1026;869
5203609;Brazabrantes;GO;52;Centro-Oeste;CENTRO GOIANO;ANAPOLIS;-16.431;-49.389;True;3142;1568;1487;2096;1017;1009;1046;551;478
5203807;Britânia;GO;52;Centro-Oeste;NOROESTE GOIANO;RIO VERMELHO;-15.241;-51.161;True;5073;2568;2458;4085;2051;1994;988;517;464
5203906;Buriti Alegre;GO;52;Centro-Oeste;SUL GOIANO;MEIA PONTE;-18.144;-49.044;True;8287;4134;4120;7525;3715;3777;762;419;343
5203939;Buriti de Goiás;GO;52;Centro-Oeste;CENTRO GOIANO;ANICUNS;-16.181;-50.431;True;2238;1113;1100;1487;731;739;751;382;361
5203962;Buritinópolis;GO;52;Centro-Oeste;LESTE GOIANO;VAO DO PARANA;-14.479;-46.408;True;3442;1784;1654;1842;924;918;1600;860;736
5204003;Cabeceiras;GO;52;Centro-Oeste;LESTE GOIANO;ENTORNO DE BRASILIA;-15.801;-46.927;True;6610;3315;3195;5261;2599;2626;1349;716;569
5204102;Cachoeira Alta;GO;52;Centro-Oeste;SUL GOIANO;QUIRINOPOLIS;-18.763;-50.942;True;8103;4130;3714;5965;2918;2808;2138;1212;906
5204201;Cachoeira de Goiás;GO;52;Centro-Oeste;CENTRO GOIANO;IPORA;-16.668;-50.647;True;1410;735;675;1106;566;540;304;169;135
5204250;Cachoeira Dourada;GO;52;Centro-Oeste;SUL GOIANO;MEIA PONTE;-18.492;-49.475;True;7567;3850;3667;5085;2561;2504;2482;1289;1163
5204300;Caçu;GO;52;Centro-Oeste;SUL GOIANO;QUIRINOPOLIS;-18.557;-51.131;True;10892;5533;5282;8543;4228;4279;2349;1305;1003
5204409;Caiapônia;GO;52;Centro-Oeste;SUL GOIANO;SUDOESTE DE GOIAS;-16.957;-51.81;True;15747;7912;7708;11493;5553;5827;4254;2359;1881
5204508;Caldas Novas;GO;52;Centro-Oeste;SUL GOIANO;MEIA PONTE;-17.744;-48.626;True;62204;30739;30869;60070;29580;29931;2134;1159;938
5204557;Caldazinha;GO;52;Centro-Oeste;CENTRO GOIANO;GOIANIA;-16.714;-49.002;True;3157;1640;1517;1739;868;871;1418;772;646
5204607;Campestre de Goiás;GO;52;Centro-Oeste;SUL GOIANO;VALE DO RIO DOS BOIS;-16.762;-49.694;True;3411;1785;1593;2276;1153;1116;1135;632;477
5204656;Campinaçu;GO;52;Centro-Oeste;NORTE GOIANO;PORANGATU;-13.79;-48.571;True;3765;2013;1751;2119;1055;1064;1646;958;687
5204706;Campinorte;GO;52;Centro-Oeste;NORTE GOIANO;PORANGATU;-14.314;-49.152;True;9697;4981;4706;7448;3746;3697;2249;1235;1009
5204805;Campo Alegre de Goiás;GO;52;Centro-Oeste;SUL GOIANO;CATALAO;-17.639;-47.782;True;5767;2875;2739;4160;2051;2052;1607;824;687
5204854;Campo Limpo de Goiás;GO;52;Centro-Oeste;CENTRO GOIANO;ANAPOLIS;-16.297;-49.088;True;5596;2758;2643;4534;2197;2155;1062;561;488
5204904;Campos Belos;GO;52;Centro-Oeste;NORTE GOIANO;CHAPADA DOS VEADEIROS;-13.037;-46.772;True;18238;9054;9171;15926;7795;8131;2312;1259;1040
5204953;Campos Verdes;GO;52;Centro-Oeste;NORTE GOIANO;PORANGATU;-14.258;-49.658;True;6331;3290;3020;5789;2993;2787;542;297;233
5205000;Carmo do Rio Verde;GO;52;Centro-Oeste;CENTRO GOIANO;CERES;-15.354;-49.708;True;8897;4583;4297;6777;3423;3352;2120;1160;945
5205059;Castelândia;GO;52;Centro-Oeste;SUL GOIANO;SUDOESTE DE GOIAS;-18.091;-50.201;True;3530;1877;1639;3205;1696;1509;325;181;130
5205109;Catalão;GO;52;Centro-Oeste;SUL GOIANO;CATALAO;-18.17;-47.942;True;75623;37513;37547;70212;34709;35243;5411;2804;2304
5205208;Caturaí;GO;52;Centro-Oeste;CENTRO GOIANO;ANAPOLIS;-16.447;-49.494;True;4477;2318;2159;3341;1691;1650;1136;627;509
5205307;Cavalcante;GO;52;Centro-Oeste;NORTE GOIANO;CHAPADA DOS VEADEIROS;-13.798;-47.458;True;9875;5094;4451;3976;1956;1994;5899;3138;2457
5205406;Ceres;GO;52;Centro-Oeste;CENTRO GOIANO;CERES;-15.308;-49.598;True;18637;9051;9469;17732;8570;9045;905;481;424
5205455;Cezarina;GO;52;Centro-Oeste;SUL GOIANO;VALE DO RIO DOS BOIS;-16.972;-49.776;True;7361;3647;3432;5127;2586;2533;2234;1061;899
5205471;Chapadão do Céu;GO;52;Centro-Oeste;SUL GOIANO;SUDOESTE DE GOIAS;-18.408;-52.549;True;5289;2686;2508;4355;2186;2074;934;500;434
5205497;Cidade Ocidental;GO;52;Centro-Oeste;LESTE GOIANO;ENTORNO DE BRASILIA;-16.077;-47.925;True;48589;22774;23838;45990;21378;22660;2599;1396;1178
5205513;Cocalzinho de Goiás;GO;52;Centro-Oeste;LESTE GOIANO;ENTORNO DE BRASILIA;-15.794;-48.776;True;14762;7273;6838;6096;2903;3003;8666;4370;3835
5205521;Colinas do Sul;GO;52;Centro-Oeste;NORTE GOIANO;CHAPADA DOS VEADEIROS;-14.151;-48.078;True;3856;2131;1725;2489;1352;1137;1367;779;588
5205703;Córrego do Ouro;GO;52;Centro-Oeste;CENTRO GOIANO;IPORA;-16.294;-50.548;True;2633;1325;1284;1571;775;792;1062;550;492
5205802;Corumbá de Goiás;GO;52;Centro-Oeste;LESTE GOIANO;ENTORNO DE BRASILIA;-15.924;-48.809;True;9190;4664;4340;5448;2638;2693;3742;2026;1647
5205901;Corumbaíba;GO;52;Centro-Oeste;SUL GOIANO;CATALAO;-18.142;-48.562;True;8001;4026;3708;6107;2962;2878;1894;1064;830
5206206;Cristalina;GO;52;Centro-Oeste;LESTE GOIANO;ENTORNO DE BRASILIA;-16.769;-47.614;True;36614;18393;17470;30292;15079;14710;6322;3314;2760
5206305;Cristianópolis;GO;52;Centro-Oeste;SUL GOIANO;PIRES DO RIO;-17.199;-48.704;True;3041;1597;1440;2470;1257;1213;571;340;227
5206404;Crixás;GO;52;Centro-Oeste;NOROESTE GOIANO;SAO MIGUEL DO ARAGUAIA;-14.549;-49.969;True;14547;7514;6908;11516;5846;5590;3031;1668;1318
5206503;Cromínia;GO;52;Centro-Oeste;SUL GOIANO;MEIA PONTE;-17.288;-49.381;True;3618;1791;1726;2726;1299;1338;892;492;388
5206602;Cumari;GO;52;Centro-Oeste;SUL GOIANO;CATALAO;-18.263;-48.151;True;3055;1559;1474;2440;1218;1222;615;341;252
5206701;Damianópolis;GO;52;Centro-Oeste;LESTE GOIANO;VAO DO PARANA;-14.564;-46.177;True;3507;1827;1677;1846;945;901;1661;882;776
5206800;Damolândia;GO;52;Centro-Oeste;CENTRO GOIANO;ANAPOLIS;-16.253;-49.37;True;2688;1366;1307;2136;1084;1043;552;282;264
5206909;Davinópolis;GO;52;Centro-Oeste;SUL GOIANO;CATALAO;-18.153;-47.562;True;2013;1060;953;1356;700;656;657;360;297
5207105;Diorama;GO;52;Centro-Oeste;NOROESTE GOIANO;ARAGARCAS;-16.234;-51.256;True;2236;1145;1090;1395;692;703;841;453;387
5207253;Doverlândia;GO;52;Centro-Oeste;SUL GOIANO;SUDOESTE DE GOIAS;-16.72;-52.319;True;8344;4414;3882;5073;2541;2488;3271;1873;1394
5207352;Edealina;GO;52;Centro-Oeste;SUL GOIANO;VALE DO RIO DOS BOIS;-17.426;-49.665;True;3718;1926;1785;2557;1283;1270;1161;643;515
5207402;Edéia;GO;52;Centro-Oeste;SUL GOIANO;VALE DO RIO DOS BOIS;-17.339;-49.931;True;10251;5240;4989;8511;4253;4242;1740;987;747
5207501;Estrela do Norte;GO;52;Centro-Oeste;NORTE GOIANO;PORANGATU;-13.868;-49.073;True;3174;1630;1544;2774;1398;1376;400;232;168
5207535;Faina;GO;52;Centro-Oeste;NOROESTE GOIANO;RIO VERMELHO;-15.446;-50.361;True;6918;3498;3117;3862;1814;1785;3056;1684;1332
5207600;Fazenda Nova;GO;52;Centro-Oeste;CENTRO GOIANO;IPORA;-16.183;-50.78;True;6373;3302;3060;4257;2139;2112;2116;1163;948
5207808;Firminópolis;GO;52;Centro-Oeste;CENTRO GOIANO;ANICUNS;-16.582;-50.305;True;10286;5108;5178;8212;3999;4213;2074;1109;965
5207907;Flores de Goiás;GO;52;Centro-Oeste;LESTE GOIANO;VAO DO PARANA;-14.449;-47.05;True;10382;5602;4675;2875;1485;1390;7507;4117;3285
5208004;Formosa;GO;52;Centro-Oeste;LESTE GOIANO;ENTORNO DE BRASILIA;-15.537;-47.334;True;90212;44912;44813;79824;39183;40337;10388;5729;4476
5208103;Formoso;GO;52;Centro-Oeste;NORTE GOIANO;PORANGATU;-13.654;-48.882;True;5241;2666;2498;3681;1848;1833;1560;818;665
5208152;Gameleira de Goiás;GO;52;Centro-Oeste;SUL GOIANO;PIRES DO RIO;-16.4635;-48.67;True;3289;1692;1494;1005;515;490;2284;1177;1004
5208301;Divinópolis de Goiás;GO;52;Centro-Oeste;LESTE GOIANO;VAO DO PARANA;-13.295;-46.393;True;5344;2841;2493;3116;1605;1511;2228;1236;982
5208400;Goianápolis;GO;52;Centro-Oeste;CENTRO GOIANO;GOIANIA;-16.511;-49.024;True;11159;5669;5482;10109;5098;5011;1050;571;471
5208509;Goiandira;GO;52;Centro-Oeste;SUL GOIANO;CATALAO;-18.133;-48.085;True;4925;2435;2414;4252;2094;2158;673;341;256
5208608;Goianésia;GO;52;Centro-Oeste;CENTRO GOIANO;CERES;-15.317;-49.117;True;53806;27022;26620;49934;24946;24884;3872;2076;1736
5208707;Goiânia;GO;52;Centro-Oeste;CENTRO GOIANO;GOIANIA;-16.679;-49.254;True;1244645;;;;;;;;
5208806;Goianira;GO;52;Centro-Oeste;CENTRO GOIANO;GOIANIA;-16.496;-49.426;True;24110;12025;12054;23548;11710;11807;562;315;247
5208905;Goiás;GO;52;Centro-Oeste;NOROESTE GOIANO;RIO VERMELHO;-15.934;-50.14;True;24472;12143;12102;17540;8336;9012;6932;3807;3090
5209101;Goiatuba;GO;52;Centro-Oeste;SUL GOIANO;MEIA PONTE;-18.013;-49.357;True;31225;15538;15657;28548;14078;14454;2677;1460;1203
5209150;Gouvelândia;GO;52;Centro-Oeste;SUL GOIANO;QUIRINOPOLIS;-18.642;-50.066;True;4507;2408;2066;3466;1808;1635;1041;600;431
5209200;Guapó;GO;52;Centro-Oeste;CENTRO GOIANO;GOIANIA;-16.831;-49.532;True;13586;6846;6736;10196;4998;5194;3390;1848;1542
5209291;Guaraíta;GO;52;Centro-Oeste;CENTRO GOIANO;CERES;-15.614;-50.024;True;2394;1171;1156;1478;715;710;916;456;446
5209408;Guarani de Goiás;GO;52;Centro-Oeste;LESTE GOIANO;VAO DO PARANA;-13.936;-46.48;True;4105;2174;1892;1743;865;848;2362;1309;1044
5209457;Guarinos;GO;52;Centro-Oeste;CENTRO GOIANO;CERES;-14.732;-49.702;True;2411;1238;1087;1174;574;569;1237;664;518
5209606;Heitoraí;GO;52;Centro-Oeste;CENTRO GOIANO;ANAPOLIS;-15.719;-49.829;True;3556;1831;1721;2468;1259;1209;1088;572;512
5209705;Hidrolândia;GO;52;Centro-Oeste;CENTRO GOIANO;GOIANIA;-16.962;-49.229;True;14004;7134;6728;9615;4795;4801;4389;2339;1927
5209804;Hidrolina;GO;52;Centro-Oeste;CENTRO GOIANO;CERES;-14.724;-49.465;True;4157;2121;2036;2991;1486;1505;1166;635;531
5209903;Iaciara;GO;52;Centro-Oeste;LESTE GOIANO;VAO DO PARANA;-14.096;-46.632;True;12674;6491;6086;9033;4575;4454;3641;1916;1632
5209937;Inaciolândia;GO;52;Centro-Oeste;SUL GOIANO;MEIA PONTE;-18.488;-49.987;True;5650;2799;2707;4582;2282;2254;1068;517;453
5209952;Indiara;GO;52;Centro-Oeste;SUL GOIANO;VALE DO RIO DOS BOIS;-17.142;-49.987;True;12703;6461;5999;10408;5239;4969;2295;1222;1030
5210000;Inhumas;GO;52;Centro-Oeste;CENTRO GOIANO;ANAPOLIS;-16.358;-49.496;True;44983;22116;22804;42421;20715;21662;2562;1401;1142
5210109;Ipameri;GO;52;Centro-Oeste;SUL GOIANO;CATALAO;-17.722;-48.16;True;23114;11605;11388;19548;9658;9836;3566;1947;1552
5210158;Ipiranga de Goiás;GO;52;Centro-Oeste;CENTRO GOIANO;CERES;-15.17;-49.671;True;2813;1483;1330;843;437;406;1970;1046;924
5210208;Iporá;GO;52;Centro-Oeste;CENTRO GOIANO;IPORA;-16.442;-51.118;True;31060;15280;15763;28316;13807;14509;2744;1473;1254
5210307;Israelândia;GO;52;Centro-Oeste;CENTRO GOIANO;IPORA;-16.318;-50.908;True;2827;1468;1359;2137;1091;1046;690;377;313
5210406;Itaberaí;GO;52;Centro-Oeste;CENTRO GOIANO;ANAPOLIS;-16.02;-49.81;True;30609;15564;14998;25255;12714;12534;5354;2850;2464
5210562;Itaguari;GO;52;Centro-Oeste;CENTRO GOIANO;ANAPOLIS;-15.919;-49.604;True;4254;2139;2097;3653;1803;1832;601;336;265
5210604;Itaguaru;GO;52;Centro-Oeste;CENTRO GOIANO;ANAPOLIS;-15.758;-49.634;True;5467;2735;2629;4288;2138;2136;1179;597;493
5210802;Itajá;GO;52;Centro-Oeste;SUL GOIANO;QUIRINOPOLIS;-19.067;-51.544;True;5409;2706;2690;3750;1809;1941;1659;897;749
5210901;Itapaci;GO;52;Centro-Oeste;CENTRO GOIANO;CERES;-14.951;-49.549;True;16003;8075;7753;14546;7293;7108;1457;782;645
5211008;Itapirapuã;GO;52;Centro-Oeste;NOROESTE GOIANO;RIO VERMELHO;-15.823;-50.613;True;8208;4168;3903;5656;2824;2832;2552;1344;1071
5211206;Itapuranga;GO;52;Centro-Oeste;CENTRO GOIANO;CERES;-15.562;-49.949;True;24832;12034;12233;19090;9064;9538;5742;2970;2695
5211305;Itarumã;GO;52;Centro-Oeste;SUL GOIANO;QUIRINOPOLIS;-18.769;-51.348;True;5338;2686;2478;3479;1763;1716;1859;923;762
5211404;Itauçu;GO;52;Centro-Oeste;CENTRO GOIANO;ANAPOLIS;-16.201;-49.608;True;8710;4044;4083;6404;2988;3122;2306;1056;961
5211503;Itumbiara;GO;52;Centro-Oeste;SUL GOIANO;MEIA PONTE;-18.42;-49.218;True;88109;43486;44299;84041;41296;42534;4068;2190;1765
5211602;Ivolândia;GO;52;Centro-Oeste;CENTRO GOIANO;IPORA;-16.602;-50.794;True;2718;1461;1252;1481;760;716;1237;701;536
5211701;Jandaia;GO;52;Centro-Oeste;SUL GOIANO;VALE DO RIO DOS BOIS;-17.049;-50.146;True;6373;3288;3069;4157;2078;2079;2216;1210;990
5211800;Jaraguá;GO;52;Centro-Oeste;CENTRO GOIANO;ANAPOLIS;-15.757;-49.334;True;38968;19551;19084;32116;15892;16004;6852;3659;3080
5211909;Jataí;GO;52;Centro-Oeste;SUL GOIANO;SUDOESTE DE GOIAS;-17.881;-51.714;True;81972;40489;41197;75668;36982;38441;6304;3507;2756
5212006;Jaupaci;GO;52;Centro-Oeste;CENTRO GOIANO;IPORA;-16.178;-50.953;True;2998;1528;1461;2376;1196;1174;622;332;287
5212055;Jesúpolis;GO;52;Centro-Oeste;CENTRO GOIANO;ANAPOLIS;-15.951;-49.374;True;2201;1168;1033;1688;888;800;513;280;233
5212105;Joviânia;GO;52;Centro-Oeste;SUL GOIANO;MEIA PONTE;-17.805;-49.614;True;6731;3464;3241;6086;3126;2945;645;338;296
5212204;Jussara;GO;52;Centro-Oeste;NOROESTE GOIANO;RIO VERMELHO;-15.865;-50.868;True;18814;9235;9192;14995;7244;7451;3819;1991;1741
5212253;Lagoa Santa;GO;52;Centro-Oeste;SUL GOIANO;QUIRINOPOLIS;-19.183;-51.391;True;1225;602;613;852;414;436;373;188;177
5212303;Leopoldo de BulhõEs;GO;52;Centro-Oeste;CENTRO GOIANO;GOIANIA;-16.619;-48.744;True;8916;4604;4273;4996;2477;2519;3920;2127;1754
5212501;Luziânia;GO;52;Centro-Oeste;LESTE GOIANO;ENTORNO DE BRASILIA;-16.253;-47.95;True;196046;;;;;;;;
5212600;Mairipotaba;GO;52;Centro-Oeste;SUL GOIANO;MEIA PONTE;-17.299;-49.491;True;2655;1386;1245;1623;826;797;1032;560;448
5212709;Mambaí;GO;52;Centro-Oeste;LESTE GOIANO;VAO DO PARANA;-14.488;-46.113;True;6454;3339;3057;4175;2137;2002;2279;1202;1055
5212808;Mara Rosa;GO;52;Centro-Oeste;NORTE GOIANO;PORANGATU;-14.017;-49.178;True;10409;5268;5072;7709;3805;3881;2700;1463;1191
5212907;Marzagão;GO;52;Centro-Oeste;SUL GOIANO;MEIA PONTE;-17.981;-48.641;True;2053;1011;1022;1781;865;904;272;146;118
5212956;Matrinchã;GO;52;Centro-Oeste;NOROESTE GOIANO;RIO VERMELHO;-15.444;-50.746;True;4325;2208;2113;2993;1504;1489;1332;704;624
5213004;Maurilândia;GO;52;Centro-Oeste;SUL GOIANO;SUDOESTE DE GOIAS;-17.971;-50.339;True;10769;5540;5005;10309;5276;4812;460;264;193
5213053;Mimoso de Goiás;GO;52;Centro-Oeste;LESTE GOIANO;ENTORNO DE BRASILIA;-15.056;-48.161;True;2836;1485;1289;1249;645;604;1587;840;685
5213087;Minaçu;GO;52;Centro-Oeste;NORTE GOIANO;PORANGATU;-13.533;-48.22;True;31041;15642;15196;26637;13239;13278;4404;2403;1918
5213103;Mineiros;GO;52;Centro-Oeste;SUL GOIANO;SUDOESTE DE GOIAS;-17.569;-52.551;True;45189;22911;22123;40683;20358;20232;4506;2553;1891
5213400;Moiporá;GO;52;Centro-Oeste;CENTRO GOIANO;IPORA;-16.546;-50.739;True;1848;955;893;1241;622;619;607;333;274
5213509;Monte Alegre de Goiás;GO;52;Centro-Oeste;NORTE GOIANO;CHAPADA DOS VEADEIROS;-13.256;-46.901;True;7155;3758;3397;3121;1569;1552;4034;2189;1845
5213707;Montes Claros de Goiás;GO;52;Centro-Oeste;NOROESTE GOIANO;ARAGARCAS;-16.008;-51.397;True;7844;4080;3739;4856;2486;2370;2988;1594;1369
5213756;Montividiu;GO;52;Centro-Oeste;SUL GOIANO;SUDOESTE DE GOIAS;-17.444;-51.175;True;9255;4744;4436;7342;3724;3560;1913;1020;876
5213772;Montividiu do Norte;GO;52;Centro-Oeste;NORTE GOIANO;PORANGATU;-13.113;-48.607;True;4395;2366;2027;1282;634;648;3113;1732;1379
5213806;Morrinhos;GO;52;Centro-Oeste;SUL GOIANO;MEIA PONTE;-17.732;-49.101;True;38997;19433;19313;33251;16369;16787;5746;3064;2526
5213855;Morro Agudo de Goiás;GO;52;Centro-Oeste;CENTRO GOIANO;CERES;-15.321;-50.057;True;2339;1177;1127;1567;757;775;772;420;352
5213905;Mossâmedes;GO;52;Centro-Oeste;CENTRO GOIANO;ANICUNS;-16.127;-50.215;True;4954;2521;2404;3472;1741;1725;1482;780;679
5214002;Mozarlândia;GO;52;Centro-Oeste;NOROESTE GOIANO;SAO MIGUEL DO ARAGUAIA;-14.745;-50.571;True;13123;6588;6270;10832;5371;5209;2291;1217;1061
5214051;Mundo Novo;GO;52;Centro-Oeste;NOROESTE GOIANO;SAO MIGUEL DO ARAGUAIA;-13.776;-50.281;True;6877;3605;3195;3974;2025;1925;2903;1580;1270
5214101;Mutunópolis;GO;52;Centro-Oeste;NORTE GOIANO;PORANGATU;-13.733;-49.275;True;3954;2022;1825;2682;1323;1252;1272;699;573
5214408;Nazário;GO;52;Centro-Oeste;CENTRO GOIANO;ANICUNS;-16.582;-49.882;True;7223;3657;3555;6702;3383;3319;521;274;236
5214507;Nerópolis;GO;52;Centro-Oeste;CENTRO GOIANO;GOIANIA;-16.406;-49.219;True;19392;9467;9713;18220;8845;9180;1172;622;533
5214606;Niquelândia;GO;52;Centro-Oeste;NORTE GOIANO;PORANGATU;-14.474;-48.46;True;38517;19872;18551;29342;14866;14458;9175;5006;4093
5214705;Nova América;GO;52;Centro-Oeste;CENTRO GOIANO;CERES;-15.022;-49.896;True;2200;1129;1071;1532;777;755;668;352;316
5214804;Nova Aurora;GO;52;Centro-Oeste;SUL GOIANO;CATALAO;-18.059;-48.255;True;2094;1055;960;1754;901;853;340;154;107
5214838;Nova Crixás;GO;52;Centro-Oeste;NOROESTE GOIANO;SAO MIGUEL DO ARAGUAIA;-14.099;-50.327;True;12603;6625;5856;8039;4114;3814;4564;2511;2042
5214861;Nova Glória;GO;52;Centro-Oeste;CENTRO GOIANO;CERES;-15.143;-49.571;True;8470;4183;4180;5482;2661;2783;2988;1522;1397
5214879;Nova Iguaçu de Goiás;GO;52;Centro-Oeste;NORTE GOIANO;PORANGATU;-14.289;-49.389;True;2622;1350;1272;1763;877;886;859;473;386
5214903;Nova Roma;GO;52;Centro-Oeste;NORTE GOIANO;CHAPADA DOS VEADEIROS;-13.742;-46.88;True;3555;1866;1646;1484;724;760;2071;1142;886
5215009;Nova Veneza;GO;52;Centro-Oeste;CENTRO GOIANO;ANAPOLIS;-16.371;-49.323;True;6884;3411;3335;5875;2880;2888;1009;531;447
5215207;Novo Brasil;GO;52;Centro-Oeste;CENTRO GOIANO;IPORA;-16.034;-50.711;True;3451;1742;1682;2208;1082;1126;1243;660;556
5215231;Novo Gama;GO;52;Centro-Oeste;LESTE GOIANO;ENTORNO DE BRASILIA;-16.059;-48.039;True;83599;40009;41367;81668;38989;40531;1931;1020;836
5215256;Novo Planalto;GO;52;Centro-Oeste;NOROESTE GOIANO;SAO MIGUEL DO ARAGUAIA;-13.244;-49.504;True;3986;2097;1886;2520;1265;1255;1466;832;631
5215306;Orizona;GO;52;Centro-Oeste;SUL GOIANO;PIRES DO RIO;-17.031;-48.296;True;14374;7483;6861;7667;3817;3850;6707;3666;3011
5215405;Ouro Verde de Goiás;GO;52;Centro-Oeste;CENTRO GOIANO;ANAPOLIS;-16.22;-49.193;True;4430;2119;2044;2838;1273;1306;1592;846;738
5215504;Ouvidor;GO;52;Centro-Oeste;SUL GOIANO;CATALAO;-18.234;-47.839;True;4736;2459;2272;4111;2111;1995;625;348;277
5215603;Padre Bernardo;GO;52;Centro-Oeste;LESTE GOIANO;ENTORNO DE BRASILIA;-15.16;-48.284;True;25969;13129;12511;15029;7359;7531;10940;5770;4980
5215652;Palestina de Goiás;GO;52;Centro-Oeste;SUL GOIANO;SUDOESTE DE GOIAS;-16.733;-51.533;True;3229;1698;1531;2039;1041;998;1190;657;533
5215702;Palmeiras de Goiás;GO;52;Centro-Oeste;SUL GOIANO;VALE DO RIO DOS BOIS;-16.805;-49.926;True;21199;10692;10292;16763;8328;8357;4436;2364;1935
5215801;Palmelo;GO;52;Centro-Oeste;SUL GOIANO;PIRES DO RIO;-17.324;-48.424;True;2260;1109;1144;2088;1014;1067;172;95;77
5215900;Palminópolis;GO;52;Centro-Oeste;SUL GOIANO;VALE DO RIO DOS BOIS;-16.796;-50.165;True;3622;1831;1791;2421;1189;1232;1201;642;559
5216007;Panamá;GO;52;Centro-Oeste;SUL GOIANO;MEIA PONTE;-18.177;-49.354;True;2618;1349;1265;1995;1004;991;623;345;274
5216304;Paranaiguara;GO;52;Centro-Oeste;SUL GOIANO;QUIRINOPOLIS;-18.916;-50.654;True;7724;3760;3813;6991;3362;3478;733;398;335
5216403;Paraúna;GO;52;Centro-Oeste;SUL GOIANO;VALE DO RIO DOS BOIS;-16.948;-50.449;True;10926;5561;5305;7649;3793;3844;3277;1768;1461
5216452;Perolândia;GO;52;Centro-Oeste;SUL GOIANO;SUDOESTE DE GOIAS;-17.529;-52.064;True;2748;1446;1301;1778;908;870;970;538;431
5216809;Petrolina de Goiás;GO;52;Centro-Oeste;CENTRO GOIANO;ANAPOLIS;-16.095;-49.338;True;9864;4967;4875;6506;3188;3318;3358;1779;1557
5216908;Pilar de Goiás;GO;52;Centro-Oeste;CENTRO GOIANO;CERES;-14.764;-49.578;True;2852;1522;1314;1121;560;561;1731;962;753
5217104;Piracanjuba;GO;52;Centro-Oeste;SUL GOIANO;MEIA PONTE;-17.303;-49.018;True;23310;11774;11313;16752;8168;8444;6558;3606;2869
5217203;Piranhas;GO;52;Centro-Oeste;NOROESTE GOIANO;ARAGARCAS;-16.427;-51.822;True;11139;5655;5468;8872;4404;4452;2267;1251;1016
5217302;Pirenópolis;GO;52;Centro-Oeste;LESTE GOIANO;ENTORNO DE BRASILIA;-15.852;-48.959;True;20460;10228;9721;12675;6144;6298;7785;4084;3423
5217401;Pires do Rio;GO;52;Centro-Oeste;SUL GOIANO;PIRES DO RIO;-17.301;-48.28;True;26857;13232;13574;25031;12243;12746;1826;989;828
5217609;Planaltina;GO;52;Centro-Oeste;LESTE GOIANO;ENTORNO DE BRASILIA;-15.453;-47.614;True;76376;37530;38048;72193;35175;36275;4183;2355;1773
5217708;Pontalina;GO;52;Centro-Oeste;SUL GOIANO;MEIA PONTE;-17.526;-49.449;True;16226;8044;8032;13216;6406;6673;3010;1638;1359
5218003;Porangatu;GO;52;Centro-Oeste;NORTE GOIANO;PORANGATU;-13.441;-49.149;True;39238;19667;19544;33077;16263;16807;6161;3404;2737
5218052;Porteirão;GO;52;Centro-Oeste;SUL GOIANO;MEIA PONTE;-17.815;-50.164;True;3008;1581;1409;2726;1427;1299;282;154;110
5218102;Portelândia;GO;52;Centro-Oeste;SUL GOIANO;SUDOESTE DE GOIAS;-17.354;-52.679;True;3310;1681;1572;2715;1360;1305;595;321;267
5218300;Posse;GO;52;Centro-Oeste;LESTE GOIANO;VAO DO PARANA;-14.093;-46.369;True;28850;14373;14212;21671;10636;10942;7179;3737;3270
5218391;Professor Jamil;GO;52;Centro-Oeste;SUL GOIANO;MEIA PONTE;-17.251;-49.244;True;3298;1712;1548;2342;1182;1148;956;530;400
5218508;Quirinópolis;GO;52;Centro-Oeste;SUL GOIANO;QUIRINOPOLIS;-18.448;-50.452;True;38064;18608;18509;33746;16372;16728;4318;2236;1781
5218607;Rialma;GO;52;Centro-Oeste;CENTRO GOIANO;CERES;-15.315;-49.584;True;10485;5215;5270;9292;4562;4730;1193;653;540
5218706;Rianápolis;GO;52;Centro-Oeste;CENTRO GOIANO;CERES;-15.447;-49.51;True;4167;2041;1974;3657;1774;1766;510;267;208
5218789;Rio Quente;GO;52;Centro-Oeste;SUL GOIANO;MEIA PONTE;-17.774;-48.773;True;2959;1501;1423;2473;1238;1200;486;263;223
5218805;Rio Verde;GO;52;Centro-Oeste;SUL GOIANO;SUDOESTE DE GOIAS;-17.798;-50.928;True;149382;75306;72425;138625;69473;67799;10757;5833;4626
5218904;Rubiataba;GO;52;Centro-Oeste;CENTRO GOIANO;CERES;-15.164;-49.803;True;18025;8886;9001;15797;7708;7976;2228;1178;1025
5219001;Sanclerlândia;GO;52;Centro-Oeste;CENTRO GOIANO;ANICUNS;-16.198;-50.314;True;7647;3875;3632;6038;3024;2947;1609;851;685
5219100;Santa Bárbara de Goiás;GO;52;Centro-Oeste;CENTRO GOIANO;ANICUNS;-16.574;-49.694;True;5658;2891;2767;5003;2526;2477;655;365;290
5219209;Santa Cruz de Goiás;GO;52;Centro-Oeste;SUL GOIANO;PIRES DO RIO;-17.316;-48.482;True;3542;1905;1586;1007;499;502;2535;1406;1084
5219258;Santa Fé de Goiás;GO;52;Centro-Oeste;NOROESTE GOIANO;RIO VERMELHO;-15.769;-51.106;True;4594;2313;2212;3514;1732;1713;1080;581;499
5219308;Santa Helena de Goiás;GO;52;Centro-Oeste;SUL GOIANO;SUDOESTE DE GOIAS;-17.814;-50.597;True;35027;17510;17319;33163;16488;16499;1864;1022;820
5219357;Santa Isabel;GO;52;Centro-Oeste;CENTRO GOIANO;CERES;-15.298;-49.427;True;3485;1705;1639;1328;657;656;2157;1048;983
5219407;Santa Rita do Araguaia;GO;52;Centro-Oeste;SUL GOIANO;SUDOESTE DE GOIAS;-17.326;-53.205;True;5873;2985;2835;5146;2554;2539;727;431;296
5219456;Santa Rita do Novo Destino;GO;52;Centro-Oeste;CENTRO GOIANO;CERES;-15.135;-49.12;True;3372;1819;1550;1156;599;557;2216;1220;993
5219506;Santa Rosa de Goiás;GO;52;Centro-Oeste;CENTRO GOIANO;ANAPOLIS;-16.085;-49.494;True;2851;1451;1396;2111;1046;1065;740;405;331
5219605;Santa Tereza de Goiás;GO;52;Centro-Oeste;NORTE GOIANO;PORANGATU;-13.714;-49.015;True;4145;2035;2050;3475;1698;1758;670;337;292
5219704;Santa Terezinha de Goiás;GO;52;Centro-Oeste;NORTE GOIANO;PORANGATU;-14.438;-49.706;True;11558;5902;5645;8673;4340;4325;2885;1562;1320
5219712;Santo Antônio da Barra;GO;52;Centro-Oeste;SUL GOIANO;SUDOESTE DE GOIAS;-17.561;-50.634;True;4134;2167;1901;3401;1784;1570;733;383;331
5219738;Santo Antônio de Goiás;GO;52;Centro-Oeste;CENTRO GOIANO;GOIANIA;-16.484;-49.311;True;3893;1933;1909;3508;1713;1744;385;220;165
5219753;Santo Antônio do Descoberto;GO;52;Centro-Oeste;LESTE GOIANO;ENTORNO DE BRASILIA;-15.94;-48.255;True;55621;27486;27876;52083;25647;26290;3538;1839;1586
5219803;São Domingos;GO;52;Centro-Oeste;LESTE GOIANO;VAO DO PARANA;-13.398;-46.318;True;9786;5109;4609;5134;2570;2551;4652;2539;2058
5219902;São Francisco de Goiás;GO;52;Centro-Oeste;CENTRO GOIANO;ANAPOLIS;-15.931;-49.261;True;5713;2916;2752;4189;2094;2053;1524;822;699
5220009;São João D'Aliança;GO;52;Centro-Oeste;NORTE GOIANO;CHAPADA DOS VEADEIROS;-14.706;-47.525;True;8177;4298;3787;5094;2543;2551;3083;1755;1236
5220058;São João da Paraúna;GO;52;Centro-Oeste;SUL GOIANO;VALE DO RIO DOS BOIS;-16.815;-50.41;True;1699;853;842;1212;587;621;487;266;221
5220108;São Luís de Montes Belos;GO;52;Centro-Oeste;CENTRO GOIANO;ANICUNS;-16.525;-50.372;True;26784;13119;13657;23439;11356;12075;3345;1763;1582
5220157;São Luíz do Norte;GO;52;Centro-Oeste;CENTRO GOIANO;CERES;-14.863;-49.329;True;4266;2203;2047;3557;1827;1730;709;376;317
5220207;São Miguel do Araguaia;GO;52;Centro-Oeste;NOROESTE GOIANO;SAO MIGUEL DO ARAGUAIA;-13.275;-50.163;True;22468;11563;10891;18202;9233;8969;4266;2330;1922
5220264;São Miguel do Passa Quatro;GO;52;Centro-Oeste;SUL GOIANO;PIRES DO RIO;-17.059;-48.663;True;3680;1947;1731;1870;962;908;1810;985;823
5220280;São Patrício;GO;52;Centro-Oeste;CENTRO GOIANO;CERES;-15.35;-49.818;True;2051;1034;1015;980;472;506;1071;562;509
5220405;São Simão;GO;52;Centro-Oeste;SUL GOIANO;QUIRINOPOLIS;-18.991;-50.544;True;13832;6808;6784;13464;6595;6629;368;213;155
5220454;Senador Canedo;GO;52;Centro-Oeste;CENTRO GOIANO;GOIANIA;-16.708;-49.093;True;70559;34597;34992;67900;33238;33758;2659;1359;1234
5220504;Serranópolis;GO;52;Centro-Oeste;SUL GOIANO;SUDOESTE DE GOIAS;-18.306;-51.962;True;7333;3942;3310;5155;2695;2460;2178;1247;850
5220603;Silvânia;GO;52;Centro-Oeste;SUL GOIANO;PIRES DO RIO;-16.659;-48.608;True;18370;9481;8881;11868;5831;6037;6502;3650;2844
5220686;Simolândia;GO;52;Centro-Oeste;LESTE GOIANO;VAO DO PARANA;-14.474;-46.483;True;6915;3535;3380;5735;2897;2838;1180;638;542
5220702;Sítio D'Abadia;GO;52;Centro-Oeste;LESTE GOIANO;VAO DO PARANA;-14.805;-46.253;True;3251;1769;1471;1034;517;517;2217;1252;954
5221007;Taquaral de Goiás;GO;52;Centro-Oeste;CENTRO GOIANO;ANAPOLIS;-16.054;-49.606;True;3404;1713;1623;2698;1322;1331;706;391;292
5221080;Teresina de Goiás;GO;52;Centro-Oeste;NORTE GOIANO;CHAPADA DOS VEADEIROS;-13.776;-47.265;True;2773;1361;1303;1931;911;934;842;450;369
5221197;Terezópolis de Goiás;GO;52;Centro-Oeste;CENTRO GOIANO;GOIANIA;-16.395;-49.08;True;5620;2797;2717;4909;2396;2407;711;401;310
5221304;Três Ranchos;GO;52;Centro-Oeste;SUL GOIANO;CATALAO;-18.354;-47.783;True;2862;1464;1390;2528;1284;1244;334;180;146
5221403;Trindade;GO;52;Centro-Oeste;CENTRO GOIANO;GOIANIA;-16.649;-49.489;True;97491;47299;49170;94515;45729;47860;2976;1570;1310
5221452;Trombas;GO;52;Centro-Oeste;NORTE GOIANO;PORANGATU;-13.509;-48.74;True;3537;1847;1690;2267;1125;1142;1270;722;548
5221502;Turvânia;GO;52;Centro-Oeste;CENTRO GOIANO;ANICUNS;-16.614;-50.134;True;4962;2497;2439;4036;2012;2024;926;485;415
5221551;Turvelândia;GO;52;Centro-Oeste;SUL GOIANO;VALE DO RIO DOS BOIS;-17.853;-50.302;True;3852;2094;1755;2865;1567;1298;987;527;457
5221577;Uirapuru;GO;52;Centro-Oeste;NOROESTE GOIANO;SAO MIGUEL DO ARAGUAIA;-14.285;-49.922;True;3021;1589;1432;1524;775;749;1497;814;683
5221601;Uruaçu;GO;52;Centro-Oeste;NORTE GOIANO;PORANGATU;-14.525;-49.141;True;33382;16393;16874;30312;14639;15572;3070;1754;1302
5221700;Uruana;GO;52;Centro-Oeste;CENTRO GOIANO;CERES;-15.498;-49.688;True;13712;6963;6736;11313;5669;5641;2399;1294;1095
5221809;Urutaí;GO;52;Centro-Oeste;SUL GOIANO;PIRES DO RIO;-17.464;-48.203;True;2727;1386;1339;2212;1099;1113;515;287;226
5221858;Valparaíso de Goiás;GO;52;Centro-Oeste;LESTE GOIANO;ENTORNO DE BRASILIA;-16.066;-47.979;True;114450;54869;58028;114450;54869;58028;;;
5221908;Varjão;GO;52;Centro-Oeste;SUL GOIANO;VALE DO RIO DOS BOIS;-17.045;-49.631;True;3649;1833;1776;2192;1043;1122;1457;790;654
5222005;Vianópolis;GO;52;Centro-Oeste;SUL GOIANO;PIRES DO RIO;-16.742;-48.516;True;12187;6180;6000;9105;4515;4588;3082;1665;1412
5222054;Vicentinópolis;GO;52;Centro-Oeste;SUL GOIANO;MEIA PONTE;-17.735;-49.806;True;5919;3052;2867;5189;2639;2550;730;413;317
5222203;Vila Boa;GO;52;Centro-Oeste;LESTE GOIANO;ENTORNO DE BRASILIA;-15.038;-47.059;True;4198;2102;1956;3188;1538;1543;1010;564;413
5222302;Vila Propício;GO;52;Centro-Oeste;LESTE GOIANO;ENTORNO DE BRASILIA;-15.457;-48.889;True;5044;2674;2366;1434;741;693;3610;1933;1673
5300108;Brasília;DF;53;Centro-Oeste;DISTRITO FEDERAL;BRASILIA;-15.78;-47.93;True;;;;;;;;;
